eski	eski+Adj
yoğunuz	yok+Adj^DB+Noun+Zero+A3sg+P2pl+Nom
üzgün	üzgün+Adj
lazım	lazım+Adj
duygusal	duygusal+Adj
iyileşen	iyi+Adj^DB+Verb+Become+Pos^DB+Adj+PresPart
ciddi	ciddi+Adj
ibaret	ibaret+Adj
aptalca	aptal+Adj^DB+Adj+AsIf
muhteşem	muhteşem+Adj
harika	harika+Adj
emin	emin+Adj
kadınlığın	kadın+Adj^DB+Noun+Ness+A3sg+Pnon+Gen
hayvanlaştırdığı	hayvan+Adj^DB+Verb+Become^DB+Verb+Caus+Pos^DB+Adj+PastPart+P3sg
uzaklaştıran	uzak+Adj^DB+Verb+Become^DB+Verb+Caus+Pos^DB+Adj+PresPart
mecbur	mecbur+Adj
fevkalade	fevkalade+Adj
kötü	kötü+Adj
hazır	hazır+Adj
koyu	koyu+Adj
bulanık	bulanık+Adj
fazlaca	fazla+Adj^DB+Adj+AsIf
güzelleşen	güzel+Adj^DB+Verb+Become+Pos^DB+Adj+PresPart
solgun	solgun+Adj
suniydi	suni+Adj^DB+Verb+Zero+Past+A3sg
kökleşmişti	kök+Adj^DB+Verb+Become+Pos+Narr+Past+A3sg
zorlaşacak	zor+Adj^DB+Verb+Become+Pos^DB+Adj+FutPart+Pnon
mümkün	mümkün+Adj
doğrusunu	doğru+Adj^DB+Noun+Zero+A3sg+P3sg+Acc
memnundu	memnu+Adj^DB+Noun+Zero+A3sg+P2sg+Nom^DB+Verb+Zero+Past+A3sg
büyük	büyük+Adj
dolu	dolu+Adj
yerindeyse	yerinde+Adj^DB+Verb+Zero+Cond+A3sg
peltekleşmişti	peltek+Adj^DB+Verb+Become+Pos+Narr+Past+A3sg
belli	belli+Adj
parlak	parlak+Adj
aziz	aziz+Adj
sapsarı	sapsarı+Adj
bitkin	bitkin+Adj
yumuşak	yumuşak+Adj
genç	genç+Adj
temiz	temiz+Adj
düşüncelisiniz	düşüncel+Adj^DB+Noun+Zero+A3sg+P3sg+Nom^DB+Verb+Zero+Pres+A2pl
saf	saf+Adj
çıplak	çıplak+Adj
sertçe	sert+Adj^DB+Adj+AsIf
sakin	sakin+Adj
bambaşka	bambaşka+Adj
karmaşık	karmaşık+Adj
geniş	geniş+Adj
başkasına	başka+Adj^DB+Noun+Zero+A3sg+P3sg+Dat
düşkün	düşkün+Adj
şaşkın	şaşkın+Adj
alışkanlığım	alışkan+Adj^DB+Noun+Ness+A3sg+P1sg+Nom
öyledir	öyle+Adj^DB+Verb+Zero+Pres+A3sg+Cop
razı	razı+Adj
yalnızlığımı	yalnız+Adj^DB+Noun+Ness+A3sg+P1sg+Acc
ıslak	ıslak+Adj
donuk	donuk+Adj
açıktaki	açık+Adj^DB+Noun+Zero+A3sg+Pnon+Loc^DB+Adj+Rel
yavaş	yavaş+Adj
garip	garip+Adj
yabancı	yabancı+Adj
nasılsın	nasıl+Adj^DB+Verb+Zero+Pres+A2sg
kutsal	kutsal+Adj
beter	beter+Adj
delikanlılar	delikanlı+Adj^DB+Noun+Zero+A3pl+Pnon+Nom
kaba	kaba+Adj
bol	bol+Adj
sağlam	sağlam+Adj
beraberiz	beraber+Adj^DB+Verb+Zero+Pres+A1pl
gergin	gergin+Adj
huysuzlaşıyor	huysuz+Adj^DB+Verb+Become+Pos+Prog1+A3sg
kapalı	kapalı+Adj
ilginç	ilginç+Adj
yoksun	yoksun+Adj
soğuk	soğuk+Adj
hoş	hoş+Adj
ana	ana+Adj
uyanık	uyanık+Adj
aşikar	aşikar+Adj
aynı	aynı+Adj
uzunlu	uzun+Adj^DB+Noun+Zero+A3sg+Pnon+Nom^DB+Adj+With
tedirgin	tedirgin+Adj
yakındaki	yakın+Adj^DB+Noun+Zero+A3sg+Pnon+Loc^DB+Adj+Rel
egemen	egemen+Adj
ürkek	ürkek+Adj
ağırlaştığı	ağır+Adj^DB+Verb+Become+Pos^DB+Adj+PastPart+P3sg
kamburlaşmıştı	kambur+Adj^DB+Verb+Become+Pos+Narr+Past+A3sg
seyrek	seyrek+Adj
zayıf	zayıf+Adj
nazik	nazik+Adj
mahkum	mahkum+Adj
tombul	tombul+Adj
siyahımsı	siyah+Adj^DB+Adj+JustLike
çirkin	çirkin+Adj
bitişik	bitişik+Adj
ters	ters+Adj
dönük	dönük+Adj
topaldı	topal+Adj^DB+Verb+Zero+Past+A3sg
göreceli	göreceli+Adj
alışık	alışık+Adj
deli	deli+Adj
adil	adil+Adj
şişkosunuz	şişko+Adj^DB+Verb+Zero+Pres+A2pl
bön	bön+Adj
böylesi	böyle+Adj^DB+Noun+Zero+A3sg+P3sg+Nom
zengin	zengin+Adj
kolay	kolay+Adj
yoğunlaştıran	yoğun+Adj^DB+Verb+Become^DB+Verb+Caus+Pos^DB+Adj+PresPart
karmakarışık	karmakarışık+Adj
meşgul	meşgul+Adj
tekli	tek+Adj^DB+Noun+Zero+A3sg+Pnon+Nom^DB+Adj+With
bayağıydı	bayağı+Adj^DB+Verb+Zero+Past+A3sg
kıpkırmızıydı	kıpkırmızı+Adj^DB+Verb+Zero+Past+A3sg
benzeri	benzeri+Adj
sahte	sahte+Adj
dayanıklı	dayanıklı+Adj
iğrenç	iğrenç+Adj
bozuk	bozuk+Adj
has	has+Adj
bembeyaz	bembeyaz+Adj
çatlak	çatlak+Adj
aksi	aksi+Adj
çok	çok+Adj
kahverengi	kahverengi+Adj
buçuk	buçuk+Adj
yeterli	yeterli+Adj
esnek	esnek+Adj
inatçı	inatçı+Adj
yetersiz	yetersiz+Adj
alçakça	alçak+Adj^DB+Adj+AsIf
kabarık	kabarık+Adj
karanlık	karanlık+Adj
yuvarlak	yuvarlak+Adj
hantallaşmıştı	hantal+Adj^DB+Verb+Become+Pos+Narr+Past+A3sg
silikleşiyordu	silik+Adj^DB+Verb+Become+Pos+Prog1+Past+A3sg
kör	kör+Adj
boş	boş+Adj
ağırbaşlı	ağırbaşlı+Adj
birinde	bir+Adj^DB+Noun+Zero+A3sg+P3sg+Loc
serbestçe	serbest+Adj^DB+Adj+AsIf
yaygınlaştığı	yaygın+Adj^DB+Verb+Become+Pos^DB+Adj+PastPart+P3sg
değişik	değişik+Adj
mutlu	mutlu+Adj
düşmanca	düşman+Adj^DB+Adj+AsIf
dobralık	dobra+Adj^DB+Noun+Ness+A3sg+Pnon+Nom
basit	basit+Adj
kırık	kırık+Adj
diğer	diğer+Adj
kesinleşen	kesin+Adj^DB+Verb+Become+Pos^DB+Adj+PresPart
bencillik	bencil+Adj^DB+Noun+Ness+A3sg+Pnon+Nom
gülünç	gülünç+Adj
sevgili	sevgili+Adj
yanlışlığı	yanlış+Adj^DB+Noun+Ness+A3sg+P3sg+Nom
bireyciliğin	bireyci+Adj^DB+Noun+Ness+A3sg+Pnon+Gen
standart	standart+Adj
pişman	pişman+Adj
kızıl	kızıl+Adj
bunaklığından	bunak+Adj^DB+Noun+Ness+A3sg+P3sg+Abl
zavallı	zavallı+Adj
küstahlığında	küstah+Adj^DB+Noun+Ness+A3sg+P3sg+Loc
duyarlı	duyarlı+Adj
acayip	acayip+Adj
ihtiyar	ihtiyar+Adj
kürk	kürk+Adj
budalaca	budala+Adj^DB+Adj+AsIf
açgözlülük	açgözlü+Adj^DB+Noun+Ness+A3sg+Pnon+Nom
kepazeliği	kepaze+Adj^DB+Noun+Ness+A3sg+P3sg+Nom
ıssızlaşan	ıssız+Adj^DB+Verb+Become+Pos^DB+Adj+PresPart
asil	asil+Adj
áşık	aşık+Adj
kibar	kibar+Adj
saçma	saçma+Adj
adi	adi+Adj
alan	ala+Adj^DB+Noun+Zero+A3sg+P2sg+Nom
hoşnutsuzluğu	hoşnutsuz+Adj^DB+Noun+Ness+A3sg+Pnon+Acc
ahmak	ahmak+Adj
fedakar	fedakar+Adj
hesaplı	hesaplı+Adj
enayi	enayi+Adj
acele	acele+Adj
kalma	kalma+Adj
sade	sade+Adj
dağınık	dağınık+Adj
yeşil	yeşil+Adj
kızgın	kızgın+Adj
azmanı	azman+Adj^DB+Noun+Zero+A3sg+P3sg+Nom
düzleştiren	düz+Adj^DB+Verb+Become^DB+Verb+Caus+Pos^DB+Adj+PresPart
kasıla	kasıl+Adj^DB+Noun+Zero+A3sg+Pnon+Dat
saygın	saygın+Adj
revan	reva+Adj^DB+Noun+Zero+A3sg+P2sg+Nom
durgun	durgun+Adj
geçenleri	geçen+Adj^DB+Noun+Zero+A3pl+P3pl+Nom
sarı	sarı+Adj
yorgun	yorgun+Adj
derinleşen	derin+Adj^DB+Verb+Become+Pos^DB+Adj+PresPart
körpecik	körpe+Adj^DB+Noun+Zero+A3sg+Pnon+Nom^DB+Noun+Dim+A3sg+Pnon+Nom
failini	fail+Adj^DB+Noun+Zero+A3sg+P3sg+Acc
ölgünlüğüne	ölgün+Adj^DB+Noun+Ness+A3sg+P3sg+Dat
çeviklikle	çevik+Adj^DB+Noun+Ness+A3sg+Pnon+Ins
üstündeki	üstün+Adj^DB+Noun+Zero+A3sg+Pnon+Loc^DB+Adj+Rel
alınganlık	alıngan+Adj^DB+Noun+Ness+A3sg+Pnon+Nom
sıkılgan	sıkılgan+Adj
çekingen	çekingen+Adj
aşırı	aşırı+Adj
aydın	aydın+Adj
çifte	çifte+Adj
rahatça	rahat+Adj^DB+Adj+AsIf
pis	pis+Adj
bütün	bütün+Adj
pul	pul+Adj
batı	batı+Adj
ince	ince+Adj
haylazlıktan	haylaz+Adj^DB+Noun+Ness+A3sg+Pnon+Abl
kurak	kurak+Adj
yükseklikteki	yüksek+Adj^DB+Noun+Ness+A3sg+Pnon+Loc^DB+Adj+Rel
memnun	memnun+Adj
normal	normal+Adj
olgun	olgun+Adj
özgürce	özgür+Adj^DB+Adj+AsIf
kısa	kısa+Adj
ekonomik	ekonomik+Adj
sosyal	sosyal+Adj
somut	somut+Adj
aykırı	aykırı+Adj
muazzam	muazzam+Adj
dakik	dakik+Adj
karışık	karışık+Adj
evli	evli+Adj
berbat	berbat+Adj
peyda	peyda+Adj
dramatik	dramatik+Adj
küçük	küçük+Adj
şahsi	şahsi+Adj
yeni	yeni+Adj
resmi	resmi+Adj
ufak	ufak+Adj
herhangi	herhangi+Adj
ahlaki	ahlaki+Adj
cömert	cömert+Adj
organize	organize+Adj
safi	safi+Adj
alicenap	alicenap+Adj
aşağılık	aşağılık+Adj
ani	ani+Adj
olağanüstü	olağanüstü+Adj
yakışıklı	yakışıklı+Adj
rengarenk	rengarenk+Adj
kadife	kadife+Adj
dar	dar+Adj
çapraz	çapraz+Adj
zarif	zarif+Adj
kırmızılı	kırmızı+Adj^DB+Noun+Zero+A3sg+Pnon+Nom^DB+Adj+With
nefis	nefis+Adj
enfes	enfes+Adj
beyazlı	beyaz+Adj^DB+Noun+Zero+A3sg+Pnon+Nom^DB+Adj+With
reşit	reşit+Adj
layık	layık+Adj
şöyle	şöyle+Adj
modern	modern+Adj
sadık	sadık+Adj
gür	gür+Adj
hırçın	hırçın+Adj
bağnaz	bağnaz+Adj
korkunç	korkunç+Adj
medeni	medeni+Adj
nüktedan	nüktedan+Adj
tabii	tabii+Adj
benzersiz	benzersiz+Adj
gümüş	gümüş+Adj
kayıp	kayıp+Adj
şişman	şişman+Adj
devasa	devasa+Adj
tiz	tiz+Adj
uygun	uygun+Adj
hassas	hassas+Adj
manevi	manevi+Adj
sefil	sefil+Adj
sevimli	sevimli+Adj
utangaç	utangaç+Adj
ayan	ayan+Adj
yapay	yapay+Adj
harcıalem	harcıalem+Adj
buruk	buruk+Adj
müthiş	müthiş+Adj
gizli	gizli+Adj
rezil	rezil+Adj
tatlı	tatlı+Adj
kuytu	kuytu+Adj
türlü	türlü+Adj
eşit	eşit+Adj
sıcak	sıcak+Adj
kalın	kalın+Adj
özel	özel+Adj
yüce	yüce+Adj
paramparça	paramparça+Adj
kıvrak	kıvrak+Adj
cici	cici+Adj
ufacık	ufacık+Adj
coşkun	coşkun+Adj
mağrur	mağrur+Adj
bunca	bunca+Adj
mükemmel	mükemmel+Adj
taze	taze+Adj
çekici	çekici+Adj
dizüstü	dizüstü+Adj
olanca	olanca+Adj
hangi	hangi+Adj
diri	diri+Adj
dimdik	dimdik+Adj
eğik	eğik+Adj
müspet	müspet+Adj
belirsiz	belirsiz+Adj
haftalık	haftalık+Adj
zamansız	zamansız+Adj
terbiyeli	terbiyeli+Adj
soğukkanlı	soğukkanlı+Adj
nail	nail+Adj
dalgın	dalgın+Adj
altın	altın+Adj
kişisel	kişisel+Adj
belirli	belirli+Adj
samimi	samimi+Adj
mahsus	mahsus+Adj
mavi	mavi+Adj
meşhur	meşhur+Adj
mühim	mühim+Adj
keskin	keskin+Adj
başlıca	başlıca+Adj
öbür	öbür+Adj
ertesi	ertesi+Adj
romantik	romantik+Adj
ahşap	ahşap+Adj
çevrili	çevrili+Adj
sayın	sayın+Adj
binbir	binbir+Adj
kocaman	kocaman+Adj
yetişkin	yetişkin+Adj
sağır	sağır+Adj
tıknaz	tıknaz+Adj
yemyeşil	yemyeşil+Adj
taptaze	taptaze+Adj
sarımtırak	sarımtırak+Adj
sipsivri	sipsivri+Adj
ölümcül	ölümcül+Adj
adamakıllı	adamakıllı+Adj
dümdüz	dümdüz+Adj
vahşi	vahşi+Adj
içgüdüsel	içgüdüsel+Adj
sıkı	sıkı+Adj
olası	olası+Adj
girişken	girişken+Adj
bezgin	bezgin+Adj
mini	mini+Adj
zalimce	zalim+Adj^DB+Adj+AsIf
acımasızca	acımasız+Adj^DB+Adj+AsIf
dürüst	dürüst+Adj
ayırt	ayırt+Adj
sınırsız	sınırsız+Adj
ortak	ortak+Adj
hafifçe	hafif+Adj^DB+Adj+AsIf
evcil	evcil+Adj
aylak	aylak+Adj
leziz	leziz+Adj
incecik	incecik+Adj
yabani	yabani+Adj
esas	esas+Adj
yalın	yalın+Adj
koskoca	koskoca+Adj
başıboş	başıboş+Adj
oynak	oynak+Adj
restore	restore+Adj
kagir	kagir+Adj
iri	iri+Adj
acıklı	acıklı+Adj
ruhsal	ruhsal+Adj
küçücük	küçücük+Adj
düzgün	düzgün+Adj
sıcakkanlı	sıcakkanlı+Adj
şaşmaz	şaşmaz+Adj
köhne	köhne+Adj
ilahi	ilahi+Adj
cılız	cılız+Adj
geçer	geçer+Adj
paralel	paralel+Adj
züppe	züppe+Adj
seçkin	seçkin+Adj
zekice	zeki+Adj^DB+Adj+AsIf
narin	narin+Adj
yapayalnız	yapayalnız+Adj
çift	çift+Adj
kaçık	kaçık+Adj
girgin	girgin+Adj
peşindeki	peşin+Adj^DB+Noun+Zero+A3sg+Pnon+Loc^DB+Adj+Rel
uygunsuz	uygunsuz+Adj
apaçık	apaçık+Adj
gevrek	gevrek+Adj
çinko	çinko+Adj
yırtık	yırtık+Adj
mızmız	mızmız+Adj
haşarı	haşarı+Adj
müstehcen	müstehcen+Adj
dinç	dinç+Adj
ayrı	ayrı+Adj
sinsi	sinsi+Adj
muzip	muzip+Adj
günahkar	günahkar+Adj
ziyade	ziyade+Adj
koskocaman	koskocaman+Adj
gebe	gebe+Adj
fena	fena+Adj
kısık	kısık+Adj
rastgele	rastgele+Adj
yığılı	yığılı+Adj
yıkık	yıkık+Adj
çırılçıplak	çırılçıplak+Adj
püskü	püskü+Adj
porselen	porselen+Adj
şeftalili	şeftali+Adj^DB+Noun+Zero+A3sg+Pnon+Nom^DB+Adj+With
çürük	çürük+Adj
kötümser	kötümser+Adj
şeytani	şeytani+Adj
değişmez	değişmez+Adj
alışkın	alışkın+Adj
kurnaz	kurnaz+Adj
yarım	yarım+Adj
sımsıkı	sımsıkı+Adj
mütereddit	mütereddit+Adj
loş	loş+Adj
kaskatı	kaskatı+Adj
konuşkan	konuşkan+Adj
doğal	doğal+Adj
şık	şık+Adj
kopuk	kopuk+Adj
kesik	kesik+Adj
kupkuru	kupkuru+Adj
sevecen	sevecen+Adj
asabi	asabi+Adj
musallat	musallat+Adj
muvaffak	muvaffak+Adj
özgü	özgü+Adj
sırtüstü	sırtüstü+Adj
bariz	bariz+Adj
masum	masum+Adj
cahil	cahil+Adj
elimdeki	elim+Adj^DB+Noun+Zero+A3sg+Pnon+Loc^DB+Adj+Rel
genelindeki	genel+Adj^DB+Noun+Zero+A3sg+P3sg+Loc^DB+Adj+Rel
sarıklı	sarıklı+Adj
pitoresk	pitoresk+Adj
dağlık	dağlık+Adj
usluca	uslu+Adj^DB+Adj+AsIf
ebedi	ebedi+Adj
örtülü	örtülü+Adj
allak	allak+Adj
bullak	bullak+Adj
sapık	sapık+Adj
amansız	amansız+Adj
gaddar	gaddar+Adj
nalet	nalet+Adj
katı	katı+Adj
siyasal	siyasal+Adj
dışındaki	dışı+Adj^DB+Noun+Zero+A3sg+P2sg+Loc^DB+Adj+Rel
dinsel	dinsel+Adj
felsefi	felsefi+Adj
alegorik	alegorik+Adj
belgesel	belgesel+Adj
toplumsal	toplumsal+Adj
insancıl	insancıl+Adj
doğrudan	doğrudan+Adj
etkinleştirildiği	etkin+Adj^DB+Verb+Become^DB+Verb+Caus^DB+Verb+Pass+Pos^DB+Adj+PastPart+P3sg
eleştirel	eleştirel+Adj
eşsiz	eşsiz+Adj
yapıcı	yapıcı+Adj
boğuk	boğuk+Adj
simsiyah	simsiyah+Adj
asık	asık+Adj
kapkara	kapkara+Adj
aciz	aciz+Adj
tekdüze	tekdüze+Adj
armonik	armonik+Adj
olağan	olağan+Adj
nemrut	nemrut+Adj
akim	akim+Adj
sivri	sivri+Adj
maruz	maruz+Adj
aralıksız	aralıksız+Adj
çatık	çatık+Adj
gücenik	gücenik+Adj
hoşnut	hoşnut+Adj
zıt	zıt+Adj
kaçınılmaz	kaçınılmaz+Adj
günlüğündeki	günlük+Adj^DB+Noun+Zero+A3sg+P3sg+Loc^DB+Adj+Rel
gencecik	gencecik+Adj
belirgin	belirgin+Adj
tabi	tabi+Adj
kafalı	kafalı+Adj
çorak	çorak+Adj
titrek	titrek+Adj
deşik	deşik+Adj
sarılı	sarılı+Adj
sırılsıklam	sırılsıklam+Adj
tehditkar	tehditkar+Adj
yatay	yatay+Adj
sarışın	sarışın+Adj
babacan	babacan+Adj
muzdarip	muzdarip+Adj
ketum	ketum+Adj
yaklaşık	yaklaşık+Adj
gevşek	gevşek+Adj
hayali	hayali+Adj
profesyonel	profesyonel+Adj
şairane	şairane+Adj
geçerli	geçerli+Adj
milli	milli+Adj
mutlak	mutlak+Adj
düşük	düşük+Adj
mütevazi	mütevazi+Adj
senelik	senelik+Adj
kem	kem+Adj
melez	melez+Adj
kıpkızıl	kıpkızıl+Adj
sabit	sabit+Adj
mesut	mesut+Adj
ucuz	ucuz+Adj
hayırlı	hayırlı+Adj
şen	şen+Adj
bitirim	bitirim+Adj
tuzlu	tuzlu+Adj
divane	divane+Adj
evvelsi	evvelsi+Adj
daim	daim+Adj
hor	hor+Adj
uysal	uysal+Adj
amade	amade+Adj
hatırşinas	hatırşinas+Adj
ihmalkar	ihmalkar+Adj
nadir	nadir+Adj
görmemiş	görmemiş+Adj
şahane	şahane+Adj
engin	engin+Adj
ticari	ticari+Adj
takma	takma+Adj
şişkin	şişkin+Adj
acil	acil+Adj
sömürgeci	sömürgeci+Adj
mutsuz	mutsuz+Adj
lüks	lüks+Adj
ödünç	ödünç+Adj
mütevazı	mütevazı+Adj
fiziksel	fiziksel+Adj
değişkenlerdeki	değişken+Adj^DB+Noun+Zero+A3pl+Pnon+Loc^DB+Adj+Rel
pespembe	pespembe+Adj
berrak	berrak+Adj
zorlu	zorlu+Adj
kalıtsal	kalıtsal+Adj
kindar	kindar+Adj
ılık	ılık+Adj
çarpık	çarpık+Adj
buruşuk	buruşuk+Adj
gönüllü	gönüllü+Adj
çakırkeyif	çakırkeyif+Adj
bedbaht	bedbaht+Adj
organik	organik+Adj
çocuksu	çocuksu+Adj
sıcacık	sıcacık+Adj
sıkkın	sıkkın+Adj
mahzun	mahzun+Adj
mezun	mezun+Adj
mesleki	mesleki+Adj
soyut	soyut+Adj
emekli	emekli+Adj
zinde	zinde+Adj
kayıtsız	kayıtsız+Adj
minik	minik+Adj
uyuşuk	uyuşuk+Adj
akıllıca	akıllıca+Adj
düzenbaz	düzenbaz+Adj
yapışkan	yapışkan+Adj
seyyar	seyyar+Adj
insanüstü	insanüstü+Adj
salim	salim+Adj
ekstra	ekstra+Adj
çocukça	çocukça+Adj
bomboş	bomboş+Adj
dopdolu	dopdolu+Adj
tertemiz	tertemiz+Adj
çın	çın+Adj
şakrak	şakrak+Adj
tok	tok+Adj
yersiz	yersiz+Adj
muhtemel	muhtemel+Adj
mahir	mahir+Adj
içli	içli+Adj
perişan	perişan+Adj
gaddarca	gaddarca+Adj
duyarsız	duyarsız+Adj
harap	harap+Adj
otobiyografik	otobiyografik+Adj
radikal	radikal+Adj
edebi	edebi+Adj
cinsel	cinsel+Adj
ahlaksal	ahlaksal+Adj
şehla	şehla+Adj
gayrimeşru	gayrimeşru+Adj
cazip	cazip+Adj
döşeli	döşeli+Adj
gözalıcı	gözalıcı+Adj
saçık	saçık+Adj
siyasi	siyasi+Adj
rahmetli	rahmetli+Adj
esrarengiz	esrarengiz+Adj
olumlu	olumlu+Adj
nazır	nazır+Adj
menkul	menkul+Adj
dayalı	dayalı+Adj
naçiz	naçiz+Adj
müteveffa	müteveffa+Adj
tutarlı	tutarlı+Adj
yerel	yerel+Adj
yapısal	yapısal+Adj
pozitif	pozitif+Adj
negatif	negatif+Adj
otomatikleştiremediğiniz	otomatik+Adj^DB+Verb+Become^DB+Verb+Caus^DB+Verb+Able+Neg^DB+Adj+PastPart+P2pl
bağımsız	bağımsız+Adj
bireysel	bireysel+Adj
bağımlı	bağımlı+Adj
çizili	çizi+Adj^DB+Noun+Zero+A3sg+Pnon+Nom^DB+Adj+With
italik	italik+Adj
dikey	dikey+Adj
geçici	geçici+Adj
toplu	toplu+Adj
karşıt	karşıt+Adj
elektronik	elektronik+Adj
yerleşik	yerleşik+Adj
çevrimiçi	çevrimiçi+Adj
masaüstünüzdeki	masaüstü+Adj^DB+Noun+Zero+A3sg+P2pl+Loc^DB+Adj+Rel
geçersiz	geçersiz+Adj
yönetimsel	yönetimsel+Adj
dinamik	dinamik+Adj
birincil	birincil+Adj
mantıksal	mantıksal+Adj
sezgisel	sezgisel+Adj
sanal	sanal+Adj
karma	karma+Adj
dijital	dijital+Adj
sayısal	sayısal+Adj
aritmetik	aritmetik+Adj
zorunlu	zorunlu+Adj
güncelleştirildiği	güncel+Adj^DB+Verb+Become^DB+Verb+Caus^DB+Verb+Pass+Pos^DB+Adj+PastPart+P3sg
sağındaki	sağın+Adj^DB+Noun+Zero+A3sg+Pnon+Loc^DB+Adj+Rel
itici	itici+Adj
görsel	görsel+Adj
işlevsel	işlevsel+Adj
teknik	teknik+Adj
istatistiksel	istatistiksel+Adj
ortalama	ortalama+Adj
eşdeğer	eşdeğer+Adj
zorlama	zorlama+Adj
asimetrik	asimetrik+Adj
muaf	muaf+Adj
kısmi	kısmi+Adj
gezici	gezici+Adj
hiyerarşik	hiyerarşik+Adj
çoklu	çoklu+Adj
hiperbolik	hiperbolik+Adj
ardışık	ardışık+Adj
hurda	hurda+Adj
işlemsel	işlemsel+Adj
geometrik	geometrik+Adj
doğrusal	doğrusal+Adj
konur	konur+Adj
özgün	özgün+Adj
otonom	otonom+Adj
çizik	çizik+Adj
saklı	saklı+Adj
basılı	basılı+Adj
alfabetik	alfabetik+Adj
cari	cari+Adj
tekil	tekil+Adj
mobil	mobil+Adj
atık	atık+Adj
nötr	nötr+Adj
statik	statik+Adj
stratejik	stratejik+Adj
mor	mor+Adj
mali	mali+Adj
geleneksel	geleneksel+Adj
dahili	dahili+Adj
kategorize	kategorize+Adj
kümülatif	kümülatif+Adj
saydam	saydam+Adj
tutucu	tutucu+Adj
örtük	örtük+Adj
asal	asal+Adj
tümleşik	tümleşik+Adj
demokratik	demokratik+Adj
kırsal	kırsal+Adj
vahim	vahim+Adj
özürlü	özürlü+Adj
amatör	amatör+Adj
elverişsiz	elverişsiz+Adj
taburcu	taburcu+Adj
akut	akut+Adj
popüler	popüler+Adj
erkeksi	erkeksi+Adj
tipik	tipik+Adj
mikro	mikro+Adj
sevimsiz	sevimsiz+Adj
şirin	şirin+Adj
mukannen	mukannen+Adj
müslüman	müslüman+Adj
laik	laik+Adj
kültürel	kültürel+Adj
gözde	gözde+Adj
fahri	fahri+Adj
ulusal	ulusal+Adj
sonuncu	sonuncu+Adj
barışcıl	barışçıl+Adj
zanlı	zanlı+Adj
olumsuz	olumsuz+Adj
politik	politik+Adj
ikiyüzlü	ikiyüzlü+Adj
bedava	bedava+Adj
uyduruk	uyduruk+Adj
sanatsever	sanatsever+Adj
antik	antik+Adj
şeffaf	şeffaf+Adj
bilimsel	bilimsel+Adj
filan	filan+Adj
cimri	cimri+Adj
çiğ	çiğ+Adj
turistikleşen	turistik+Adj^DB+Verb+Become+Pos^DB+Adj+PresPart
yerli	yerli+Adj
klasik	klasik+Adj
çağdaş	çağdaş+Adj
bonkör	bonkör+Adj
fanatik	fanatik+Adj
apar	apar+Adj
uygarca	uygar+Adj^DB+Adj+AsIf
orijinal	orijinal+Adj
müteşebbis	müteşebbis+Adj
perakende	perakende+Adj
kanserojen	kanserojen+Adj
batık	batık+Adj
yumuşacık	yumuşacık+Adj
atmosferik	atmosferik+Adj
rutin	rutin+Adj
manyetik	manyetik+Adj
alakart	alakart+Adj
stabilize	stabilize+Adj
yurtdışı	yurtdışı+Adj
modernize	modernize+Adj
mimari	mimari+Adj
merkezindeki	merkezi+Adj^DB+Noun+Zero+A3sg+P2sg+Loc^DB+Adj+Rel
ender	ender+Adj
panoramik	panoramik+Adj
bakir	bakir+Adj
kumsal	kumsal+Adj
tük	tük+Adj
kentsel	kentsel+Adj
idari	idari+Adj
azami	azami+Adj
mustarip	mustarip+Adj
girift	girift+Adj
abuk	abuk+Adj
empoze	empoze+Adj
kombine	kombine+Adj
nafile	nafile+Adj
gözüpek	gözüpek+Adj
makul	makul+Adj
peşpeşe	peşpeşe+Adj
lacivertli	lacivert+Adj^DB+Noun+Zero+A3sg+Pnon+Nom^DB+Adj+With
fast	fast+Adj
güzelim	güzelim+Adj
içiçe	içiçe+Adj
konsantre	konsantre+Adj
tutuk	tutuk+Adj
efsanevi	efsanevi+Adj
altüst	altüst+Adj
motive	motive+Adj
maddi	maddi+Adj
adapte	adapte+Adj
uçuk	uçuk+Adj
mağlup	mağlup+Adj
sportif	sportif+Adj
ferdi	ferdi+Adj
teorik	teorik+Adj
çalışkan	çalışkan+Adj
itaatkar	itaatkar+Adj
kritik	kritik+Adj
acizane	acizane+Adj
tecavüzkar	tecavüzkar+Adj
yanık	yanık+Adj
mümtaz	mümtaz+Adj
endüstriyel	endüstriyel+Adj
tektip	tektip+Adj
fukara	fukara+Adj
yasal	yasal+Adj
kaçıncı	kaçıncı+Adj
suskun	suskun+Adj
özerk	özerk+Adj
anti	anti+Adj
parasal	parasal+Adj
matematiksel	matematiksel+Adj
izole	izole+Adj
mahrum	mahrum+Adj
erotik	erotik+Adj
abes	abes+Adj
tarihindeki	tarihi+Adj^DB+Noun+Zero+A3sg+P2sg+Loc^DB+Adj+Rel
habis	habis+Adj
turuncu	turuncu+Adj
bedensel	bedensel+Adj
ferah	ferah+Adj
müstakil	müstakil+Adj
dekoratif	dekoratif+Adj
yaşamsal	yaşamsal+Adj
hormonal	hormonal+Adj
aktif	aktif+Adj
yanal	yanal+Adj
filanca	filanca+Adj
fotojenik	fotojenik+Adj
fiziki	fiziki+Adj
birebir	birebir+Adj
pop	pop+Adj
entegre	entegre+Adj
evrensel	evrensel+Adj
hukuki	hukuki+Adj
evrimsel	evrimsel+Adj
yatkın	yatkın+Adj
bitap	bitap+Adj
obez	obez+Adj
kuduz	kuduz+Adj
hayvansal	hayvansal+Adj
kamusal	kamusal+Adj
revize	revize+Adj
anormal	anormal+Adj
büyükbaş	büyükbaş+Adj
haram	haram+Adj
müzeyyen	müzeyyen+Adj
mahcup	mahcup+Adj
kimyevi	kimyevi+Adj
mecazi	mecazi+Adj
muhterem	muhterem+Adj
illegal	illegal+Adj
asimile	asimile+Adj
tepkisel	tepkisel+Adj
polisiye	polisiye+Adj
insani	insani+Adj
akademik	akademik+Adj
topluca	topluca+Adj
tarihsel	tarihsel+Adj
deşifre	deşifre+Adj
beşeri	beşeri+Adj
islami	islami+Adj
fiili	fiili+Adj
meçhul	meçhul+Adj
faal	faal+Adj
örgütsel	örgütsel+Adj
hukuksal	hukuksal+Adj
asgari	asgari+Adj
meşru	meşru+Adj
köklü	köklü+Adj
kılpayı	kılpayı+Adj
ilkel	ilkel+Adj
sistematik	sistematik+Adj
rafine	rafine+Adj
sosyolojik	sosyolojik+Adj
müttefik	müttefik+Adj
reel	reel+Adj
yepyeni	yepyeni+Adj
alafranga	alafranga+Adj
üniter	üniter+Adj
iyimser	iyimser+Adj
hazin	hazin+Adj
demokratça	demokrat+Adj^DB+Adj+AsIf
akli	akli+Adj
daimi	daimi+Adj
atletik	atletik+Adj
simgesel	simgesel+Adj
düşünsel	düşünsel+Adj
ütopik	ütopik+Adj
agresif	agresif+Adj
mahsur	mahsur+Adj
spesifik	spesifik+Adj
alkolik	alkolik+Adj
elverişli	elverişli+Adj
bölgesel	bölgesel+Adj
bağışık	bağışık+Adj
barışık	barışık+Adj
inandırıcı	inandırıcı+Adj
kimyasal	kimyasal+Adj
müsrif	müsrif+Adj
gecelik	gecelik+Adj
şayan	şayan+Adj
ılımlı	ılımlı+Adj
diplomatik	diplomatik+Adj
sosyetik	sosyetik+Adj
plastik	plastik+Adj
global	global+Adj
cesur	cesur+Adj
etnik	etnik+Adj
bej	bej+Adj
baştançıkarıcı	baştançıkarıcı+Adj
fütüristik	fütüristik+Adj
sıradışı	sıradışı+Adj
jarse	jarse+Adj
kruvaze	kruvaze+Adj
enerjik	enerjik+Adj
objektif	objektif+Adj
minicik	minicik+Adj
ultra	ultra+Adj
streç	streç+Adj
metalik	metalik+Adj
kloş	kloş+Adj
otoriter	otoriter+Adj
hayati	hayati+Adj
sempatik	sempatik+Adj
titiz	titiz+Adj
sarp	sarp+Adj
şád	şad+Adj
alaturka	alaturka+Adj
zilli	zilli+Adj
eşcinsel	eşcinsel+Adj
bıçkın	bıçkın+Adj
kadınsı	kadınsı+Adj
aleni	aleni+Adj
yamuk	yamuk+Adj
feci	feci+Adj
usturuplu	usturuplu+Adj
yegane	yegane+Adj
metazori	metazori+Adj
apayrı	apayrı+Adj
paranoyak	paranoyak+Adj
laubali	laubali+Adj
zincirleme	zincirleme+Adj
üstüste	üstüste+Adj
durağan	durağan+Adj
aktüel	aktüel+Adj
deneysel	deneysel+Adj
sönük	sönük+Adj
ergonomik	ergonomik+Adj
makbul	makbul+Adj
zihinsel	zihinsel+Adj
okullu	okullu+Adj
periyodik	periyodik+Adj
enflasyonist	enflasyonist+Adj
prefabrik	prefabrik+Adj
atıl	atıl+Adj
yöresel	yöresel+Adj
mağdur	mağdur+Adj
cezai	cezai+Adj
gerçekleştiren	gerçek+Noun+A3sg+Pnon+Nom^DB+Verb+Become^DB+Verb+Caus+Pos^DB+Adj+PresPart
yaşlarındaki	yaş+Noun+A3pl+P3sg+Loc^DB+Adj+Rel
babasız	baba+Noun+A3sg+Pnon+Nom^DB+Adj+Without
centilmen	centilmen+Noun+A3sg+Pnon+Nom
bağlı	bağ+Noun+A3sg+Pnon+Nom^DB+Adj+With
duygulandığı	duygu+Noun+A3sg+Pnon+Nom^DB+Verb+Acquire+Pos^DB+Adj+PastPart+P3sg
alışkındı	alışkı+Noun+A3sg+P2sg+Nom^DB+Verb+Zero+Past+A3sg
farklı	fark+Noun+A3sg+Pnon+Nom^DB+Adj+With
yandaki	yan+Noun+A3sg+Pnon+Loc^DB+Adj+Rel
sahibiyle	sahip+Noun+A3sg+P3sg+Ins
renkteki	renk+Noun+A3sg+Pnon+Loc^DB+Adj+Rel
gayemdeki	gaye+Noun+A3sg+P1sg+Loc^DB+Adj+Rel
insansı	insan+Noun+A3sg+Pnon+Nom^DB+Adj+JustLike
korkusuz	korku+Noun+A3sg+Pnon+Nom^DB+Adj+Without
pembeleşen	pembe+Noun+A3sg+Pnon+Nom^DB+Verb+Become+Pos^DB+Adj+PresPart
sinirlenen	sinir+Noun+A3sg+Pnon+Nom^DB+Verb+Acquire+Pos^DB+Adj+PresPart
pratik	pratik+Noun+A3sg+Pnon+Nom
yemin	yemin+Noun+A3sg+Pnon+Nom
hayıflanıyorum	hayıf+Noun+A3sg+Pnon+Nom^DB+Verb+Acquire+Pos+Prog1+A1sg
şeyimiz	şey+Noun+A3sg+P1pl+Nom
sınavıdır	sınav+Noun+A3sg+P3sg+Nom^DB+Verb+Zero+Pres+A3sg+Cop
işaretsiz	işaret+Noun+A3sg+Pnon+Nom^DB+Adj+Without
temsilcisi	temsilci+Noun+A3sg+P3sg+Nom
durumsuz	durum+Noun+A3sg+Pnon+Nom^DB+Adj+Without
imtiyazıdır	imtiyaz+Noun+A3sg+P3sg+Nom^DB+Verb+Zero+Pres+A3sg+Cop
belasız	bela+Noun+A3sg+Pnon+Nom^DB+Adj+Without
çeşitli	çeşit+Noun+A3sg+Pnon+Nom^DB+Adj+With
heyecanlı	heyecan+Noun+A3sg+Pnon+Nom^DB+Adj+With
düşüncesiz	düşünce+Noun+A3sg+Pnon+Nom^DB+Adj+Without
kalabalığın	kalabalık+Noun+A3sg+Pnon+Gen
ahenkli	ahenk+Noun+A3sg+Pnon+Nom^DB+Adj+With
başlı	baş+Noun+A3sg+Pnon+Nom^DB+Adj+With
tinselleştirir	tinsel+Noun+A3sg+Pnon+Nom^DB+Verb+Become^DB+Verb+Caus+Pos+Aor+A3sg
katlardaki	kat+Noun+A3pl+Pnon+Loc^DB+Adj+Rel
anındaki	an+Noun+A3sg+P3sg+Loc^DB+Adj+Rel
rüyalarında	rüya+Noun+A3pl+P3sg+Loc
suskundu	susku+Noun+A3sg+P2sg+Nom^DB+Verb+Zero+Past+A3sg
şerefli	şeref+Noun+A3sg+Pnon+Nom^DB+Adj+With
başarılı	başarı+Noun+A3sg+Pnon+Nom^DB+Adj+With
gergindi	gergi+Noun+A3sg+P2sg+Nom^DB+Verb+Zero+Past+A3sg
boyardı	boyar+Noun+A3sg+Pnon+Nom^DB+Verb+Zero+Past+A3sg
hakimdi	haki+Noun+A3sg+P1sg+Nom^DB+Verb+Zero+Past+A3sg
oyunları	oyun+Noun+A3sg+P3pl+Nom
sanatçısının	sanatçı+Noun+A3sg+P3sg+Gen
üstteki	üst+Noun+A3sg+Pnon+Loc^DB+Adj+Rel
sonuçlanan	sonuç+Noun+A3sg+Pnon+Nom^DB+Verb+Acquire+Pos^DB+Adj+PresPart
canlanan	can+Noun+A3sg+Pnon+Nom^DB+Verb+Acquire+Pos^DB+Adj+PresPart
halindeki	hal+Noun+A3sg+P3sg+Loc^DB+Adj+Rel
em	em+Noun+A3sg+Pnon+Nom
sabırsızca	sabır+Noun+A3sg+Pnon+Nom^DB+Adj+Without^DB+Adj+AsIf
sebebin	sebep+Noun+A3sg+Pnon+Gen
kaftandı	kaftan+Noun+A3sg+Pnon+Nom^DB+Verb+Zero+Past+A3sg
düşkündü	düşkü+Noun+A3sg+P2sg+Nom^DB+Verb+Zero+Past+A3sg
ahlaklı	ahlak+Noun+A3sg+Pnon+Nom^DB+Adj+With
özelliklerindeki	özellik+Noun+A3pl+P3sg+Loc^DB+Adj+Rel
neşeli	neşe+Noun+A3sg+Pnon+Nom^DB+Adj+With
kızlı	kız+Noun+A3sg+Pnon+Nom^DB+Adj+With
üzüntülü	üzüntü+Noun+A3sg+Pnon+Nom^DB+Adj+With
köyündeki	köy+Noun+A3sg+P3sg+Loc^DB+Adj+Rel
alev	alev+Noun+A3sg+Pnon+Nom
arkadaşları	arkadaş+Noun+A3pl+Pnon+Acc
komik	komik+Noun+A3sg+Pnon+Nom
şarkılar	şarkı+Noun+A3pl+Pnon+Nom
zamanlı	zaman+Noun+A3sg+Pnon+Nom^DB+Adj+With
tuhafı	tuhaf+Noun+A3sg+P3sg+Nom
örnekteki	örnek+Noun+A3sg+Pnon+Loc^DB+Adj+Rel
annesiz	anne+Noun+A3sg+Pnon+Nom^DB+Adj+Without
melek	melek+Noun+A3sg+Pnon+Nom
şartlı	şart+Noun+A3sg+Pnon+Nom^DB+Adj+With
sesindeki	ses+Noun+A3sg+P3sg+Loc^DB+Adj+Rel
kanlı	kan+Noun+A3sg+Pnon+Nom^DB+Adj+With
haklı	hak+Noun+A3sg+Pnon+Nom^DB+Adj+With
ölümlüyüz	ölümlü+Noun+A3sg+Pnon+Nom^DB+Verb+Zero+Pres+A1pl
şahit	şahit+Noun+A3sg+Pnon+Nom
kuvvetli	kuvvet+Noun+A3sg+Pnon+Nom^DB+Adj+With
kurbanısınız	kurban+Noun+A3sg+P3sg+Nom^DB+Verb+Zero+Pres+A2pl
aşksız	aşk+Noun+A3sg+Pnon+Nom^DB+Adj+Without
çıkarınızı	çıkar+Noun+A3sg+P2pl+Acc
tecrübeli	tecrübe+Noun+A3sg+Pnon+Nom^DB+Adj+With
onurlu	onur+Noun+A3sg+Pnon+Nom^DB+Adj+With
ekli	ek+Noun+A3sg+Pnon+Nom^DB+Adj+With
hiddetli	hiddet+Noun+A3sg+Pnon+Nom^DB+Adj+With
kanatlı	kanat+Noun+A3sg+Pnon+Nom^DB+Adj+With
karlı	kar+Noun+A3sg+Pnon+Nom^DB+Adj+With
evdeki	ev+Noun+A3sg+Pnon+Loc^DB+Adj+Rel
göstergeleriydi	gösterge+Noun+A3pl+P3sg+Nom^DB+Verb+Zero+Past+A3sg
dehşetli	dehşet+Noun+A3sg+Pnon+Nom^DB+Adj+With
endişeli	endişe+Noun+A3sg+Pnon+Nom^DB+Adj+With
gerisindeki	geri+Noun+A3sg+P3sg+Loc^DB+Adj+Rel
köpeklere	köpek+Noun+A3pl+Pnon+Dat
engelli	engel+Noun+A3sg+Pnon+Nom^DB+Adj+With
güçsüz	güç+Noun+A3sg+Pnon+Nom^DB+Adj+Without
kurtlar	kurt+Noun+A3pl+Pnon+Nom
felaket	felaket+Noun+A3sg+Pnon+Nom
teláşlı	telaş+Noun+A3sg+Pnon+Nom^DB+Adj+With
öfkeli	öfke+Noun+A3sg+Pnon+Nom^DB+Adj+With
tetikteydi	tetik+Noun+A3sg+Pnon+Loc^DB+Verb+Zero+Past+A3sg
aradaki	ara+Noun+A3sg+Pnon+Loc^DB+Adj+Rel
faydalanan	fayda+Noun+A3sg+Pnon+Nom^DB+Verb+Acquire+Pos^DB+Adj+PresPart
çocuklu	çocuk+Noun+A3sg+Pnon+Nom^DB+Adj+With
efendilerce	efendi+Noun+A3pl+Pnon+Equ
malını	mal+Noun+A3sg+P3sg+Acc
tarifsiz	tarif+Noun+A3sg+Pnon+Nom^DB+Adj+Without
kısmetliydi	kısmet+Noun+A3sg+Pnon+Nom^DB+Adj+With^DB+Verb+Zero+Past+A3sg
hücum	hücum+Noun+A3sg+Pnon+Nom
kurlardaki	kur+Noun+A3pl+Pnon+Loc^DB+Adj+Rel
hırslı	hırs+Noun+A3sg+Pnon+Nom^DB+Adj+With
üzerimdeki	üzer+Noun+A3sg+P1sg+Loc^DB+Adj+Rel
uçlu	uç+Noun+A3sg+Pnon+Nom^DB+Adj+With
nedenli	neden+Noun+A3sg+Pnon+Nom^DB+Adj+With
kurumlu	kurum+Noun+A3sg+Pnon+Nom^DB+Adj+With
dostluğunuza	dost+Noun+A3sg+Pnon+Nom^DB+Noun+Ness+A3sg+P2pl+Dat
günkü	gün+Noun+A3sg+Pnon+Nom^DB+Adj+Rel
rıhtım	rıh+Noun+A3sg+Pnon+Nom^DB+Verb+Zero+Past+A1sg
esmer	esmer+Noun+A3sg+Pnon+Nom
kollu	kol+Noun+A3sg+Pnon+Nom^DB+Adj+With
vaziyette	vaziyet+Noun+A3sg+Pnon+Loc
tutumlu	tutum+Noun+A3sg+Pnon+Nom^DB+Adj+With
dinle	din+Noun+A3sg+Pnon+Ins
görevlendirilen	görev+Noun+A3sg+Pnon+Nom^DB+Verb+Acquire^DB+Verb+Caus^DB+Verb+Pass+Pos^DB+Adj+PresPart
kalçalarının	kalça+Noun+A3pl+P3sg+Gen
parçalı	parça+Noun+A3sg+Pnon+Nom^DB+Adj+With
biçimdeki	biçim+Noun+A3sg+Pnon+Loc^DB+Adj+Rel
şefkatli	şefkat+Noun+A3sg+Pnon+Nom^DB+Adj+With
ilgisiz	ilgi+Noun+A3sg+Pnon+Nom^DB+Adj+Without
sınırındaki	sınır+Noun+A3sg+P3sg+Loc^DB+Adj+Rel
buradaki	bura+Noun+A3sg+Pnon+Loc^DB+Adj+Rel
adamların	adam+Noun+A3pl+Pnon+Gen
yaramazsın	yaramaz+Noun+A3sg+Pnon+Nom^DB+Verb+Zero+Pres+A2sg
solundaki	sol+Noun+A3sg+P3sg+Loc^DB+Adj+Rel
eşyanın	eşya+Noun+A3sg+Pnon+Gen
bay	bay+Noun+A3sg+Pnon+Nom
yaşıyacağız	yaşıyacağ+Noun+A3sg+Pnon+Nom^DB+Verb+Zero+Pres+A1pl
tenekesidir	teneke+Noun+A3sg+P3sg+Nom^DB+Verb+Zero+Pres+A3sg+Cop
sobalar	soba+Noun+A3pl+Pnon+Nom
yıllıktır	yıllık+Noun+A3sg+Pnon+Nom^DB+Verb+Zero+Pres+A3sg+Cop
domuz	domuz+Noun+A3sg+Pnon+Nom
şanssız	şans+Noun+A3sg+Pnon+Nom^DB+Adj+Without
yerinizdeki	yer+Noun+A3sg+P2pl+Loc^DB+Adj+Rel
gevezeliğinin	geveze+Noun+A3sg+Pnon+Nom^DB+Noun+Ness+A3sg+P3sg+Gen
yasaklı	yasak+Noun+A3sg+Pnon+Nom^DB+Adj+With
tüysüz	tüy+Noun+A3sg+Pnon+Nom^DB+Adj+Without
adetini	adet+Noun+A3sg+P3sg+Acc
papazdan	papaz+Noun+A3sg+Pnon+Abl
hareketlenen	hareket+Noun+A3sg+Pnon+Nom^DB+Verb+Acquire+Pos^DB+Adj+PresPart
koridordaki	koridor+Noun+A3sg+Pnon+Loc^DB+Adj+Rel
önünüzdeki	ön+Noun+A3sg+P2pl+Loc^DB+Adj+Rel
alemsin	alem+Noun+A3sg+Pnon+Nom^DB+Verb+Zero+Pres+A2sg
çukurdu	çukur+Noun+A3sg+Pnon+Nom^DB+Verb+Zero+Past+A3sg
oralı	ora+Noun+A3sg+Pnon+Nom^DB+Adj+With
havadaki	hava+Noun+A3sg+Pnon+Loc^DB+Adj+Rel
odamdaki	oda+Noun+A3sg+P1sg+Loc^DB+Adj+Rel
masasındaki	masa+Noun+A3sg+P3sg+Loc^DB+Adj+Rel
mantarlı	mantar+Noun+A3sg+Pnon+Nom^DB+Adj+With
olaylı	olay+Noun+A3sg+Pnon+Nom^DB+Adj+With
beyi	bey+Noun+A3sg+P3sg+Nom
sıhhati	sıhhat+Noun+A3sg+P3sg+Nom
yukarıdaki	yukarı+Noun+A3sg+Pnon+Loc^DB+Adj+Rel
metanet	metanet+Noun+A3sg+Pnon+Nom
yarışındaki	yarış+Noun+A3sg+P3sg+Loc^DB+Adj+Rel
omuzlu	omuz+Noun+A3sg+Pnon+Nom^DB+Adj+With
direktti	direkt+Noun+A3sg+Pnon+Nom^DB+Verb+Zero+Past+A3sg
beyefendi	beyefendi+Noun+A3sg+Pnon+Nom
huzursuz	huzur+Noun+A3sg+Pnon+Nom^DB+Adj+Without
sandalyeler	sandalye+Noun+A3pl+Pnon+Nom
bahane	bahane+Noun+A3sg+Pnon+Nom
örtüsünün	örtü+Noun+A3sg+P3sg+Gen
örülüdür	örü+Noun+A3sg+Pnon+Nom^DB+Adj+With^DB+Verb+Zero+Pres+A3sg+Cop
paslı	pas+Noun+A3sg+Pnon+Nom^DB+Adj+With
dokunaklı	dokunak+Noun+A3sg+Pnon+Nom^DB+Adj+With
erkeklerdeki	erkek+Noun+A3pl+Pnon+Loc^DB+Adj+Rel
yemeğindeki	yemek+Noun+A3sg+P3sg+Loc^DB+Adj+Rel
değerlendirdiğiniz	değer+Noun+A3sg+Pnon+Nom^DB+Verb+Acquire^DB+Verb+Caus+Pos^DB+Adj+PastPart+P2pl
hazinesiydi	hazine+Noun+A3sg+P3sg+Nom^DB+Verb+Zero+Past+A3sg
çiçekli	çiçek+Noun+A3sg+Pnon+Nom^DB+Adj+With
nezleymiş	nezle+Noun+A3sg+Pnon+Nom^DB+Verb+Zero+Narr+A3sg
fetholunmuş	fetholun+Noun+A3sg+Pnon+Nom^DB+Verb+Zero+Narr+A3sg
hüzünlü	hüzün+Noun+A3sg+Pnon+Nom^DB+Adj+With
manastır	manas+Noun+A3sg+Pnon+Nom^DB+Verb+Zero+Pres+A3sg+Cop
eser	eser+Noun+A3sg+Pnon+Nom
karışımıdır	karışım+Noun+A3sg+P3sg+Nom^DB+Verb+Zero+Pres+A3sg+Cop
yoksulluğun	yoksul+Noun+A3sg+Pnon+Nom^DB+Noun+Ness+A3sg+Pnon+Gen
adlandırıldığı	ad+Noun+A3sg+Pnon+Nom^DB+Verb+Acquire^DB+Verb+Caus^DB+Verb+Pass+Pos^DB+Adj+PastPart+P3sg
yapıtlarındaki	yapıt+Noun+A3pl+P3sg+Loc^DB+Adj+Rel
üslubudur	üslup+Noun+A3sg+P3sg+Nom^DB+Verb+Zero+Pres+A3sg+Cop
çoğunluğunun	çoğunluk+Noun+A3sg+P3sg+Gen
realizmdir	realizm+Noun+A3sg+Pnon+Nom^DB+Verb+Zero+Pres+A3sg+Cop
pelteleşmiş	pelte+Noun+A3sg+Pnon+Nom^DB+Verb+Become+Pos+Narr+A3sg
ustabaşılar	ustabaşı+Noun+A3sg+Pnon+Nom^DB+Verb+Zero+Pres+A3pl
mutlulukları	mut+Noun+A3sg+Pnon+Nom^DB+Adj+With^DB+Noun+Ness+A3pl+P3sg+Nom
koyardı	koyar+Noun+A3sg+Pnon+Nom^DB+Verb+Zero+Past+A3sg
redetti	redet+Noun+A3sg+Pnon+Nom^DB+Verb+Zero+Past+A3sg
kederli	keder+Noun+A3sg+Pnon+Nom^DB+Adj+With
toparlamayamıyordu	toparlamayamıyor+Noun+A3sg+Pnon+Nom^DB+Verb+Zero+Past+A3sg
olursan	olur+Noun+A3sg+Pnon+Nom^DB+Verb+Zero+Cond+A2sg
yıllardaki	yıl+Noun+A3pl+Pnon+Loc^DB+Adj+Rel
alttaki	alt+Noun+A3sg+Pnon+Loc^DB+Adj+Rel
tüccara	tüccar+Noun+A3sg+Pnon+Dat
karısının	karı+Noun+A3sg+P3sg+Gen
hatıralarını	hatıra+Noun+A3pl+P3sg+Acc
mezar	mezar+Noun+A3sg+Pnon+Nom
bataklıktaki	batak+Noun+A3sg+Pnon+Nom^DB+Noun+Ness+A3sg+Pnon+Loc^DB+Adj+Rel
nehirdeki	nehir+Noun+A3sg+Pnon+Loc^DB+Adj+Rel
denizdeki	deniz+Noun+A3sg+Pnon+Loc^DB+Adj+Rel
keserim	keser+Noun+A3sg+Pnon+Nom^DB+Verb+Zero+Pres+A1sg
çizgili	çizgi+Noun+A3sg+Pnon+Nom^DB+Adj+With
kulesiydi	kule+Noun+A3sg+P3sg+Nom^DB+Verb+Zero+Past+A3sg
korsanmış	korsan+Noun+A3sg+Pnon+Nom^DB+Verb+Zero+Narr+A3sg
keskindi	keski+Noun+A3sg+P2sg+Nom^DB+Verb+Zero+Past+A3sg
boyundaki	boy+Noun+A3sg+P2sg+Loc^DB+Adj+Rel
değnekti	değnek+Noun+A3sg+Pnon+Nom^DB+Verb+Zero+Past+A3sg
akranımmış	akran+Noun+A3sg+P1sg+Nom^DB+Verb+Zero+Narr+A3sg
dakikadaki	dakika+Noun+A3sg+Pnon+Loc^DB+Adj+Rel
ekmeğin	ekmek+Noun+A3sg+Pnon+Gen
kişiler	kişi+Noun+A3pl+Pnon+Nom
arifesiydi	arife+Noun+A3sg+P3sg+Nom^DB+Verb+Zero+Past+A3sg
nezaketsiz	nezaket+Noun+A3sg+Pnon+Nom^DB+Adj+Without
soylu	soy+Noun+A3sg+Pnon+Nom^DB+Adj+With
sabahki	sabah+Noun+A3sg+Pnon+Nom^DB+Adj+Rel
nemli	nem+Noun+A3sg+Pnon+Nom^DB+Adj+With
şapkalı	şapka+Noun+A3sg+Pnon+Nom^DB+Adj+With
bataryadaydım	batarya+Noun+A3sg+Pnon+Loc^DB+Verb+Zero+Past+A1sg
eğlenceli	eğlence+Noun+A3sg+Pnon+Nom^DB+Adj+With
dirençliyimdir	direnç+Noun+A3sg+Pnon+Nom^DB+Adj+With^DB+Verb+Zero+Pres+A1sg+Cop
aklındaki	akıl+Noun+A3sg+P3sg+Loc^DB+Adj+Rel
idmanlıdır	idman+Noun+A3sg+Pnon+Nom^DB+Adj+With^DB+Verb+Zero+Pres+A3sg+Cop
çelikleştirir	çelik+Noun+A3sg+Pnon+Nom^DB+Verb+Become^DB+Verb+Caus+Pos+Aor+A3sg
nedimmiş	nedim+Noun+A3sg+Pnon+Nom^DB+Verb+Zero+Narr+A3sg
formüldeki	formül+Noun+A3sg+Pnon+Loc^DB+Adj+Rel
sıkıntılı	sıkıntı+Noun+A3sg+Pnon+Nom^DB+Adj+With
biberli	biber+Noun+A3sg+Pnon+Nom^DB+Adj+With
tasalanmayın	tasa+Noun+A3sg+Pnon+Nom^DB+Verb+Acquire+Neg+Imp+A2pl
metresiniz	metre+Noun+A3sg+Pnon+Nom^DB+Verb+Zero+Pres+A2pl
usuldendir	usul+Noun+A3sg+Pnon+Abl^DB+Verb+Zero+Pres+A3sg+Cop
kafesin	kafes+Noun+A3sg+Pnon+Gen
ellerindeki	el+Noun+A3pl+P3sg+Loc^DB+Adj+Rel
işsiz	iş+Noun+A3sg+Pnon+Nom^DB+Adj+Without
uzmansam	uzman+Noun+A3sg+Pnon+Nom^DB+Verb+Zero+Cond+A1sg
erbapsın	erbap+Noun+A3sg+Pnon+Nom^DB+Verb+Zero+Pres+A2sg
şüpheli	şüphe+Noun+A3sg+Pnon+Nom^DB+Adj+With
emrindeki	emir+Noun+A3sg+P3sg+Loc^DB+Adj+Rel
dişsiz	diş+Noun+A3sg+Pnon+Nom^DB+Adj+Without
kokulu	koku+Noun+A3sg+Pnon+Nom^DB+Adj+With
dantelasındandı	dantela+Noun+A3sg+P3sg+Abl^DB+Verb+Zero+Past+A3sg
isli	is+Noun+A3sg+Pnon+Nom^DB+Adj+With
süslü	süs+Noun+A3sg+Pnon+Nom^DB+Adj+With
lordu	lor+Noun+A3sg+Pnon+Nom^DB+Verb+Zero+Past+A3sg
tahminlerinin	tahmin+Noun+A3pl+P3sg+Gen
oğlunuz	oğul+Noun+A3sg+P2pl+Nom
öteki	öte+Noun+A3sg+Pnon+Nom^DB+Adj+Rel
net	net+Noun+A3sg+Pnon+Nom
rüzgarlı	rüzgar+Noun+A3sg+Pnon+Nom^DB+Adj+With
senedir	sene+Noun+A3sg+Pnon+Nom^DB+Verb+Zero+Pres+A3sg+Cop
eksikli	eksik+Noun+A3sg+Pnon+Nom^DB+Adj+With
tedbirli	tedbir+Noun+A3sg+Pnon+Nom^DB+Adj+With
ayaklı	ayak+Noun+A3sg+Pnon+Nom^DB+Adj+With
misafirleri	misafir+Noun+A3pl+P3sg+Nom
taşralı	taşra+Noun+A3sg+Pnon+Nom^DB+Adj+With
avukatımdı	avukat+Noun+A3sg+P1sg+Nom^DB+Verb+Zero+Past+A3sg
gözündeki	göz+Noun+A3sg+P3sg+Loc^DB+Adj+Rel
dolabındaki	dolap+Noun+A3sg+P3sg+Loc^DB+Adj+Rel
hiçe	hiç+Noun+A3sg+Pnon+Dat
kaplanmış	kaplan+Noun+A3sg+Pnon+Nom^DB+Verb+Zero+Narr+A3sg
franktı	frank+Noun+A3sg+Pnon+Nom^DB+Verb+Zero+Past+A3sg
borçlu	borç+Noun+A3sg+Pnon+Nom^DB+Adj+With
aylarındaki	ay+Noun+A3pl+P3sg+Loc^DB+Adj+Rel
saatlerindeki	saat+Noun+A3pl+P3sg+Loc^DB+Adj+Rel
şaheserler	şaheser+Noun+A3pl+Pnon+Nom
ülkemdeki	ülke+Noun+A3sg+P1sg+Loc^DB+Adj+Rel
kayıttaki	kayıt+Noun+A3sg+Pnon+Loc^DB+Adj+Rel
generalle	general+Noun+A3sg+Pnon+Ins
ihtimal	ihtimal+Noun+A3sg+Pnon+Nom
topraklardaki	toprak+Noun+A3pl+Pnon+Loc^DB+Adj+Rel
yüzyılda	yüzyıl+Noun+A3sg+Pnon+Loc
dengidir	denk+Noun+A3sg+P3sg+Nom^DB+Verb+Zero+Pres+A3sg+Cop
hain	hain+Noun+A3sg+Pnon+Nom
toptan	top+Noun+A3sg+Pnon+Abl
nöbetteki	nöbet+Noun+A3sg+Pnon+Loc^DB+Adj+Rel
doktordu	doktor+Noun+A3sg+Pnon+Nom^DB+Verb+Zero+Past+A3sg
sayısındaki	sayı+Noun+A3sg+P3sg+Loc^DB+Adj+Rel
ölümdür	ölüm+Noun+A3sg+Pnon+Nom^DB+Verb+Zero+Pres+A3sg+Cop
uslu	us+Noun+A3sg+Pnon+Nom^DB+Adj+With
dikkatli	dikkat+Noun+A3sg+Pnon+Nom^DB+Adj+With
durultmuştu	durultmuş+Noun+A3sg+Pnon+Nom^DB+Verb+Zero+Past+A3sg
yararlanan	yarar+Noun+A3sg+Pnon+Nom^DB+Verb+Acquire+Pos^DB+Adj+PresPart
yaslı	yas+Noun+A3sg+Pnon+Nom^DB+Adj+With
yönündeki	yön+Noun+A3sg+P3sg+Loc^DB+Adj+Rel
veremdi	vere+Noun+A3sg+P1sg+Nom^DB+Verb+Zero+Past+A3sg
asılıydı	ası+Noun+A3sg+Pnon+Nom^DB+Adj+With^DB+Verb+Zero+Past+A3sg
derindi	deri+Noun+A3sg+P2sg+Nom^DB+Verb+Zero+Past+A3sg
hastalıklı	hastalık+Noun+A3sg+Pnon+Nom^DB+Adj+With
gürültülü	gürültü+Noun+A3sg+Pnon+Nom^DB+Adj+With
konumundaki	konum+Noun+A3sg+P3sg+Loc^DB+Adj+Rel
hızlıca	hız+Noun+A3sg+Pnon+Nom^DB+Adj+With^DB+Adj+AsIf
kentli	kent+Noun+A3sg+Pnon+Nom^DB+Adj+With
önemlice	önem+Noun+A3sg+Pnon+Nom^DB+Adj+With^DB+Adj+AsIf
yürekli	yürek+Noun+A3sg+Pnon+Nom^DB+Adj+With
hastaneydi	hastane+Noun+A3sg+Pnon+Nom^DB+Verb+Zero+Past+A3sg
teğmendi	teğmen+Noun+A3sg+Pnon+Nom^DB+Verb+Zero+Past+A3sg
sorumluluk	sorumlu+Noun+A3sg+Pnon+Nom^DB+Noun+Ness+A3sg+Pnon+Nom
imkansız	imkan+Noun+A3sg+Pnon+Nom^DB+Adj+Without
karşımdaki	karşı+Noun+A3sg+P1sg+Loc^DB+Adj+Rel
mucize	mucize+Noun+A3sg+Pnon+Nom
ağlacaktı	ağlacak+Noun+A3sg+Pnon+Nom^DB+Verb+Zero+Past+A3sg
kaygılı	kaygı+Noun+A3sg+Pnon+Nom^DB+Adj+With
köşelerindeki	köşe+Noun+A3pl+P3sg+Loc^DB+Adj+Rel
parasız	para+Noun+A3sg+Pnon+Nom^DB+Adj+Without
soluksuz	soluk+Noun+A3sg+Pnon+Nom^DB+Adj+Without
sonundaki	son+Noun+A3sg+P2sg+Loc^DB+Adj+Rel
muhtaç	muhtaç+Noun+A3sg+Pnon+Nom
sözüyordu	sözüyor+Noun+A3sg+Pnon+Nom^DB+Verb+Zero+Past+A3sg
birlikteydiler	birlik+Noun+A3sg+Pnon+Loc^DB+Verb+Zero+Past+A3pl
haftaki	hafta+Noun+A3sg+Pnon+Nom^DB+Adj+Rel
avans	avans+Noun+A3sg+Pnon+Nom
hesapsızca	hesap+Noun+A3sg+Pnon+Nom^DB+Adj+Without^DB+Adj+AsIf
liraya	lira+Noun+A3sg+Pnon+Dat
ödemelerinin	ödeme+Noun+A3pl+P3sg+Gen
döviz	döviz+Noun+A3sg+Pnon+Nom
rezervlerindeki	rezerv+Noun+A3pl+P3sg+Loc^DB+Adj+Rel
dolarlı	dolar+Noun+A3sg+Pnon+Nom^DB+Adj+With
kaynaklı	kaynak+Noun+A3sg+Pnon+Nom^DB+Adj+With
tutarını	tutar+Noun+A3sg+P3sg+Acc
bilançosuna	bilanço+Noun+A3sg+P3sg+Dat
varlığından	varlık+Noun+A3sg+P3sg+Abl
ölçülü	ölçü+Noun+A3sg+Pnon+Nom^DB+Adj+With
toplamı	toplam+Noun+A3sg+Pnon+Acc
kredilerin	kredi+Noun+A3pl+Pnon+Gen
yolundaki	yol+Noun+A3sg+P3sg+Loc^DB+Adj+Rel
piyasalara	piyasa+Noun+A3pl+Pnon+Dat
likiditenin	likidite+Noun+A3sg+Pnon+Gen
etkisiz	etki+Noun+A3sg+Pnon+Nom^DB+Adj+Without
itibarlı	itibar+Noun+A3sg+Pnon+Nom^DB+Adj+With
düzeyindeki	düzey+Noun+A3sg+P3sg+Loc^DB+Adj+Rel
emisyon	emisyon+Noun+A3sg+Pnon+Nom
miktarda	miktar+Noun+A3sg+Pnon+Loc
verilerindeki	veri+Noun+A3pl+P3sg+Loc^DB+Adj+Rel
tarihli	tarih+Noun+A3sg+Pnon+Nom^DB+Adj+With
kamu	kamu+Noun+A3sg+Pnon+Nom
kuruluştaki	kuruluş+Noun+A3sg+Pnon+Loc^DB+Adj+Rel
şoku	şok+Noun+A3sg+P3sg+Nom
petrol	petrol+Noun+A3sg+Pnon+Nom
boru	boru+Noun+A3sg+Pnon+Nom
hatlarının	hat+Noun+A3pl+P3sg+Gen
fiyatlarındaki	fiyat+Noun+A3pl+P3sg+Loc^DB+Adj+Rel
kotanın	kota+Noun+A3sg+Pnon+Gen
firmadaki	firma+Noun+A3sg+Pnon+Loc^DB+Adj+Rel
sözleşme	sözleşme+Noun+A3sg+Pnon+Nom
iptal	iptal+Noun+A3sg+Pnon+Nom
gıdaya	gıda+Noun+A3sg+Pnon+Dat
izinli	izin+Noun+A3sg+Pnon+Nom^DB+Adj+With
yönetimindeki	yönetim+Noun+A3sg+P3sg+Loc^DB+Adj+Rel
talebini	talep+Noun+A3sg+P3sg+Acc
üyesi	üye+Noun+A3sg+P3sg+Nom
diplomatları	diplomat+Noun+A3pl+P3pl+Nom
aylık	aylık+Noun+A3sg+Pnon+Nom
süresiz	süre+Noun+A3sg+Pnon+Nom^DB+Adj+Without
gözönüne	gözönü+Noun+A3sg+P3sg+Dat
unlu	un+Noun+A3sg+Pnon+Nom^DB+Adj+With
dünyamızdaki	dünya+Noun+A3sg+P1pl+Loc^DB+Adj+Rel
şirkette	şirket+Noun+A3sg+Pnon+Loc
parametreler	parametre+Noun+A3pl+Pnon+Nom
hacimdeki	hacim+Noun+A3sg+Pnon+Loc^DB+Adj+Rel
yarısındaki	yarı+Noun+A3sg+P3sg+Loc^DB+Adj+Rel
sinyalini	sinyal+Noun+A3sg+P3sg+Acc
sendikacı	sendikacı+Noun+A3sg+Pnon+Nom
suçlu	suç+Noun+A3sg+Pnon+Nom^DB+Adj+With
duyurusunda	duyuru+Noun+A3sg+P3sg+Loc
hakaretlerden	hakaret+Noun+A3pl+Pnon+Abl
gerekçeli	gerekçe+Noun+A3sg+Pnon+Nom^DB+Adj+With
dilekçesinde	dilekçe+Noun+A3sg+P3sg+Loc
ifadeyle	ifade+Noun+A3sg+Pnon+Ins
tazminat	tazminat+Noun+A3sg+Pnon+Nom
istemiyle	istem+Noun+A3sg+P3sg+Ins
davası	dava+Noun+A3sg+P3sg+Nom
duruşması	duruşma+Noun+A3sg+P3sg+Nom
hedeflerine	hedef+Noun+A3pl+P3sg+Dat
rektörlerini	rektör+Noun+A3pl+P3pl+Acc
türbanlı	türban+Noun+A3sg+Pnon+Nom^DB+Adj+With
girişimlerin	girişim+Noun+A3pl+Pnon+Gen
kriz	kriz+Noun+A3sg+Pnon+Nom
raporundaki	rapor+Noun+A3sg+P3sg+Loc^DB+Adj+Rel
üniversiteli	üniversite+Noun+A3sg+Pnon+Nom^DB+Adj+With
başörtülü	başörtü+Noun+A3sg+Pnon+Nom^DB+Adj+With
ortadaki	orta+Noun+A3sg+Pnon+Loc^DB+Adj+Rel
öğretim	öğretim+Noun+A3sg+Pnon+Nom
merkezdeki	merkez+Noun+A3sg+Pnon+Loc^DB+Adj+Rel
gençlikte	gençlik+Noun+A3sg+Pnon+Loc
örgütü	örgüt+Noun+A3sg+P3sg+Nom
bilgiye	bilgi+Noun+A3sg+Pnon+Dat
öğrenciye	öğrenci+Noun+A3sg+Pnon+Dat
yasasında	yasa+Noun+A3sg+P3sg+Loc
fakültelerinden	fakülte+Noun+A3pl+P3sg+Abl
tepkisiz	tepki+Noun+A3sg+Pnon+Nom^DB+Adj+Without
imzalı	imza+Noun+A3sg+Pnon+Nom^DB+Adj+With
dün	dün+Noun+A3sg+Pnon+Nom
temelsiz	temel+Noun+A3sg+Pnon+Nom^DB+Adj+Without
boyutlu	boyut+Noun+A3sg+Pnon+Nom^DB+Adj+With
arkamızdaki	arka+Noun+A3sg+P1pl+Loc^DB+Adj+Rel
kıyafetler	kıyafet+Noun+A3pl+Pnon+Nom
devrimlerine	devrim+Noun+A3pl+P3sg+Dat
sözden	söz+Noun+A3sg+Pnon+Abl
nefretiyle	nefret+Noun+A3sg+P3sg+Ins
cevapsız	cevap+Noun+A3sg+Pnon+Nom^DB+Adj+Without
yardımıyla	yardım+Noun+A3sg+P3sg+Ins
çöplerin	çöp+Noun+A3pl+Pnon+Gen
evraklarım	evrak+Noun+A3pl+P1sg+Nom
kahramanlı	kahraman+Noun+A3sg+Pnon+Nom^DB+Adj+With
zararlı	zarar+Noun+A3sg+Pnon+Nom^DB+Adj+With
kardeşi	kardeş+Noun+A3sg+P3sg+Nom
oğlanla	oğlan+Noun+A3sg+Pnon+Ins
omnibüslerin	omnibüs+Noun+A3pl+Pnon+Gen
yakın	yakı+Noun+A3sg+P2sg+Nom
istirahat	istirahat+Noun+A3sg+Pnon+Nom
ısrarlı	ısrar+Noun+A3sg+Pnon+Nom^DB+Adj+With
kalıptan	kalıp+Noun+A3sg+Pnon+Abl
sahneyi	sahne+Noun+A3sg+Pnon+Acc
türündeki	tür+Noun+A3sg+P3sg+Loc^DB+Adj+Rel
kalpli	kalp+Noun+A3sg+Pnon+Nom^DB+Adj+With
nebze	nebze+Noun+A3sg+Pnon+Nom
kıskançlık	kıskanç+Noun+A3sg+Pnon+Nom^DB+Noun+Ness+A3sg+Pnon+Nom
boynundaki	boyun+Noun+A3sg+P3sg+Loc^DB+Adj+Rel
parmağındaki	parmak+Noun+A3sg+P3sg+Loc^DB+Adj+Rel
muhabbetle	muhabbet+Noun+A3sg+Pnon+Ins
aşağıdaki	aşağı+Noun+A3sg+Pnon+Loc^DB+Adj+Rel
şikayet	şikayet+Noun+A3sg+Pnon+Nom
sofranıza	sofra+Noun+A3sg+P2pl+Dat
etrafımdaki	etraf+Noun+A3sg+P1sg+Loc^DB+Adj+Rel
binek	binek+Noun+A3sg+Pnon+Nom
arabasındaki	araba+Noun+A3sg+P3sg+Loc^DB+Adj+Rel
patırtısız	patırtı+Noun+A3sg+Pnon+Nom^DB+Adj+Without
azıya	azı+Noun+A3sg+Pnon+Dat
vaktim	vakit+Noun+A3sg+P1sg+Nom
tabaklarını	tabak+Noun+A3pl+P3pl+Acc
habersiz	haber+Noun+A3sg+Pnon+Nom^DB+Adj+Without
dudaklı	dudak+Noun+A3sg+Pnon+Nom^DB+Adj+With
makineli	makine+Noun+A3sg+Pnon+Nom^DB+Adj+With
pırtık	pırtık+Noun+A3sg+Pnon+Nom
dantel	dantel+Noun+A3sg+Pnon+Nom
mendil	mendil+Noun+A3sg+Pnon+Nom
kapıdaki	kapı+Noun+A3sg+Pnon+Loc^DB+Adj+Rel
merhametli	merhamet+Noun+A3sg+Pnon+Nom^DB+Adj+With
sorusuna	soru+Noun+A3sg+P3sg+Dat
geceki	gece+Noun+A3sg+Pnon+Nom^DB+Adj+Rel
açıdan	açı+Noun+A3sg+Pnon+Abl
hüsran	hüsran+Noun+A3sg+Pnon+Nom
şekilsiz	şekil+Noun+A3sg+Pnon+Nom^DB+Adj+Without
deneyimsiz	deneyim+Noun+A3sg+Pnon+Nom^DB+Adj+Without
hayattaki	hayat+Noun+A3sg+Pnon+Loc^DB+Adj+Rel
hayret	hayret+Noun+A3sg+Pnon+Nom
yanıtsız	yanıt+Noun+A3sg+Pnon+Nom^DB+Adj+Without
yumruğumda	yumruk+Noun+A3sg+P1sg+Loc
temin	temin+Noun+A3sg+Pnon+Nom
aleyhindeki	aleyh+Noun+A3sg+P3sg+Loc^DB+Adj+Rel
ağzındaki	ağız+Noun+A3sg+P3sg+Loc^DB+Adj+Rel
küfürlerle	küfür+Noun+A3pl+Pnon+Ins
sınıf	sınıf+Noun+A3sg+Pnon+Nom
ailesindeki	aile+Noun+A3sg+P3sg+Loc^DB+Adj+Rel
mensup	mensup+Noun+A3sg+Pnon+Nom
kadının	kadı+Noun+A3sg+Pnon+Gen
utancından	utanç+Noun+A3sg+P3sg+Abl
hislerini	his+Noun+A3pl+P3sg+Acc
evladımın	evlat+Noun+A3sg+P1sg+Gen
izini	iz+Noun+A3sg+P3sg+Acc
mübalağaya	mübalağa+Noun+A3sg+Pnon+Dat
eşleşmeyen	eş+Noun+A3sg+Pnon+Nom^DB+Verb+Become+Neg^DB+Adj+PresPart
çılgınca	çılgın+Noun+A3sg+Pnon+Equ
canlılar	canlı+Noun+A3pl+Pnon+Nom
atmosfere	atmosfer+Noun+A3sg+Pnon+Dat
kez	kez+Noun+A3sg+Pnon+Nom
takdirle	takdir+Noun+A3sg+Pnon+Ins
tonlarındaki	ton+Noun+A3pl+P3sg+Loc^DB+Adj+Rel
devamlı	devam+Noun+A3sg+Pnon+Nom^DB+Adj+With
kontrollü	kontrol+Noun+A3sg+Pnon+Nom^DB+Adj+With
uşağa	uşak+Noun+A3sg+Pnon+Dat
bagaj	bagaj+Noun+A3sg+Pnon+Nom
detaylı	detay+Noun+A3sg+Pnon+Nom^DB+Adj+With
esnada	esna+Noun+A3sg+Pnon+Loc
camlı	cam+Noun+A3sg+Pnon+Nom^DB+Adj+With
hayalimizdeki	hayal+Noun+A3sg+P1pl+Loc^DB+Adj+Rel
fırsatı	fırsat+Noun+A3sg+Pnon+Acc
ziyan	ziyan+Noun+A3sg+Pnon+Nom
tesellisi	teselli+Noun+A3sg+P3sg+Nom
cümle	cümle+Noun+A3sg+Pnon+Nom
rica	rica+Noun+A3sg+Pnon+Nom
tehdide	tehdit+Noun+A3sg+Pnon+Dat
akşamki	akşam+Noun+A3sg+Pnon+Nom^DB+Adj+Rel
ceketiyle	ceket+Noun+A3sg+P3sg+Ins
garsonun	garson+Noun+A3sg+Pnon+Gen
umarsız	umar+Noun+A3sg+Pnon+Nom^DB+Adj+Without
mesele	mesele+Noun+A3sg+Pnon+Nom
badanalı	badana+Noun+A3sg+Pnon+Nom^DB+Adj+With
kaşları	kaş+Noun+A3pl+P3sg+Nom
aktris	aktris+Noun+A3sg+Pnon+Nom
sıralarındaki	sıra+Noun+A3pl+P3sg+Loc^DB+Adj+Rel
nikáhlı	nikah+Noun+A3sg+Pnon+Nom^DB+Adj+With
haricinde	hariç+Noun+A3sg+P3sg+Loc
şakaya	şaka+Noun+A3sg+Pnon+Dat
evliliğe	evlilik+Noun+A3sg+Pnon+Dat
anı	anı+Noun+A3sg+Pnon+Nom
nişanlılığa	nişanlı+Noun+A3sg+Pnon+Nom^DB+Noun+Ness+A3sg+Pnon+Dat
variyetini	variyet+Noun+A3sg+P3sg+Acc
tabiatlı	tabiat+Noun+A3sg+Pnon+Nom^DB+Adj+With
ifsat	ifsat+Noun+A3sg+Pnon+Nom
vermut	vermut+Noun+A3sg+Pnon+Nom
portakalları	portakal+Noun+A3pl+P3sg+Nom
kokteylini	kokteyl+Noun+A3sg+P3sg+Acc
portresi	portre+Noun+A3sg+P3sg+Nom
yetenekli	yetenek+Noun+A3sg+Pnon+Nom^DB+Adj+With
hususiyetler	hususiyet+Noun+A3pl+Pnon+Nom
tesirini	tesir+Noun+A3sg+P3sg+Acc
randevu	randevu+Noun+A3sg+Pnon+Nom
konudaki	konu+Noun+A3sg+Pnon+Loc^DB+Adj+Rel
önyargılarımızı	önyargı+Noun+A3pl+P1pl+Acc
şahsiyetin	şahsiyet+Noun+A3sg+Pnon+Gen
tercih	tercih+Noun+A3sg+Pnon+Nom
piyesine	piyes+Noun+A3sg+P3sg+Dat
teklifte	teklif+Noun+A3sg+Pnon+Loc
taraftarı	taraftar+Noun+A3sg+P3sg+Nom
mahzuru	mahzur+Noun+A3sg+P3sg+Nom
mizaçlar	mizaç+Noun+A3pl+Pnon+Nom
egosunu	ego+Noun+A3sg+P3sg+Acc
insanoğlunun	insanoğlu+Noun+A3sg+P3sg+Gen
varoluş	varoluş+Noun+A3sg+Pnon+Nom
hayranlık	hayran+Noun+A3sg+Pnon+Nom^DB+Noun+Ness+A3sg+Pnon+Nom
kelimeleri	kelime+Noun+A3pl+Pnon+Acc
hükmü	hüküm+Noun+A3sg+P3sg+Nom
komşusu	komşu+Noun+A3sg+P3sg+Nom
erdemleri	erdem+Noun+A3pl+P3sg+Nom
umutlu	umut+Noun+A3sg+Pnon+Nom^DB+Adj+With
bankerleri	banker+Noun+A3pl+P3sg+Nom
cüzdanlarındaki	cüzdan+Noun+A3pl+P3sg+Loc^DB+Adj+Rel
soygunculuk	soyguncu+Noun+A3sg+Pnon+Nom^DB+Noun+Ness+A3sg+Pnon+Nom
teşvik	teşvik+Noun+A3sg+Pnon+Nom
cazibesini	cazibe+Noun+A3sg+P3sg+Acc
saten	saten+Noun+A3sg+Pnon+Nom
pelerinli	pelerin+Noun+A3sg+Pnon+Nom^DB+Adj+With
ömür	ömür+Noun+A3sg+Pnon+Nom
ümitli	ümit+Noun+A3sg+Pnon+Nom^DB+Adj+With
haberdar	haberdar+Noun+A3sg+Pnon+Nom
laf	laf+Noun+A3sg+Pnon+Nom
aşçıbaşımın	aşçıbaşı+Noun+A3sg+P1sg+Gen
marifetlerini	marifet+Noun+A3pl+P3sg+Acc
restoranda	restoran+Noun+A3sg+Pnon+Loc
tiyatrosuz	tiyatro+Noun+A3sg+Pnon+Nom^DB+Adj+Without
gömleğini	gömlek+Noun+A3sg+P3sg+Acc
yeleğini	yelek+Noun+A3sg+P3sg+Acc
pantolonlu	pantolon+Noun+A3sg+Pnon+Nom^DB+Adj+With
şahin	şahin+Noun+A3sg+Pnon+Nom
atölyende	atölye+Noun+A3sg+P2sg+Loc
heykeli	heykel+Noun+A3sg+Pnon+Acc
zarafet	zarafet+Noun+A3sg+Pnon+Nom
yapraklı	yaprak+Noun+A3sg+Pnon+Nom^DB+Adj+With
locada	loca+Noun+A3sg+Pnon+Loc
kimseyi	kimse+Noun+A3sg+Pnon+Acc
ormanınızdaki	orman+Noun+A3sg+P2pl+Loc^DB+Adj+Rel
hazdan	haz+Noun+A3sg+Pnon+Abl
nilüfer	nilüfer+Noun+A3sg+Pnon+Nom
sırlarını	sır+Noun+A3pl+P3sg+Acc
pençe	pençe+Noun+A3sg+Pnon+Nom
fikirli	fikir+Noun+A3sg+Pnon+Nom^DB+Adj+With
kulağa	kulak+Noun+A3sg+Pnon+Dat
tavırlı	tavır+Noun+A3sg+Pnon+Nom^DB+Adj+With
şampanya	şampanya+Noun+A3sg+Pnon+Nom
hususunda	husus+Noun+A3sg+P3sg+Loc
mukavelesi	mukavele+Noun+A3sg+P3sg+Nom
önerisinde	öneri+Noun+A3sg+P3sg+Loc
bizlerden	biz+Noun+A3pl+Pnon+Abl
ekseriyetle	ekseriyet+Noun+A3sg+Pnon+Ins
meraklı	merak+Noun+A3sg+Pnon+Nom^DB+Adj+With
teorilerimin	teori+Noun+A3pl+P1sg+Gen
iflah	iflah+Noun+A3sg+Pnon+Nom
yazık	yazık+Noun+A3sg+Pnon+Nom
kaide	kaide+Noun+A3sg+Pnon+Nom
dalgalı	dalga+Noun+A3sg+Pnon+Nom^DB+Adj+With
inançlı	inanç+Noun+A3sg+Pnon+Nom^DB+Adj+With
salata	salata+Noun+A3sg+Pnon+Nom
kuram	kuram+Noun+A3sg+Pnon+Nom
iddialı	iddia+Noun+A3sg+Pnon+Nom^DB+Adj+With
onayın	onay+Noun+A3sg+Pnon+Gen
demeti	demet+Noun+A3sg+P3sg+Nom
kastın	kast+Noun+A3sg+Pnon+Gen
kadehteki	kadeh+Noun+A3sg+Pnon+Loc^DB+Adj+Rel
uyumsuz	uyum+Noun+A3sg+Pnon+Nom^DB+Adj+Without
yargıya	yargı+Noun+A3sg+Pnon+Dat
amaçlı	amaç+Noun+A3sg+Pnon+Nom^DB+Adj+With
anlayışlı	anlayış+Noun+A3sg+Pnon+Nom^DB+Adj+With
çağındaki	çağ+Noun+A3sg+P3sg+Loc^DB+Adj+Rel
kabulünü	kabul+Noun+A3sg+P3sg+Acc
gelenekçi	gelenekçi+Noun+A3sg+Pnon+Nom
farz	farz+Noun+A3sg+Pnon+Nom
bedelini	bedel+Noun+A3sg+P3sg+Acc
ressamın	ressam+Noun+A3sg+Pnon+Gen
şimdiki	şimdi+Noun+A3sg+Pnon+Nom^DB+Adj+Rel
derecedeki	derece+Noun+A3sg+Pnon+Loc^DB+Adj+Rel
fakirlerin	fakir+Noun+A3pl+Pnon+Gen
trajedisi	trajedi+Noun+A3sg+P3sg+Nom
feragattan	feragat+Noun+A3sg+Pnon+Abl
satın	satın+Noun+A3sg+Pnon+Nom
günah	günah+Noun+A3sg+Pnon+Nom
velev	velev+Noun+A3sg+Pnon+Nom
ıstıraplardan	ıstırap+Noun+A3pl+Pnon+Abl
ortaçağa	ortaçağ+Noun+A3sg+Pnon+Dat
sanattan	sanat+Noun+A3sg+Pnon+Abl
modası	moda+Noun+A3sg+P3sg+Nom
romanlar	roman+Noun+A3pl+Pnon+Nom
barbar	barbar+Noun+A3sg+Pnon+Nom
meyvelerle	meyve+Noun+A3pl+Pnon+Ins
tanrılarına	tanrı+Noun+A3pl+P3sg+Dat
dileğiyle	dilek+Noun+A3sg+P3sg+Ins
mücevherli	mücevher+Noun+A3sg+Pnon+Nom^DB+Adj+With
göğsünün	göğüs+Noun+A3sg+P3sg+Gen
azarı	azar+Noun+A3sg+P3sg+Nom
galeyana	galeyan+Noun+A3sg+Pnon+Dat
ilham	ilham+Noun+A3sg+Pnon+Nom
mani	mani+Noun+A3sg+Pnon+Nom
kahvenin	kahve+Noun+A3sg+Pnon+Gen
sigaralarını	sigara+Noun+A3pl+P3sg+Acc
tanesi	tane+Noun+A3sg+P3sg+Nom
puro	puro+Noun+A3sg+Pnon+Nom
içmeni	içme+Noun+A3sg+P2sg+Acc
tasvip	tasvip+Noun+A3sg+Pnon+Nom
keyiflenen	keyif+Noun+A3sg+Pnon+Nom^DB+Verb+Acquire+Pos^DB+Adj+PresPart
cüretli	cüret+Noun+A3sg+Pnon+Nom^DB+Adj+With
temsil	temsil+Noun+A3sg+Pnon+Nom
ejderha	ejderha+Noun+A3sg+Pnon+Nom
çakmak	çakmak+Noun+A3sg+Pnon+Nom
ateşli	ateş+Noun+A3sg+Pnon+Nom^DB+Adj+With
ideale	ideal+Noun+A3sg+Pnon+Dat
kupa	kupa+Noun+A3sg+Pnon+Nom
kişiliği	kişilik+Noun+A3sg+P3sg+Nom
takiplerinden	takip+Noun+A3pl+P3sg+Abl
kasvetli	kasvet+Noun+A3sg+Pnon+Nom^DB+Adj+With
merdivendeki	merdiven+Noun+A3sg+Pnon+Loc^DB+Adj+Rel
ışıklı	ışık+Noun+A3sg+Pnon+Nom^DB+Adj+With
caddelerindeki	cadde+Noun+A3pl+P3sg+Loc^DB+Adj+Rel
edálı	eda+Noun+A3sg+Pnon+Nom^DB+Adj+With
lobilerine	lobi+Noun+A3pl+P3sg+Dat
şiir	şiir+Noun+A3sg+Pnon+Nom
dehasının	deha+Noun+A3sg+P3sg+Gen
hararet	hararet+Noun+A3sg+Pnon+Nom
taç	taç+Noun+A3sg+Pnon+Nom
yıldızlı	yıldız+Noun+A3sg+Pnon+Nom^DB+Adj+With
kenarlarındaki	kenar+Noun+A3pl+P3sg+Loc^DB+Adj+Rel
şişeyle	şişe+Noun+A3sg+Pnon+Ins
tanrıça	tanrıça+Noun+A3sg+Pnon+Nom
ağınızdaki	ağ+Noun+A3sg+P2pl+Loc^DB+Adj+Rel
seyircisiz	seyirci+Noun+A3sg+Pnon+Nom^DB+Adj+Without
keman	keman+Noun+A3sg+Pnon+Nom
opera	opera+Noun+A3sg+Pnon+Nom
dürbünle	dürbün+Noun+A3sg+Pnon+Ins
salonundaki	salon+Noun+A3sg+P3sg+Loc^DB+Adj+Rel
ruhumdaki	ruh+Noun+A3sg+P1sg+Loc^DB+Adj+Rel
uğurlu	uğur+Noun+A3sg+Pnon+Nom^DB+Adj+With
gözyaşlarına	gözyaşı+Noun+A3pl+P3pl+Dat
orkestra	orkestra+Noun+A3sg+Pnon+Nom
perdeler	perde+Noun+A3pl+Pnon+Nom
alkış	alkış+Noun+A3sg+Pnon+Nom
tufanı	tufan+Noun+A3sg+P3sg+Nom
mahlûklardan	mahluk+Noun+A3pl+Pnon+Abl
yavrum	yavru+Noun+A3sg+P1sg+Nom
ceylanı	ceylan+Noun+A3sg+P3sg+Nom
yanaklı	yanak+Noun+A3sg+Pnon+Nom^DB+Adj+With
aynalı	ayna+Noun+A3sg+Pnon+Nom^DB+Adj+With
adımlar	adım+Noun+A3pl+Pnon+Nom
içerisindeki	içeri+Noun+A3sg+P3sg+Loc^DB+Adj+Rel
dans	dans+Noun+A3sg+Pnon+Nom
aktörlerle	aktör+Noun+A3pl+Pnon+Ins
bedenim	beden+Noun+A3sg+P1sg+Nom
sudaki	su+Noun+A3sg+Pnon+Loc^DB+Adj+Rel
kıvrımlarına	kıvrım+Noun+A3pl+P3sg+Dat
zambağın	zambak+Noun+A3sg+Pnon+Gen
fildişinden	fildişi+Noun+A3sg+P3sg+Abl
sevinçli	sevinç+Noun+A3sg+Pnon+Nom^DB+Adj+With
alameti	alamet+Noun+A3sg+P3sg+Nom
sözcüğünü	sözcük+Noun+A3sg+P3sg+Acc
hacıların	hacı+Noun+A3pl+Pnon+Gen
ibadeti	ibadet+Noun+A3sg+Pnon+Acc
avuç	avuç+Noun+A3sg+Pnon+Nom
diyalog	diyalog+Noun+A3sg+Pnon+Nom
iniş	iniş+Noun+A3sg+Pnon+Nom
cesaretini	cesaret+Noun+A3sg+P3sg+Acc
oyunculu	oyuncu+Noun+A3sg+Pnon+Nom^DB+Adj+With
acemi	acem+Noun+A3sg+P3sg+Nom
balkondaki	balkon+Noun+A3sg+Pnon+Loc^DB+Adj+Rel
bölümündeki	bölüm+Noun+A3sg+P3sg+Loc^DB+Adj+Rel
inkar	inkar+Noun+A3sg+Pnon+Nom
pasajı	pasaj+Noun+A3sg+P3sg+Nom
okul	okul+Noun+A3sg+Pnon+Nom
hassasiyetle	hassasiyet+Noun+A3sg+Pnon+Ins
metindeki	metin+Noun+A3sg+Pnon+Loc^DB+Adj+Rel
hitabet	hitabet+Noun+A3sg+Pnon+Nom
ezbere	ezber+Noun+A3sg+Pnon+Dat
dizesindeki	dize+Noun+A3sg+P3sg+Loc^DB+Adj+Rel
anii	anii+Noun+A3sg+Pnon+Nom
şimşek	şimşek+Noun+A3sg+Pnon+Nom
tomurcuğu	tomurcuk+Noun+A3sg+P3sg+Nom
nefese	nefes+Noun+A3sg+Pnon+Dat
galeri	galeri+Noun+A3sg+Pnon+Nom
uğultu	uğultu+Noun+A3sg+Pnon+Nom
müdürünün	müdür+Noun+A3sg+P3sg+Gen
ıslık	ıslık+Noun+A3sg+Pnon+Nom
paltosunu	palto+Noun+A3sg+P3sg+Acc
rolündeki	rol+Noun+A3sg+P3sg+Loc^DB+Adj+Rel
özür	özür+Noun+A3sg+Pnon+Nom
hasta	hasta+Noun+A3sg+Pnon+Nom
formları	form+Noun+A3pl+P3sg+Nom
tasarı	tasarı+Noun+A3sg+Pnon+Nom
sakat	sakat+Noun+A3sg+Pnon+Nom
planlı	plan+Noun+A3sg+Pnon+Nom^DB+Adj+With
badirelerden	badire+Noun+A3pl+Pnon+Abl
yalan	yalan+Noun+A3sg+Pnon+Nom
tarafsız	taraf+Noun+A3sg+Pnon+Nom^DB+Adj+Without
dağlar	dağ+Noun+A3pl+Pnon+Nom
kutsallığına	kut+Noun+A3sg+Pnon+Nom^DB+Adj+Related^DB+Noun+Ness+A3sg+P3sg+Dat
ürpertiler	ürperti+Noun+A3pl+Pnon+Nom
fıçı	fıçı+Noun+A3sg+Pnon+Nom
taslak	taslak+Noun+A3sg+Pnon+Nom
ayrıntılı	ayrıntı+Noun+A3sg+Pnon+Nom^DB+Adj+With
ihtiyaçları	ihtiyaç+Noun+A3pl+P3pl+Nom
seviyeli	seviye+Noun+A3sg+Pnon+Nom^DB+Adj+With
hemşerilerinden	hemşeri+Noun+A3pl+P3sg+Abl
hanımefendi	hanımefendi+Noun+A3sg+Pnon+Nom
muhit	muhit+Noun+A3sg+Pnon+Nom
şehirlerarası	şehir+Noun+A3pl+Pnon+Nom^DB+Adj+InBetween
herkesle	herkes+Noun+A3sg+Pnon+Ins
niyetli	niyet+Noun+A3sg+Pnon+Nom^DB+Adj+With
pazarı	pazar+Noun+A3sg+P3sg+Nom
satıcıların	satıcı+Noun+A3pl+Pnon+Gen
dükkan	dükkan+Noun+A3sg+Pnon+Nom
tezgahtarlarının	tezgahtar+Noun+A3pl+P3sg+Gen
gelecekteki	gelecek+Noun+A3sg+Pnon+Loc^DB+Adj+Rel
önsezi	önsezi+Noun+A3sg+Pnon+Nom
söylentilere	söylenti+Noun+A3pl+Pnon+Dat
ortalıkta	ortalık+Noun+A3sg+Pnon+Loc
pasaportsuz	pasaport+Noun+A3sg+Pnon+Nom^DB+Adj+Without
emellerinin	emel+Noun+A3pl+P3sg+Gen
nüfuzlu	nüfuz+Noun+A3sg+Pnon+Nom^DB+Adj+With
münasebetsizliğe	münasebet+Noun+A3sg+Pnon+Nom^DB+Adj+Without^DB+Noun+Ness+A3sg+Pnon+Dat
havadis	havadis+Noun+A3sg+Pnon+Nom
asıllı	asıl+Noun+A3sg+Pnon+Nom^DB+Adj+With
başlangıçtaki	başlangıç+Noun+A3sg+Pnon+Loc^DB+Adj+Rel
incelikle	incelik+Noun+A3sg+Pnon+Ins
taşralıların	taşralı+Noun+A3pl+Pnon+Gen
muhafaza	muhafaza+Noun+A3sg+Pnon+Nom
psikolog	psikolog+Noun+A3sg+Pnon+Nom
bilgini	bilgin+Noun+A3sg+P3sg+Nom
eşek	eşek+Noun+A3sg+Pnon+Nom
süratiyle	sürat+Noun+A3sg+P3sg+Ins
gökleri	gök+Noun+A3pl+P3sg+Nom
rezaletlerinin	rezalet+Noun+A3pl+P3sg+Gen
milyoner	milyoner+Noun+A3sg+Pnon+Nom
dul	dul+Noun+A3sg+Pnon+Nom
dükle	dük+Noun+A3sg+Pnon+Ins
valisi	vali+Noun+A3sg+P3sg+Nom
il	il+Noun+A3sg+Pnon+Nom
tahammülsüz	tahammül+Noun+A3sg+Pnon+Nom^DB+Adj+Without
kafanızdaki	kafa+Noun+A3sg+P2pl+Loc^DB+Adj+Rel
tuzağa	tuzak+Noun+A3sg+Pnon+Dat
barın	bar+Noun+A3sg+Pnon+Gen
geleni	geleni+Noun+A3sg+Pnon+Nom
yüzde	yüzde+Noun+A3sg+Pnon+Nom
kilitteki	kilit+Noun+A3sg+Pnon+Loc^DB+Adj+Rel
bugünlerdeki	bugün+Noun+A3pl+Pnon+Loc^DB+Adj+Rel
bayanlardaki	bayan+Noun+A3pl+Pnon+Loc^DB+Adj+Rel
bacadan	baca+Noun+A3sg+Pnon+Abl
dahice	dahi+Noun+A3sg+Pnon+Equ
ihmal	ihmal+Noun+A3sg+Pnon+Nom
hikayelerini	hikaye+Noun+A3pl+P3sg+Acc
sokaklarındaki	sokak+Noun+A3pl+P3pl+Loc^DB+Adj+Rel
dibindeki	dip+Noun+A3sg+P3sg+Loc^DB+Adj+Rel
zerrece	zerre+Noun+A3sg+Pnon+Equ
entrikalarına	entrika+Noun+A3pl+P3sg+Dat
bozguna	bozgun+Noun+A3sg+Pnon+Dat
arzu	arzu+Noun+A3sg+Pnon+Nom
rakibesinin	rakibe+Noun+A3sg+P3sg+Gen
itirazlarına	itiraz+Noun+A3pl+P3sg+Dat
kurallardaki	kural+Noun+A3pl+Pnon+Loc^DB+Adj+Rel
esprili	espri+Noun+A3sg+Pnon+Nom^DB+Adj+With
gırla	gır+Noun+A3sg+Pnon+Ins
inat	inat+Noun+A3sg+Pnon+Nom
suratlı	surat+Noun+A3sg+Pnon+Nom^DB+Adj+With
takımlardaki	takım+Noun+A3pl+Pnon+Loc^DB+Adj+Rel
cenaze	cenaze+Noun+A3sg+Pnon+Nom
törensiz	tören+Noun+A3sg+Pnon+Nom^DB+Adj+Without
lanetinin	lanet+Noun+A3sg+P3sg+Gen
kazığa	kazık+Noun+A3sg+Pnon+Dat
samimiyetsiz	samimiyet+Noun+A3sg+Pnon+Nom^DB+Adj+Without
kibirli	kibir+Noun+A3sg+Pnon+Nom^DB+Adj+With
sitemlerle	sitem+Noun+A3pl+Pnon+Ins
gelişimde	gelişim+Noun+A3sg+Pnon+Loc
çayını	çay+Noun+A3sg+P3sg+Acc
öğle	öğle+Noun+A3sg+Pnon+Nom
uykusuz	uyku+Noun+A3sg+Pnon+Nom^DB+Adj+Without
idarenin	idare+Noun+A3sg+Pnon+Gen
intihardan	intihar+Noun+A3sg+Pnon+Abl
vaftiz	vaftiz+Noun+A3sg+Pnon+Nom
vasiyetinde	vasiyet+Noun+A3sg+P3sg+Loc
ziyaret	ziyaret+Noun+A3sg+Pnon+Nom
ahbab	ahbap+Noun+A3sg+Pnon+Nom
mujiğin	mujik+Noun+A3sg+Pnon+Gen
meyhanecilerle	meyhane+Noun+A3sg+Pnon+Nom^DB+Noun+Agt+A3pl+Pnon+Ins
bodrumlarda	bodrum+Noun+A3pl+Pnon+Loc
kanaate	kanaat+Noun+A3sg+Pnon+Dat
saygılı	saygı+Noun+A3sg+Pnon+Nom^DB+Adj+With
hoşçakalın	hoşçakal+Noun+A3sg+Pnon+Gen
mazeretimi	mazeret+Noun+A3sg+P1sg+Acc
revoir	revoir+Noun+A3sg+Pnon+Nom
au	au+Noun+A3sg+Pnon+Nom
antreye	antre+Noun+A3sg+Pnon+Dat
deminden	demin+Noun+A3sg+Pnon+Abl
nişansız	nişan+Noun+A3sg+Pnon+Nom^DB+Adj+Without
vedalaşmasını	veda+Noun+A3sg+Pnon+Nom^DB+Verb+Become+Pos^DB+Noun+Inf2+A3sg+P3sg+Acc
keklik	keklik+Noun+A3sg+Pnon+Nom
peşinde	peş+Noun+A3sg+P3sg+Loc
komedi	komedi+Noun+A3sg+Pnon+Nom
tongaya	tonga+Noun+A3sg+Pnon+Dat
numaralı	numara+Noun+A3sg+Pnon+Nom^DB+Adj+With
midem	mide+Noun+A3sg+P1sg+Nom
anlamsız	anlam+Noun+A3sg+Pnon+Nom^DB+Adj+Without
bakana	bakan+Noun+A3sg+Pnon+Dat
ihanet	ihanet+Noun+A3sg+Pnon+Nom
delikli	delik+Noun+A3sg+Pnon+Nom^DB+Adj+With
cepli	cep+Noun+A3sg+Pnon+Nom^DB+Adj+With
koyunları	koyun+Noun+A3pl+P3sg+Nom
nazlı	naz+Noun+A3sg+Pnon+Nom^DB+Adj+With
yarığa	yarık+Noun+A3sg+Pnon+Dat
şakakları	şakak+Noun+A3pl+P3sg+Nom
alanınızdaki	alan+Noun+A3sg+P2pl+Loc^DB+Adj+Rel
toplantıdaki	toplantı+Noun+A3sg+Pnon+Loc^DB+Adj+Rel
iftihar	iftihar+Noun+A3sg+Pnon+Nom
çenemi	çene+Noun+A3sg+P1sg+Acc
vet	vet+Noun+A3sg+Pnon+Nom
fev	fev+Noun+A3sg+Pnon+Nom
ka	ka+Noun+A3sg+Pnon+Nom
la	la+Noun+A3sg+Pnon+Nom
le	le+Noun+A3sg+Pnon+Nom
lun	lu+Noun+A3sg+P2sg+Nom
komedyanızda	komedya+Noun+A3sg+P2pl+Loc
yaldızlı	yaldız+Noun+A3sg+Pnon+Nom^DB+Adj+With
cehennemlik	cehennem+Noun+A3sg+Pnon+Nom^DB+Noun+Ness+A3sg+Pnon+Nom
arısı	arı+Noun+A3sg+P3sg+Nom
yuvasındaki	yuva+Noun+A3sg+P3sg+Loc^DB+Adj+Rel
kemikli	kemik+Noun+A3sg+Pnon+Nom^DB+Adj+With
vakasını	vaka+Noun+A3sg+P3sg+Acc
dedikoducu	dedikodu+Noun+A3sg+Pnon+Nom^DB+Noun+Agt+A3sg+Pnon+Nom
ikram	ikram+Noun+A3sg+Pnon+Nom
aralığındaki	aralık+Noun+A3sg+P3sg+Loc^DB+Adj+Rel
dışardaki	dışarı+Noun+A3sg+Pnon+Loc^DB+Adj+Rel
şekerli	şeker+Noun+A3sg+Pnon+Nom^DB+Adj+With
asaletinden	asalet+Noun+A3sg+P3sg+Abl
nuz	nuz+Noun+A3sg+Pnon+Nom
nor	nor+Noun+A3sg+Pnon+Nom
belle	bel+Noun+A3sg+Pnon+Ins
zevkli	zevk+Noun+A3sg+Pnon+Nom^DB+Adj+With
vücutlu	vücut+Noun+A3sg+Pnon+Nom^DB+Adj+With
kızcağıza	kızcağız+Noun+A3sg+Pnon+Dat
dördünde	dördün+Noun+A3sg+Pnon+Loc
ge	ge+Noun+A3sg+Pnon+Nom
li	li+Noun+A3sg+Pnon+Nom
şi	şi+Noun+A3sg+Pnon+Nom
ci	ci+Noun+A3sg+Pnon+Nom
gözlüğüyle	gözlük+Noun+A3sg+P3sg+Ins
quelle	uel+Noun+A3sg+Pnon+Ins
charmante	charmante+Noun+A3sg+Pnon+Nom
artist	artist+Noun+A3sg+Pnon+Nom
piyano	piyano+Noun+A3sg+Pnon+Nom
manalı	mana+Noun+A3sg+Pnon+Nom^DB+Adj+With
bakımlı	bakım+Noun+A3sg+Pnon+Nom^DB+Adj+With
konteslerden	kontes+Noun+A3pl+Pnon+Abl
müş	müş+Noun+A3sg+Pnon+Nom
aşçısıyla	aşçı+Noun+A3sg+P3sg+Ins
ru	ru+Noun+A3sg+Pnon+Nom
kont	kont+Noun+A3sg+Pnon+Nom
unvan	unvan+Noun+A3sg+Pnon+Nom
bıyıklı	bıyık+Noun+A3sg+Pnon+Nom^DB+Adj+With
kavgalı	kavga+Noun+A3sg+Pnon+Nom^DB+Adj+With
charmant	charmant+Noun+A3sg+Pnon+Nom
zi	zi+Noun+A3sg+Pnon+Nom
ği	ği+Noun+A3sg+Pnon+Nom
taşkın	taşkın+Noun+A3sg+Pnon+Nom
burunlu	burun+Noun+A3sg+Pnon+Nom^DB+Adj+With
enfiyeden	enfiye+Noun+A3sg+Pnon+Abl
rış	rış+Noun+A3sg+Pnon+Nom
tı	tı+Noun+A3sg+Pnon+Nom
rım	rı+Noun+A3sg+P1sg+Nom
rum	rum+Noun+A3sg+Pnon+Nom
defasında	defa+Noun+A3sg+P3sg+Loc
şövalyeler	şövalye+Noun+A3pl+Pnon+Nom
şarklı	şark+Noun+A3sg+Pnon+Nom^DB+Adj+With
şatolar	şato+Noun+A3pl+Pnon+Nom
turnuvalar	turnuva+Noun+A3pl+Pnon+Nom
tır	tır+Noun+A3sg+Pnon+Nom
modda	mod+Noun+A3sg+Pnon+Loc
notayı	nota+Noun+A3sg+Pnon+Acc
heykeltıraşın	heykeltıraş+Noun+A3sg+Pnon+Gen
müzik	müzik+Noun+A3sg+Pnon+Nom
mem	me+Noun+A3sg+P1sg+Nom
ravissez	ravissez+Noun+A3sg+Pnon+Nom
ma	ma+Noun+A3sg+Pnon+Nom
enfant	enfant+Noun+A3sg+Pnon+Nom
yaşamındaki	yaşam+Noun+A3sg+P3sg+Loc^DB+Adj+Rel
tabir	tabir+Noun+A3sg+Pnon+Nom
toplumdaki	toplum+Noun+A3sg+Pnon+Loc^DB+Adj+Rel
kocası	koca+Noun+A3sg+P3sg+Nom
personne	personne+Noun+A3sg+Pnon+Nom
ü	ü+Noun+A3sg+Pnon+Nom
asilzadeliğin	asilzade+Noun+A3sg+Pnon+Nom^DB+Noun+Ness+A3sg+Pnon+Gen
kralı	kral+Noun+A3sg+P3sg+Nom
sarayındaki	saray+Noun+A3sg+P3sg+Loc^DB+Adj+Rel
dilberlerinden	dilber+Noun+A3pl+P3sg+Abl
görünün	görü+Noun+A3sg+Pnon+Gen
zümresinin	zümre+Noun+A3sg+P3sg+Gen
gururlu	gurur+Noun+A3sg+Pnon+Nom^DB+Adj+With
gazetesini	gazete+Noun+A3sg+P3sg+Acc
yazılı	yazı+Noun+A3sg+Pnon+Nom^DB+Adj+With
kı	kı+Noun+A3sg+Pnon+Nom
yım	yı+Noun+A3sg+P1sg+Nom
te	te+Noun+A3sg+Pnon+Nom
ri	ri+Noun+A3sg+Pnon+Nom
isteksiz	istek+Noun+A3sg+Pnon+Nom^DB+Adj+Without
chatelaine	chatelain+Noun+A3sg+Pnon+Dat
lat	lat+Noun+A3sg+Pnon+Nom
nız	nız+Noun+A3sg+Pnon+Nom
vikontesle	vikontes+Noun+A3sg+Pnon+Ins
düetler	düet+Noun+A3pl+Pnon+Nom
feda	feda+Noun+A3sg+Pnon+Nom
lar	lar+Noun+A3sg+Pnon+Nom
ler	ler+Noun+A3sg+Pnon+Nom
tiksinti	tiksinti+Noun+A3sg+Pnon+Nom
pı	pı+Noun+A3sg+Pnon+Nom
huşu	huşu+Noun+A3sg+Pnon+Nom
lı	lı+Noun+A3sg+Pnon+Nom
ayıp	ayıp+Noun+A3sg+Pnon+Nom
tahkir	tahkir+Noun+A3sg+Pnon+Nom
iftira	iftira+Noun+A3sg+Pnon+Nom
düğün	düğün+Noun+A3sg+Pnon+Nom
nolu	no+Noun+A3sg+Pnon+Nom^DB+Adj+With
pa	pa+Noun+A3sg+Pnon+Nom
kor	kor+Noun+A3sg+Pnon+Nom
ku	ku+Noun+A3sg+Pnon+Nom
du	du+Noun+A3sg+Pnon+Nom
canavar	canavar+Noun+A3sg+Pnon+Nom
koltuğunun	koltuk+Noun+A3sg+P3sg+Gen
ba	ba+Noun+A3sg+Pnon+Nom
hi	hi+Noun+A3sg+Pnon+Nom
ğen	ğe+Noun+A3sg+P2sg+Nom
miş	miş+Noun+A3sg+Pnon+Nom
ğıt	ğıt+Noun+A3sg+Pnon+Nom
paz	paz+Noun+A3sg+Pnon+Nom
zım	zı+Noun+A3sg+P1sg+Nom
u	u+Noun+A3sg+Pnon+Nom
zan	zan+Noun+A3sg+Pnon+Nom
ter	ter+Noun+A3sg+Pnon+Nom
ziz	ziz+Noun+A3sg+Pnon+Nom
joli	joli+Noun+A3sg+Pnon+Nom
re	re+Noun+A3sg+Pnon+Nom
cher	cher+Noun+A3sg+Pnon+Nom
nu	nü+Noun+A3sg+Pnon+Nom
ni	ni+Noun+A3sg+Pnon+Nom
selamlaşmaya	selam+Noun+A3sg+Pnon+Nom^DB+Verb+Become+Pos^DB+Noun+Inf2+A3sg+Pnon+Dat
eşiğe	eşik+Noun+A3sg+Pnon+Dat
ağırlıklı	ağırlık+Noun+A3sg+Pnon+Nom^DB+Adj+With
isimsiz	isim+Noun+A3sg+Pnon+Nom^DB+Adj+Without
yedekli	yedek+Noun+A3sg+Pnon+Nom^DB+Adj+With
lüzumsuz	lüzum+Noun+A3sg+Pnon+Nom^DB+Adj+Without
ortamlardaki	ortam+Noun+A3pl+Pnon+Loc^DB+Adj+Rel
zekadan	zeka+Noun+A3sg+Pnon+Abl
ahlarımızı	ah+Noun+A3pl+P1pl+Acc
şahım	şahım+Noun+A3sg+Pnon+Nom
bahtınızın	baht+Noun+A3sg+P2pl+Gen
sırtları	sırt+Noun+A3pl+P3pl+Nom
selameti	selamet+Noun+A3sg+P3sg+Nom
zihnime	zihin+Noun+A3sg+P1sg+Dat
halttan	halt+Noun+A3sg+Pnon+Abl
hanımı	hanım+Noun+A3sg+P3sg+Nom
çeyrek	çeyrek+Noun+A3sg+Pnon+Nom
hitap	hitap+Noun+A3sg+Pnon+Nom
gözcü	gözcü+Noun+A3sg+Pnon+Nom
toy	toy+Noun+A3sg+Pnon+Nom
kabahat	kabahat+Noun+A3sg+Pnon+Nom
delili	delil+Noun+A3sg+P3sg+Nom
terbiye	terbiye+Noun+A3sg+Pnon+Nom
güçlük	güçlük+Noun+A3sg+Pnon+Nom
çaresiz	çare+Noun+A3sg+Pnon+Nom^DB+Adj+Without
otoritemi	otorite+Noun+A3sg+P1sg+Acc
kuyumu	kuyu+Noun+A3sg+P1sg+Acc
devlet	devlet+Noun+A3sg+Pnon+Nom
kuşlar	kuş+Noun+A3pl+Pnon+Nom
servetin	servet+Noun+A3sg+Pnon+Gen
izdivacı	izdivaç+Noun+A3sg+P3sg+Nom
azabı	azap+Noun+A3sg+P3sg+Nom
noktalarındaki	nokta+Noun+A3pl+P3sg+Loc^DB+Adj+Rel
mert	mert+Noun+A3sg+Pnon+Nom
sihirli	sihir+Noun+A3sg+Pnon+Nom^DB+Adj+With
dayanağı	dayanak+Noun+A3sg+P3sg+Nom
yoldaşı	yoldaş+Noun+A3sg+P3sg+Nom
sevgisiz	sevgi+Noun+A3sg+Pnon+Nom^DB+Adj+Without
gurubu	gurup+Noun+A3sg+P3sg+Nom
cennetteki	cennet+Noun+A3sg+Pnon+Loc^DB+Adj+Rel
rahibe	rahip+Noun+A3sg+Pnon+Dat
güvercinlerden	güvercin+Noun+A3pl+Pnon+Abl
vicdanındaki	vicdan+Noun+A3sg+P3sg+Loc^DB+Adj+Rel
menfaat	menfaat+Noun+A3sg+Pnon+Nom
defterindeki	defter+Noun+A3sg+P3sg+Loc^DB+Adj+Rel
kere	kere+Noun+A3sg+Pnon+Nom
payını	pay+Noun+A3sg+P3sg+Acc
kıt	kıt+Noun+A3sg+Pnon+Nom
dışlı	dış+Noun+A3sg+Pnon+Nom^DB+Adj+With
deyim	deyim+Noun+A3sg+Pnon+Nom
bıçak	bıçak+Noun+A3sg+Pnon+Nom
manzaralı	manzara+Noun+A3sg+Pnon+Nom^DB+Adj+With
burjuvazide	burjuvazi+Noun+A3sg+Pnon+Loc
baloda	balo+Noun+A3sg+Pnon+Loc
sütunlardaki	sütun+Noun+A3pl+Pnon+Loc^DB+Adj+Rel
nağmeleri	nağme+Noun+A3pl+P3sg+Nom
sosyeteye	sosyete+Noun+A3sg+Pnon+Dat
mersinlerin	mersin+Noun+A3pl+Pnon+Gen
limon	limon+Noun+A3sg+Pnon+Nom
öpücük	öpücük+Noun+A3sg+Pnon+Nom
diyarda	diyar+Noun+A3sg+Pnon+Loc
mevkie	mevki+Noun+A3sg+Pnon+Dat
kadersiz	kader+Noun+A3sg+Pnon+Nom^DB+Adj+Without
akrabasının	akraba+Noun+A3sg+P3sg+Gen
şahısların	şahıs+Noun+A3pl+Pnon+Gen
sayede	saye+Noun+A3sg+Pnon+Loc
rütbeler	rütbe+Noun+A3pl+Pnon+Nom
düzendeki	düzen+Noun+A3sg+Pnon+Loc^DB+Adj+Rel
taşkınlığınızdan	taşkınlık+Noun+A3sg+P2pl+Abl
gönlünü	gönül+Noun+A3sg+P3sg+Acc
sağlıklı	sağlık+Noun+A3sg+Pnon+Nom^DB+Adj+With
duayı	dua+Noun+A3sg+Pnon+Acc
gündüzünü	gündüz+Noun+A3sg+P3sg+Acc
saadeti	saadet+Noun+A3sg+P3sg+Nom
pamuk	pamuk+Noun+A3sg+Pnon+Nom
ipliğine	ip+Noun+A3sg+Pnon+Nom^DB+Noun+Ness+A3sg+P3sg+Dat
başkente	başkent+Noun+A3sg+Pnon+Dat
tuz	tuz+Noun+A3sg+Pnon+Nom
emanet	emanet+Noun+A3sg+Pnon+Nom
zafer	zafer+Noun+A3sg+Pnon+Nom
damarına	damar+Noun+A3sg+P3sg+Dat
çirkefin	çirkef+Noun+A3sg+Pnon+Gen
yüzüstü	yüzüst+Noun+A3sg+P3sg+Nom
tehlikeli	tehlike+Noun+A3sg+Pnon+Nom^DB+Adj+With
namuslu	namus+Noun+A3sg+Pnon+Nom^DB+Adj+With
kinli	kin+Noun+A3sg+Pnon+Nom^DB+Adj+With
yakasındaki	yaka+Noun+A3sg+P3sg+Loc^DB+Adj+Rel
yastıklara	yastık+Noun+A3pl+Pnon+Dat
dirseklerinden	dirsek+Noun+A3pl+P3sg+Abl
tutam	tutam+Noun+A3sg+Pnon+Nom
çekeceği	çekecek+Noun+A3sg+P3sg+Nom
vaad	vaad+Noun+A3sg+Pnon+Nom
vız	vız+Noun+A3sg+Pnon+Nom
ilerki	ileri+Noun+A3sg+Pnon+Loc^DB+Adj+Rel
polisteki	polis+Noun+A3sg+Pnon+Loc^DB+Adj+Rel
icabı	icap+Noun+A3sg+P3sg+Nom
macera	macera+Noun+A3sg+Pnon+Nom
sarhoş	sarhoş+Noun+A3sg+Pnon+Nom
kıyamet	kıyamet+Noun+A3sg+Pnon+Nom
mat	mat+Noun+A3sg+Pnon+Nom
tarzdaki	tarz+Noun+A3sg+Pnon+Loc^DB+Adj+Rel
davet	davet+Noun+A3sg+Pnon+Nom
reisinin	reis+Noun+A3sg+P3sg+Gen
kilometrelik	kilometre+Noun+A3sg+Pnon+Nom^DB+Noun+Ness+A3sg+Pnon+Nom
arabacı	arabacı+Noun+A3sg+Pnon+Nom
binalara	bina+Noun+A3pl+Pnon+Dat
pencereli	pencere+Noun+A3sg+Pnon+Nom^DB+Adj+With
ıhlamur	ıhlamur+Noun+A3sg+Pnon+Nom
ağacındaki	ağaç+Noun+A3sg+P3sg+Loc^DB+Adj+Rel
kasırga	kasırga+Noun+A3sg+Pnon+Nom
tembel	tembel+Noun+A3sg+Pnon+Nom
havlunun	havlu+Noun+A3sg+Pnon+Gen
hamamdan	hamam+Noun+A3sg+Pnon+Abl
beyin	beyin+Noun+A3sg+Pnon+Nom
semaverin	semaver+Noun+A3sg+Pnon+Gen
panik	panik+Noun+A3sg+Pnon+Nom
makasla	makas+Noun+A3sg+Pnon+Ins
bekle	bek+Noun+A3sg+Pnon+Ins
icat	icat+Noun+A3sg+Pnon+Nom
kıvırcık	kıvırcık+Noun+A3sg+Pnon+Nom
kulübelerde	kulübe+Noun+A3pl+Pnon+Loc
barakaların	baraka+Noun+A3pl+Pnon+Gen
yeller	yel+Noun+A3pl+Pnon+Nom
otomobil	otomobil+Noun+A3sg+Pnon+Nom
yüklü	yük+Noun+A3sg+Pnon+Nom^DB+Adj+With
vaşaklar	vaşak+Noun+A3pl+Pnon+Nom
çığlığa	çığ+Noun+A3sg+Pnon+Nom^DB+Noun+Ness+A3sg+Pnon+Dat
hakimiyeti	hakimiyet+Noun+A3sg+P3sg+Nom
yabandan	yaban+Noun+A3sg+Pnon+Abl
karınca	karınca+Noun+A3sg+Pnon+Nom
kalabalığı	kalaba+Noun+A3sg+Pnon+Nom^DB+Noun+Ness+A3sg+P3sg+Nom
gereksinim	gereksinim+Noun+A3sg+Pnon+Nom
karabasan	karabasan+Noun+A3sg+Pnon+Nom
kabus	kabus+Noun+A3sg+Pnon+Nom
çantamdaki	çanta+Noun+A3sg+P1sg+Loc^DB+Adj+Rel
bavul	bavul+Noun+A3sg+Pnon+Nom
yığınındaki	yığın+Noun+A3sg+P3sg+Loc^DB+Adj+Rel
curcuna	curcuna+Noun+A3sg+Pnon+Nom
terk	terk+Noun+A3sg+Pnon+Nom
sandık	sandık+Noun+A3sg+Pnon+Nom
güneşlenen	güneş+Noun+A3sg+Pnon+Nom^DB+Verb+Acquire+Pos^DB+Adj+PresPart
meydanındaki	meydan+Noun+A3sg+P3sg+Loc^DB+Adj+Rel
düşmancıl	düşmancıl+Noun+A3sg+Pnon+Nom
saldırılarına	saldırı+Noun+A3pl+P3sg+Dat
diken	diken+Noun+A3sg+Pnon+Nom
bindi	bindi+Noun+A3sg+Pnon+Nom
tekerlekli	tekerlek+Noun+A3sg+Pnon+Nom^DB+Adj+With
bahçeli	bahçe+Noun+A3sg+Pnon+Nom^DB+Adj+With
kestane	kestane+Noun+A3sg+Pnon+Nom
çatısı	çatı+Noun+A3sg+P3sg+Nom
çimenlerin	çimen+Noun+A3pl+Pnon+Gen
şuradaki	şura+Noun+A3sg+Pnon+Loc^DB+Adj+Rel
meşe	meşe+Noun+A3sg+Pnon+Nom
tarlaların	tarla+Noun+A3pl+Pnon+Gen
tezat	tezat+Noun+A3sg+Pnon+Nom
tepedeki	tepe+Noun+A3sg+Pnon+Loc^DB+Adj+Rel
otlakları	otlak+Noun+A3pl+P3sg+Nom
terasta	teras+Noun+A3sg+Pnon+Loc
çoban	çoban+Noun+A3sg+Pnon+Nom
hamle	hamle+Noun+A3sg+Pnon+Nom
zar	zar+Noun+A3sg+Pnon+Nom
çabasındaki	çaba+Noun+A3sg+P3sg+Loc^DB+Adj+Rel
dengeli	denge+Noun+A3sg+Pnon+Nom^DB+Adj+With
kıç	kıç+Noun+A3sg+Pnon+Nom
dişinin	dişi+Noun+A3sg+Pnon+Gen
kanundaki	kanun+Noun+A3sg+Pnon+Loc^DB+Adj+Rel
içgüdüleri	içgüdü+Noun+A3pl+P3sg+Nom
bilinçaltına	bilinçaltı+Noun+A3sg+P3sg+Dat
seferki	sefer+Noun+A3sg+Pnon+Nom^DB+Adj+Rel
babacığım	babacığım+Noun+A3sg+Pnon+Nom
kavisle	kavis+Noun+A3sg+Pnon+Ins
çayıra	çayır+Noun+A3sg+Pnon+Dat
hilelerinden	hile+Noun+A3pl+P3sg+Abl
çakıllı	çakıl+Noun+A3sg+Pnon+Nom^DB+Adj+With
gemi	gem+Noun+A3sg+Pnon+Acc
gölgeli	gölge+Noun+A3sg+Pnon+Nom^DB+Adj+With
tazının	tazı+Noun+A3sg+Pnon+Gen
gırtlağına	gırtlak+Noun+A3sg+P3sg+Dat
çapulcu	çapulcu+Noun+A3sg+Pnon+Nom
yaratığa	yaratık+Noun+A3sg+Pnon+Dat
kutbundan	kutup+Noun+A3sg+P3sg+Abl
geçmişimdeki	geçmiş+Noun+A3sg+P1sg+Loc^DB+Adj+Rel
korkak	korkak+Noun+A3sg+Pnon+Nom
hatalı	hata+Noun+A3sg+Pnon+Nom^DB+Adj+With
topuklu	topuk+Noun+A3sg+Pnon+Nom^DB+Adj+With
homurtuda	homurtu+Noun+A3sg+Pnon+Loc
kozlarını	koz+Noun+A3pl+P3sg+Acc
pusuya	pusu+Noun+A3sg+Pnon+Dat
yaradılış	yaradılış+Noun+A3sg+Pnon+Nom
çevresindeki	çevre+Noun+A3sg+P3sg+Loc^DB+Adj+Rel
yolculuğumuza	yolculuk+Noun+A3sg+P1pl+Dat
çiftliklerine	çiftlik+Noun+A3pl+P3sg+Dat
mekanını	mekan+Noun+A3sg+P3sg+Acc
dersin	ders+Noun+A3sg+Pnon+Gen
ahıra	ahır+Noun+A3sg+Pnon+Dat
cinsi	cins+Noun+A3sg+P3sg+Nom
öç	öç+Noun+A3sg+Pnon+Nom
olanaksız	olanak+Noun+A3sg+Pnon+Nom^DB+Adj+Without
zindan	zindan+Noun+A3sg+Pnon+Nom
öncesindeki	önce+Noun+A3sg+P3sg+Loc^DB+Adj+Rel
intikamını	intikam+Noun+A3sg+P3sg+Acc
siper	siper+Noun+A3sg+Pnon+Nom
bireyleriyle	birey+Noun+A3pl+P3sg+Ins
yatak	yatak+Noun+A3sg+Pnon+Nom
çadır	çadır+Noun+A3sg+Pnon+Nom
alakalı	alaka+Noun+A3sg+Pnon+Nom^DB+Adj+With
şamarı	şamar+Noun+A3sg+P3sg+Nom
falan	falan+Noun+A3sg+Pnon+Nom
parıltıları	parıltı+Noun+A3pl+Pnon+Acc
yargıç	yargıç+Noun+A3sg+Pnon+Nom
iltifatla	iltifat+Noun+A3sg+Pnon+Ins
mırıltı	mırıltı+Noun+A3sg+Pnon+Nom
ikna	ikna+Noun+A3sg+Pnon+Nom
hizmetçim	hizmetçi+Noun+A3sg+P1sg+Nom
yardımcı	yardımcı+Noun+A3sg+Pnon+Nom
mülkü	mülk+Noun+A3sg+P3sg+Nom
antlaşma	antlaşma+Noun+A3sg+Pnon+Nom
barış	barış+Noun+A3sg+Pnon+Nom
bulaşık	bulaşık+Noun+A3sg+Pnon+Nom
araziye	arazi+Noun+A3sg+Pnon+Dat
karayoluna	karayolu+Noun+A3sg+P3sg+Dat
çitlerle	çit+Noun+A3pl+Pnon+Ins
ilişkilerindeki	ilişki+Noun+A3pl+P3sg+Loc^DB+Adj+Rel
kullanımlar	kullanım+Noun+A3pl+Pnon+Nom
gözlem	gözlem+Noun+A3sg+Pnon+Nom
eğitimli	eğitim+Noun+A3sg+Pnon+Nom^DB+Adj+With
faktör	faktör+Noun+A3sg+Pnon+Nom
fiskesi	fiske+Noun+A3sg+P3sg+Nom
dayaklardan	dayak+Noun+A3pl+Pnon+Abl
muamelesini	muamele+Noun+A3sg+P3sg+Acc
ihtarlara	ihtar+Noun+A3pl+Pnon+Dat
sözlü	sözlü+Noun+A3sg+Pnon+Nom
uyarısı	uyarı+Noun+A3sg+P3sg+Nom
pusula	pusula+Noun+A3sg+Pnon+Nom
tamam	tamam+Noun+A3sg+Pnon+Nom
avla	av+Noun+A3sg+Pnon+Ins
kümeslerinde	kümes+Noun+A3pl+P3sg+Loc
tavuğa	tavuk+Noun+A3sg+Pnon+Dat
iştahlı	iştah+Noun+A3sg+Pnon+Nom^DB+Adj+With
lezzetli	lezzet+Noun+A3sg+Pnon+Nom^DB+Adj+With
civardaki	civar+Noun+A3sg+Pnon+Loc^DB+Adj+Rel
imdadına	imdat+Noun+A3sg+P3sg+Dat
hevesi	heves+Noun+A3sg+P3sg+Nom
kursağında	kursak+Noun+A3sg+P3sg+Loc
silahlı	silah+Noun+A3sg+Pnon+Nom^DB+Adj+With
kırbaca	kırbaç+Noun+A3sg+Pnon+Dat
sopasını	sopa+Noun+A3sg+P3sg+Acc
feryat	feryat+Noun+A3sg+Pnon+Nom
seyislerin	seyis+Noun+A3pl+Pnon+Gen
ödü	öd+Noun+A3sg+P3sg+Nom
müdahale	müdahale+Noun+A3sg+Pnon+Nom
cezalı	ceza+Noun+A3sg+Pnon+Nom^DB+Adj+With
ciddiyet	ciddiyet+Noun+A3sg+Pnon+Nom
tabanlı	taban+Noun+A3sg+Pnon+Nom^DB+Adj+With
suçüstü	suçüst+Noun+A3sg+P3sg+Nom
kümesindeki	küme+Noun+A3sg+P3sg+Loc^DB+Adj+Rel
odun	odun+Noun+A3sg+Pnon+Nom
ölüsü	ölü+Noun+A3sg+P3sg+Nom
leşini	leş+Noun+A3sg+P3sg+Acc
anlık	anlık+Noun+A3sg+Pnon+Nom
tatsız	tat+Noun+A3sg+Pnon+Nom^DB+Adj+Without
gökyüzüne	gökyüzü+Noun+A3sg+P3sg+Dat
bucaksız	bucak+Noun+A3sg+Pnon+Nom^DB+Adj+Without
halkının	halk+Noun+A3sg+P3sg+Gen
yazlıkta	yazlık+Noun+A3sg+Pnon+Loc
içimdeki	içim+Noun+A3sg+Pnon+Loc^DB+Adj+Rel
fırtınalı	fırtına+Noun+A3sg+Pnon+Nom^DB+Adj+With
rıhtımda	rıhtım+Noun+A3sg+Pnon+Loc
hergün	hergün+Noun+A3sg+Pnon+Nom
sağdaki	sağ+Noun+A3sg+Pnon+Loc^DB+Adj+Rel
bastonuyla	baston+Noun+A3sg+P3sg+Ins
tanışıklığımız	tanışık+Noun+A3sg+Pnon+Nom^DB+Noun+Ness+A3sg+P1pl+Nom
şükür	şükür+Noun+A3sg+Pnon+Nom
tamir	tamir+Noun+A3sg+Pnon+Nom
kül	kül+Noun+A3sg+Pnon+Nom
mimar	mimar+Noun+A3sg+Pnon+Nom
hatırını	hatır+Noun+A3sg+P3sg+Acc
caniler	cani+Noun+A3pl+Pnon+Nom
demirsiz	demir+Noun+A3sg+Pnon+Nom^DB+Adj+Without
pervazlarına	pervaz+Noun+A3pl+P3sg+Dat
semte	semt+Noun+A3sg+Pnon+Dat
duvarın	duvar+Noun+A3sg+P2sg+Nom
örümcekler	örümcek+Noun+A3pl+Pnon+Nom
iskemleli	iskemle+Noun+A3sg+Pnon+Nom^DB+Adj+With
çileli	çile+Noun+A3sg+Pnon+Nom^DB+Adj+With
kadıncağız	kadıncağız+Noun+A3sg+Pnon+Nom
hazırlıklı	hazırlık+Noun+A3sg+Pnon+Nom^DB+Adj+With
çiçekçiye	çiçekçi+Noun+A3sg+Pnon+Dat
giysi	giysi+Noun+A3sg+Pnon+Nom
alıcı	alıç+Noun+A3sg+Pnon+Acc
kılıklarıyla	kılık+Noun+A3sg+P3pl+Ins
belil	belil+Noun+A3sg+Pnon+Nom
kervanlarına	kervan+Noun+A3pl+P3sg+Dat
tanımlı	tanım+Noun+A3sg+Pnon+Nom^DB+Adj+With
statüleri	statü+Noun+A3pl+P3sg+Nom
hengamenin	hengame+Noun+A3sg+Pnon+Gen
çağrısıyla	çağrı+Noun+A3sg+P3sg+Ins
köprüyü	köprü+Noun+A3sg+Pnon+Acc
otların	ot+Noun+A3pl+Pnon+Gen
tebessüm	tebessüm+Noun+A3sg+Pnon+Nom
belirtisi	belirti+Noun+A3sg+P3sg+Nom
bayırlarıyla	bayır+Noun+A3pl+P3sg+Ins
tutkulu	tutku+Noun+A3sg+Pnon+Nom^DB+Adj+With
sineler	sine+Noun+A3pl+Pnon+Nom
coşkuyla	coşku+Noun+A3sg+Pnon+Ins
ışıltılarının	ışıltı+Noun+A3pl+P3sg+Gen
serüvene	serüven+Noun+A3sg+Pnon+Dat
kanalındaki	kanal+Noun+A3sg+P3sg+Loc^DB+Adj+Rel
atkılı	atkı+Noun+A3sg+Pnon+Nom^DB+Adj+With
istifini	istif+Noun+A3sg+P3sg+Acc
hıçkırıklarını	hıçkırık+Noun+A3pl+P3pl+Acc
romancılarımız	romancı+Noun+A3pl+P1pl+Nom
telaffuzundaki	telaffuz+Noun+A3sg+P3sg+Loc^DB+Adj+Rel
tereddütsüz	tereddüt+Noun+A3sg+Pnon+Nom^DB+Adj+Without
kaldırıma	kaldırım+Noun+A3sg+Pnon+Dat
yaya	yaya+Noun+A3sg+Pnon+Nom
kaldırımınında	kaldırımının+Noun+A3sg+Pnon+Loc
fraklı	frak+Noun+A3sg+Pnon+Nom^DB+Adj+With
boşlukta	boşluk+Noun+A3sg+Pnon+Loc
minnet	minnet+Noun+A3sg+Pnon+Nom
teşekkürünü	teşekkür+Noun+A3sg+P3sg+Acc
gözucuyla	gözucu+Noun+A3sg+Pnon+Ins
kirpiklerinin	kirpik+Noun+A3pl+P3sg+Gen
kaçamak	kaçamak+Noun+A3sg+Pnon+Nom
gelimi	gelim+Noun+A3sg+P3sg+Nom
sıkılgınlık	sıkılgın+Noun+A3sg+Pnon+Nom^DB+Noun+Ness+A3sg+Pnon+Nom
lütuflu	lütuf+Noun+A3sg+Pnon+Nom^DB+Adj+With
kulu	kul+Noun+A3sg+P3sg+Nom
ustalıkla	ustalık+Noun+A3sg+Pnon+Ins
günü	günü+Noun+A3sg+Pnon+Nom
kaleme	kale+Noun+A3sg+P1sg+Dat
tasavvur	tasavvur+Noun+A3sg+Pnon+Nom
sahibelerimi	sahibe+Noun+A3pl+P1sg+Acc
safiyetle	safiyet+Noun+A3sg+Pnon+Ins
içtenlikle	içtenlik+Noun+A3sg+Pnon+Ins
şanlı	şan+Noun+A3sg+Pnon+Nom^DB+Adj+With
kızkardeş	kızkardeş+Noun+A3sg+Pnon+Nom
arkadaşlığa	arkadaşlık+Noun+A3sg+Pnon+Dat
daracık	dara+Noun+A3sg+Pnon+Nom^DB+Noun+Dim+A3sg+Pnon+Nom
saniye	saniye+Noun+A3sg+Pnon+Nom
nimet	nimet+Noun+A3sg+Pnon+Nom
düşümde	düşüm+Noun+A3sg+Pnon+Loc
tanığı	tanık+Noun+A3sg+P3sg+Nom
kesinkes	kesinkes+Noun+A3sg+Pnon+Nom
barut	barut+Noun+A3sg+Pnon+Nom
mücadele	mücadele+Noun+A3sg+Pnon+Nom
barkından	bark+Noun+A3sg+P3sg+Abl
yurdumuzdan	yurt+Noun+A3sg+P1pl+Abl
kapakları	kapak+Noun+A3pl+P3sg+Nom
pırıltı	pırıltı+Noun+A3sg+Pnon+Nom
büyükanneye	büyükanne+Noun+A3sg+Pnon+Dat
herşey	herşey+Noun+A3sg+Pnon+Nom
peksimetleri	peksimet+Noun+A3pl+P3sg+Nom
tavayı	tava+Noun+A3sg+Pnon+Acc
müddetçe	müddet+Noun+A3sg+Pnon+Equ
büyükbabalarının	büyükbaba+Noun+A3pl+P3sg+Gen
bacaklarından	bacak+Noun+A3pl+P3pl+Abl
düğmeli	düğme+Noun+A3sg+Pnon+Nom^DB+Adj+With
iliklerini	ilik+Noun+A3pl+P3pl+Acc
pantalon	pantalo+Noun+A3sg+P2sg+Nom
grimsi	gri+Noun+A3sg+Pnon+Nom^DB+Adj+JustLike
çamaşır	çamaşır+Noun+A3sg+Pnon+Nom
askılı	askı+Noun+A3sg+Pnon+Nom^DB+Adj+With
tokasını	toka+Noun+A3sg+P3sg+Acc
muhalefet	muhalefet+Noun+A3sg+Pnon+Nom
öyküsel	öykü+Noun+A3sg+Pnon+Nom^DB+Adj+Related
alaycı	alaycı+Noun+A3sg+Pnon+Nom
ayinden	ayin+Noun+A3sg+Pnon+Abl
namlusuyla	namlu+Noun+A3sg+P3sg+Ins
santim	santim+Noun+A3sg+Pnon+Nom
böcekler	böcek+Noun+A3pl+Pnon+Nom
işkenceleri	işkence+Noun+A3pl+Pnon+Acc
elbisesi	elbise+Noun+A3sg+P3sg+Nom
harp	harp+Noun+A3sg+Pnon+Nom
narasını	nara+Noun+A3sg+P3sg+Acc
bilmiyenler	bilmiyen+Noun+A3pl+Pnon+Nom
tatmin	tatmin+Noun+A3sg+Pnon+Nom
birşeyler	birşey+Noun+A3pl+Pnon+Nom
forsepsi	forseps+Noun+A3sg+P3sg+Nom
ebe	ebe+Noun+A3sg+Pnon+Nom
ayrık	ayrık+Noun+A3sg+Pnon+Nom
okur	okur+Noun+A3sg+Pnon+Nom
hınzır	hınzır+Noun+A3sg+Pnon+Nom
habercilerdeki	haberci+Noun+A3pl+Pnon+Loc^DB+Adj+Rel
hapiste	hapis+Noun+A3sg+Pnon+Loc
hırsız	hırsız+Noun+A3sg+Pnon+Nom
herif	herif+Noun+A3sg+Pnon+Nom
hapishaneden	hapishane+Noun+A3sg+Pnon+Abl
parmaklıklı	parmaklık+Noun+A3sg+Pnon+Nom^DB+Adj+With
boğalara	boğa+Noun+A3pl+Pnon+Dat
karnımda	karın+Noun+A3sg+P1sg+Loc
durağı	durak+Noun+A3sg+P3sg+Nom
kamyonlar	kamyon+Noun+A3pl+Pnon+Nom
salça	salça+Noun+A3sg+Pnon+Nom
kasesinin	kase+Noun+A3sg+P3sg+Gen
sinekleri	sinek+Noun+A3pl+P3sg+Nom
daikka	daikka+Noun+A3sg+Pnon+Nom
deposundaki	depo+Noun+A3sg+P3sg+Loc^DB+Adj+Rel
etmen	etmen+Noun+A3sg+Pnon+Nom
mutfaklarda	mutfak+Noun+A3pl+Pnon+Loc
kahvaltılarını	kahvaltı+Noun+A3pl+P3sg+Acc
vaz	vaz+Noun+A3sg+Pnon+Nom
gidi	gidi+Noun+A3sg+Pnon+Nom
keçi	keçi+Noun+A3sg+Pnon+Nom
göbeğinin	göbek+Noun+A3sg+P3sg+Gen
suretle	suret+Noun+A3sg+Pnon+Ins
hakikati	hakikat+Noun+A3sg+P3sg+Nom
çöle	çöl+Noun+A3sg+Pnon+Dat
dertlerimizi	dert+Noun+A3pl+P1pl+Acc
neticeye	netice+Noun+A3sg+Pnon+Dat
min	mi+Noun+A3sg+P2sg+Nom
fasılalarına	fasıla+Noun+A3pl+P3sg+Dat
yiyecek	yiyecek+Noun+A3sg+Pnon+Nom
giyecek	giyecek+Noun+A3sg+Pnon+Nom
lokmaları	lokma+Noun+A3pl+P3sg+Nom
minnettarım	minnettar+Noun+A3sg+P1sg+Nom
mevcut	mevcut+Noun+A3sg+Pnon+Nom
köpürtüsü	köpürtü+Noun+A3sg+P3sg+Nom
yudumunu	yudum+Noun+A3sg+P3sg+Acc
karyolalar	karyola+Noun+A3pl+Pnon+Nom
pervane	pervane+Noun+A3sg+Pnon+Nom
tahtasındaki	tahta+Noun+A3sg+P3sg+Loc^DB+Adj+Rel
motorlu	motor+Noun+A3sg+Pnon+Nom^DB+Adj+With
teke	teke+Noun+A3sg+Pnon+Nom
sevine	sevi+Noun+A3sg+P2sg+Dat
açıkhava	açıkhava+Noun+A3sg+Pnon+Nom
serseriler	serseri+Noun+A3pl+Pnon+Nom
üzümleri	üzüm+Noun+A3pl+P3sg+Nom
sepet	sepet+Noun+A3sg+Pnon+Nom
bebeğini	bebek+Noun+A3sg+P3sg+Acc
mil	mil+Noun+A3sg+Pnon+Nom
süpapları	süpap+Noun+A3pl+Pnon+Acc
lastikli	lastik+Noun+A3sg+Pnon+Nom^DB+Adj+With
şoseye	şose+Noun+A3sg+Pnon+Dat
bezi	bez+Noun+A3sg+P3sg+Nom
telin	tel+Noun+A3sg+Pnon+Gen
yaygarayı	yaygara+Noun+A3sg+Pnon+Acc
tozlu	toz+Noun+A3sg+Pnon+Nom^DB+Adj+With
tetkik	tetkik+Noun+A3sg+Pnon+Nom
kaskete	kasket+Noun+A3sg+Pnon+Dat
ayakkabılarıyla	ayakkabı+Noun+A3pl+P3sg+Ins
güneşliğini	güneşlik+Noun+A3sg+P3sg+Acc
tasdik	tasdik+Noun+A3sg+Pnon+Nom
kuyruğunu	kuyruk+Noun+A3sg+P3sg+Acc
horoz	horoz+Noun+A3sg+Pnon+Nom
kabara	kabara+Noun+A3sg+Pnon+Nom
ağabeyimin	ağabey+Noun+A3sg+P1sg+Gen
yaşıtları	yaşıt+Noun+A3pl+P3sg+Nom
kürek	kürek+Noun+A3sg+Pnon+Nom
külhanbeyi	külhanbeyi+Noun+A3sg+P3sg+Nom
sırık	sırık+Noun+A3sg+Pnon+Nom
fasulyası	fasulya+Noun+A3sg+P3sg+Nom
tın	tın+Noun+A3sg+Pnon+Nom
yolculağa	yolculağ+Noun+A3sg+Pnon+Dat
tohum	tohum+Noun+A3sg+Pnon+Nom
makinanın	makina+Noun+A3sg+Pnon+Gen
çapalar	çapa+Noun+A3pl+Pnon+Nom
sent	sent+Noun+A3sg+Pnon+Nom
traktörler	traktör+Noun+A3pl+Pnon+Nom
doru	doru+Noun+A3sg+Pnon+Nom
kişniyerek	kişniyerek+Noun+A3sg+Pnon+Nom
perçemlerini	perçem+Noun+A3pl+P2sg+Acc
yelelerini	yele+Noun+A3pl+P3sg+Acc
örmeğe	örmeğ+Noun+A3sg+Pnon+Dat
kurdelasını	kurdela+Noun+A3sg+P3sg+Acc
tay	tay+Noun+A3sg+Pnon+Nom
çekerler	çeker+Noun+A3pl+Pnon+Nom
bayram	bayram+Noun+A3sg+Pnon+Nom
emeğini	emek+Noun+A3sg+P3sg+Acc
prim	prim+Noun+A3sg+Pnon+Nom
içki	içki+Noun+A3sg+Pnon+Nom
alkolsüz	alkol+Noun+A3sg+Pnon+Nom^DB+Adj+Without
meyva	meyva+Noun+A3sg+Pnon+Nom
sel	sel+Noun+A3sg+Pnon+Nom
ızdırap	ızdırap+Noun+A3sg+Pnon+Nom
ordunuzdaki	ordu+Noun+A3sg+P2pl+Loc^DB+Adj+Rel
istikamette	istikamet+Noun+A3sg+Pnon+Loc
terör	terör+Noun+A3sg+Pnon+Nom
leğene	leğen+Noun+A3sg+Pnon+Dat
kovalar	kova+Noun+A3pl+Pnon+Nom
vazo	vazo+Noun+A3sg+Pnon+Nom
tencereye	tencere+Noun+A3sg+Pnon+Dat
yorganlar	yorgan+Noun+A3pl+Pnon+Nom
lamba	lamba+Noun+A3sg+Pnon+Nom
kanaviçe	kanaviçe+Noun+A3sg+Pnon+Nom
gaz	gaz+Noun+A3sg+Pnon+Nom
römorkun	römork+Noun+A3sg+Pnon+Gen
şiltenin	şilte+Noun+A3sg+Pnon+Gen
testere	testere+Noun+A3sg+Pnon+Nom
mengene	mengene+Noun+A3sg+Pnon+Nom
kıskaç	kıskaç+Noun+A3sg+Pnon+Nom
balta	balta+Noun+A3sg+Pnon+Nom
oku	ok+Noun+A3sg+Pnon+Acc
olırım	olır+Noun+A3sg+P1sg+Nom
kitaplığınızdaki	kitap+Noun+A3sg+Pnon+Nom^DB+Noun+Ness+A3sg+P2pl+Loc^DB+Adj+Rel
pipolarını	pipo+Noun+A3pl+P3sg+Acc
zifir	zifir+Noun+A3sg+Pnon+Nom
resmindeki	resim+Noun+A3sg+P3sg+Loc^DB+Adj+Rel
evvelki	evvel+Noun+A3sg+Pnon+Nom^DB+Adj+Rel
sergisinden	sergi+Noun+A3sg+P3sg+Abl
mektup	mektup+Noun+A3sg+Pnon+Nom
söğüt	söğüt+Noun+A3sg+Pnon+Nom
döşeğin	döşek+Noun+A3sg+Pnon+Gen
aletlerinin	alet+Noun+A3pl+P3sg+Gen
somyalar	somya+Noun+A3pl+Pnon+Nom
samanlığa	saman+Noun+A3sg+Pnon+Nom^DB+Noun+Ness+A3sg+Pnon+Dat
saçak	saçak+Noun+A3sg+Pnon+Nom
sabunlu	sabun+Noun+A3sg+Pnon+Nom^DB+Adj+With
köpükleri	köpük+Noun+A3pl+Pnon+Acc
ensesine	ense+Noun+A3sg+P3sg+Dat
ilan	ilan+Noun+A3sg+Pnon+Nom
yinede	yine+Noun+A3sg+Pnon+Loc
yazar	yazar+Noun+A3sg+Pnon+Nom
harfli	harf+Noun+A3sg+Pnon+Nom^DB+Adj+With
küplere	küp+Noun+A3pl+Pnon+Dat
haritanızdaki	harita+Noun+A3sg+P2pl+Loc^DB+Adj+Rel
kartpostal	kartpostal+Noun+A3sg+Pnon+Nom
yarını	yarın+Noun+A3sg+Pnon+Acc
kamplarda	kamp+Noun+A3pl+Pnon+Loc
kağıt	kağıt+Noun+A3sg+Pnon+Nom
zahmetli	zahmet+Noun+A3sg+Pnon+Nom^DB+Adj+With
parlıyan	parlıya+Noun+A3sg+P2sg+Nom
hizalı	hiza+Noun+A3sg+Pnon+Nom^DB+Adj+With
tulumlarla	tulum+Noun+A3pl+Pnon+Ins
hayalarının	haya+Noun+A3pl+P3sg+Gen
pantalonumun	pantalon+Noun+A3sg+P1sg+Gen
alaylı	alaylı+Noun+A3sg+Pnon+Nom
teknesi	tekne+Noun+A3sg+P3sg+Nom
paçalı	paça+Noun+A3sg+Pnon+Nom^DB+Adj+With
kerata	kerata+Noun+A3sg+Pnon+Nom
hergele	hergele+Noun+A3sg+Pnon+Nom
atımı	atım+Noun+A3sg+P3sg+Nom
ocak	ocak+Noun+A3sg+Pnon+Nom
görüntülü	görüntü+Noun+A3sg+Pnon+Nom^DB+Adj+With
dumanın	duma+Noun+A3sg+Pnon+Gen
bardaklardan	bardak+Noun+A3pl+Pnon+Abl
cumartesi	cumartesi+Noun+A3sg+Pnon+Nom
romun	rom+Noun+A3sg+Pnon+Gen
mezarlıklar	mezarlık+Noun+A3pl+Pnon+Nom
kilise	kilise+Noun+A3sg+Pnon+Nom
tabureye	tabure+Noun+A3sg+Pnon+Dat
gezinti	gezinti+Noun+A3sg+Pnon+Nom
saçı	saçı+Noun+A3sg+Pnon+Nom
kıyısındaki	kıyı+Noun+A3sg+P3sg+Loc^DB+Adj+Rel
çingene	çingene+Noun+A3sg+Pnon+Nom
kaçak	kaçak+Noun+A3sg+Pnon+Nom
ufaklığın	ufaklık+Noun+A3sg+Pnon+Gen
soyadı	soyad+Noun+A3sg+P3sg+Nom
baskılı	baskı+Noun+A3sg+Pnon+Nom^DB+Adj+With
gösterisi	gösteri+Noun+A3sg+P3sg+Nom
muhatabı	muhatap+Noun+A3sg+P3sg+Nom
bendim	bent+Noun+A3sg+P1sg+Nom
kaşık	kaşık+Noun+A3sg+Pnon+Nom
eğenin	eğe+Noun+A3sg+Pnon+Gen
şalgamlardan	şalgam+Noun+A3pl+Pnon+Abl
şilinlik	şilin+Noun+A3sg+Pnon+Nom^DB+Noun+Ness+A3sg+Pnon+Nom
aval	aval+Noun+A3sg+Pnon+Nom
gayret	gayret+Noun+A3sg+Pnon+Nom
tanıdığa	tanıdık+Noun+A3sg+Pnon+Dat
ablamı	abla+Noun+A3sg+P1sg+Acc
muzaffer	muzaffer+Noun+A3sg+Pnon+Nom
banknottan	banknot+Noun+A3sg+Pnon+Abl
sığır	sığır+Noun+A3sg+Pnon+Nom
çaydanlığın	çaydanlık+Noun+A3sg+Pnon+Gen
anlaşmalı	anlaşma+Noun+A3sg+Pnon+Nom^DB+Adj+With
çarşamba	çarşamba+Noun+A3sg+Pnon+Nom
zil	zil+Noun+A3sg+Pnon+Nom
mumla	mum+Noun+A3sg+Pnon+Ins
kare	kare+Noun+A3sg+Pnon+Nom
zeminli	zemin+Noun+A3sg+Pnon+Nom^DB+Adj+With
avluda	avlu+Noun+A3sg+Pnon+Loc
bira	bira+Noun+A3sg+Pnon+Nom
imalathanesinin	imalathane+Noun+A3sg+P3sg+Gen
kasıtlı	kasıt+Noun+A3sg+Pnon+Nom^DB+Adj+With
lahana	lahana+Noun+A3sg+Pnon+Nom
şimşir	şimşir+Noun+A3sg+Pnon+Nom
pudinge	puding+Noun+A3sg+Pnon+Dat
kadarıyla	kadar+Noun+A3sg+P3sg+Ins
dalkavuk	dalkavuk+Noun+A3sg+Pnon+Nom
tipler	tip+Noun+A3pl+Pnon+Nom
izlenimini	izlenim+Noun+A3sg+P3sg+Acc
vasıflı	vasıf+Noun+A3sg+Pnon+Nom^DB+Adj+With
yordamdaki	yordam+Noun+A3sg+Pnon+Loc^DB+Adj+Rel
sistemindeki	sistem+Noun+A3sg+P3sg+Loc^DB+Adj+Rel
yağmura	yağmur+Noun+A3sg+Pnon+Dat
tokat	tokat+Noun+A3sg+Pnon+Nom
kıyım	kıyım+Noun+A3sg+Pnon+Nom
sakallı	sakal+Noun+A3sg+Pnon+Nom^DB+Adj+With
favorilerinin	favori+Noun+A3pl+P3sg+Gen
tuvalet	tuvalet+Noun+A3sg+Pnon+Nom
şöminenin	şömine+Noun+A3sg+Pnon+Gen
dumanlı	duman+Noun+A3sg+Pnon+Nom^DB+Adj+With
bataklıkta	bataklık+Noun+A3sg+Pnon+Loc
rafta	raf+Noun+A3sg+Pnon+Loc
küf	küf+Noun+A3sg+Pnon+Nom
lime	lime+Noun+A3sg+Pnon+Nom
obje	obje+Noun+A3sg+Pnon+Nom
ziyafet	ziyafet+Noun+A3sg+Pnon+Nom
tıkırtılar	tıkırtı+Noun+A3pl+Pnon+Nom
karafatmalar	karafatma+Noun+A3pl+Pnon+Nom
cadıya	cadı+Noun+A3sg+Pnon+Dat
balmumundan	balmumu+Noun+A3sg+P3sg+Abl
pastayı	pasta+Noun+A3sg+Pnon+Acc
taklit	taklit+Noun+A3sg+Pnon+Nom
yapılı	yapı+Noun+A3sg+Pnon+Nom^DB+Adj+With
zencefil	zencefil+Noun+A3sg+Pnon+Nom
amonyum	amonyum+Noun+A3sg+Pnon+Nom
karbonatlara	karbonat+Noun+A3pl+Pnon+Dat
sindirim	sindirim+Noun+A3sg+Pnon+Nom
ceviz	ceviz+Noun+A3sg+Pnon+Nom
kabuklarından	kabuk+Noun+A3pl+P3pl+Abl
kediye	kedi+Noun+A3sg+Pnon+Dat
etekli	etek+Noun+A3sg+Pnon+Nom^DB+Adj+With
kanepeye	kanepe+Noun+A3sg+Pnon+Dat
akortçusunun	akort+Noun+A3sg+Pnon+Nom^DB+Noun+Agt+A3sg+P3sg+Gen
boğazına	boğaz+Noun+A3sg+P3sg+Dat
oluşumların	oluşum+Noun+A3pl+Pnon+Gen
beklentisi	beklenti+Noun+A3sg+P3sg+Nom
kimyasını	kimya+Noun+A3sg+P3sg+Acc
eninde	en+Noun+A3sg+P3sg+Loc
melankoliyle	melankoli+Noun+A3sg+Pnon+Ins
mazur	mazur+Noun+A3sg+Pnon+Nom
doğumlu	doğum+Noun+A3sg+Pnon+Nom^DB+Adj+With
müsaade	müsaade+Noun+A3sg+Pnon+Nom
gelirler	gelir+Noun+A3pl+Pnon+Nom
teşebbüs	teşebbüs+Noun+A3sg+Pnon+Nom
fare	fare+Noun+A3sg+Pnon+Nom
gelinliğimin	gelinlik+Noun+A3sg+P1sg+Gen
gerdanında	gerdan+Noun+A3sg+P3sg+Loc
tenezzül	tenezzül+Noun+A3sg+Pnon+Nom
düzine	düzine+Noun+A3sg+Pnon+Nom
kavunla	kavun+Noun+A3sg+Pnon+Ins
salatalık	salatalık+Noun+A3sg+Pnon+Nom
yumru	yumru+Noun+A3sg+Pnon+Nom
serayı	sera+Noun+A3sg+Pnon+Acc
pat	pat+Noun+A3sg+Pnon+Nom
mürekkebi	mürekkep+Noun+A3sg+Pnon+Acc
gezmene	gezmen+Noun+A3sg+Pnon+Dat
sirke	sirke+Noun+A3sg+Pnon+Nom
süngeri	sünger+Noun+A3sg+P3sg+Nom
sivilceler	sivilce+Noun+A3pl+Pnon+Nom
bilekleri	bilek+Noun+A3pl+P3sg+Nom
kısmındaki	kısım+Noun+A3sg+P3sg+Loc^DB+Adj+Rel
mekanik	mekanik+Noun+A3sg+Pnon+Nom
maharet	maharet+Noun+A3sg+Pnon+Nom
sürpriz	sürpriz+Noun+A3sg+Pnon+Nom
bere	bere+Noun+A3sg+Pnon+Nom
anahtarlarla	anahtar+Noun+A3pl+Pnon+Ins
vadeli	vade+Noun+A3sg+Pnon+Nom^DB+Adj+With
kısıtlı	kısıt+Noun+A3sg+Pnon+Nom^DB+Adj+With
çapındaki	çap+Noun+A3sg+P3sg+Loc^DB+Adj+Rel
melodramlardaki	melodram+Noun+A3pl+Pnon+Loc^DB+Adj+Rel
huysuz	huy+Noun+A3sg+Pnon+Nom^DB+Adj+Without
şiddetlenen	şiddet+Noun+A3sg+Pnon+Nom^DB+Verb+Acquire+Pos^DB+Adj+PresPart
kirlenen	kir+Noun+A3sg+Pnon+Nom^DB+Verb+Acquire+Pos^DB+Adj+PresPart
ihtiraslı	ihtiras+Noun+A3sg+Pnon+Nom^DB+Adj+With
astarlı	astar+Noun+A3sg+Pnon+Nom^DB+Adj+With
kapüşonlu	kapüşon+Noun+A3sg+Pnon+Nom^DB+Adj+With
kıymetli	kıymet+Noun+A3sg+Pnon+Nom^DB+Adj+With
doyumsuz	doyum+Noun+A3sg+Pnon+Nom^DB+Adj+Without
tumturaklı	tumturak+Noun+A3sg+Pnon+Nom^DB+Adj+With
parterdeki	parter+Noun+A3sg+Pnon+Loc^DB+Adj+Rel
çehreli	çehre+Noun+A3sg+Pnon+Nom^DB+Adj+With
çerçeveli	çerçeve+Noun+A3sg+Pnon+Nom^DB+Adj+With
kıpırtısız	kıpırtı+Noun+A3sg+Pnon+Nom^DB+Adj+Without
ihtiyatlı	ihtiyat+Noun+A3sg+Pnon+Nom^DB+Adj+With
isabetli	isabet+Noun+A3sg+Pnon+Nom^DB+Adj+With
iğneli	iğne+Noun+A3sg+Pnon+Nom^DB+Adj+With
drahomasız	drahoma+Noun+A3sg+Pnon+Nom^DB+Adj+Without
nüfuslu	nüfus+Noun+A3sg+Pnon+Nom^DB+Adj+With
kusursuz	kusur+Noun+A3sg+Pnon+Nom^DB+Adj+Without
ünlü	ün+Noun+A3sg+Pnon+Nom^DB+Adj+With
namlı	nam+Noun+A3sg+Pnon+Nom^DB+Adj+With
azametli	azamet+Noun+A3sg+Pnon+Nom^DB+Adj+With
kravatlı	kravat+Noun+A3sg+Pnon+Nom^DB+Adj+With
ferli	fer+Noun+A3sg+Pnon+Nom^DB+Adj+With
devimsi	dev+Noun+A3sg+Pnon+Nom^DB+Adj+JustLike
elektrikli	elektrik+Noun+A3sg+Pnon+Nom^DB+Adj+With
çöreklenen	çörek+Noun+A3sg+Pnon+Nom^DB+Verb+Acquire+Pos^DB+Adj+PresPart
kuşkulandığınız	kuşku+Noun+A3sg+Pnon+Nom^DB+Verb+Acquire+Pos^DB+Adj+PastPart+P2pl
butlu	but+Noun+A3sg+Pnon+Nom^DB+Adj+With
karşılaşmalarımızdaki	karşılaşma+Noun+A3pl+P1pl+Loc^DB+Adj+Rel
görünümünüzdeki	görünüm+Noun+A3sg+P2pl+Loc^DB+Adj+Rel
nezdinizdeki	nezit+Noun+A3sg+P2pl+Loc^DB+Adj+Rel
salyalı	salya+Noun+A3sg+Pnon+Nom^DB+Adj+With
edepsiz	edep+Noun+A3sg+Pnon+Nom^DB+Adj+Without
çilli	çil+Noun+A3sg+Pnon+Nom^DB+Adj+With
tavanlı	tavan+Noun+A3sg+Pnon+Nom^DB+Adj+With
işlemeli	işleme+Noun+A3sg+Pnon+Nom^DB+Adj+With
tenli	ten+Noun+A3sg+Pnon+Nom^DB+Adj+With
köstekli	köstek+Noun+A3sg+Pnon+Nom^DB+Adj+With
benekli	benek+Noun+A3sg+Pnon+Nom^DB+Adj+With
şuursuzca	şuur+Noun+A3sg+Pnon+Nom^DB+Adj+Without^DB+Adj+AsIf
benizli	beniz+Noun+A3sg+Pnon+Nom^DB+Adj+With
hünerli	hüner+Noun+A3sg+Pnon+Nom^DB+Adj+With
heybetli	heybet+Noun+A3sg+Pnon+Nom^DB+Adj+With
mantıklı	mantık+Noun+A3sg+Pnon+Nom^DB+Adj+With
sonrasındaki	sonra+Noun+A3sg+P3sg+Loc^DB+Adj+Rel
verimli	verim+Noun+A3sg+Pnon+Nom^DB+Adj+With
fizyolojik	fizyoloji+Noun+A3sg+Pnon+Nom^DB+Adj+Related
zarflı	zarf+Noun+A3sg+Pnon+Nom^DB+Adj+With
iltihaplı	iltihap+Noun+A3sg+Pnon+Nom^DB+Adj+With
kuzeyindeki	kuzey+Noun+A3sg+P3sg+Loc^DB+Adj+Rel
niteliğindeki	nitelik+Noun+A3sg+P3sg+Loc^DB+Adj+Rel
edebiyatındaki	edebiyat+Noun+A3sg+P3sg+Loc^DB+Adj+Rel
öğretisindeki	öğreti+Noun+A3sg+P3sg+Loc^DB+Adj+Rel
dönemindeki	dönem+Noun+A3sg+P3sg+Loc^DB+Adj+Rel
dolaylı	dolay+Noun+A3sg+Pnon+Nom^DB+Adj+With
kolalı	kola+Noun+A3sg+Pnon+Nom^DB+Adj+With
fabrikadaki	fabrika+Noun+A3sg+Pnon+Loc^DB+Adj+Rel
sedasız	seda+Noun+A3sg+Pnon+Nom^DB+Adj+Without
ikircikli	ikircik+Noun+A3sg+Pnon+Nom^DB+Adj+With
yeryüzündeki	yeryüzü+Noun+A3sg+P3sg+Loc^DB+Adj+Rel
dizisindeki	dizi+Noun+A3sg+P3sg+Loc^DB+Adj+Rel
uzunluğundaki	uzunluk+Noun+A3sg+P3sg+Loc^DB+Adj+Rel
kapsamındaki	kapsam+Noun+A3sg+P3sg+Loc^DB+Adj+Rel
uzaklıktaki	uzaklık+Noun+A3sg+Pnon+Loc^DB+Adj+Rel
çelimsiz	çelim+Noun+A3sg+Pnon+Nom^DB+Adj+Without
ufuktaki	ufuk+Noun+A3sg+Pnon+Loc^DB+Adj+Rel
kasnaksız	kasnak+Noun+A3sg+Pnon+Nom^DB+Adj+Without
zincirsiz	zincir+Noun+A3sg+Pnon+Nom^DB+Adj+Without
gizemli	gizem+Noun+A3sg+Pnon+Nom^DB+Adj+With
tereyağlı	tereyağı+Noun+A3sg+Pnon+Nom^DB+Adj+With
böreksiz	börek+Noun+A3sg+Pnon+Nom^DB+Adj+Without
sisli	sis+Noun+A3sg+Pnon+Nom^DB+Adj+With
dahaki	daha+Noun+A3sg+Pnon+Nom^DB+Adj+Rel
kabiliyetli	kabiliyet+Noun+A3sg+Pnon+Nom^DB+Adj+With
espirili	espiri+Noun+A3sg+Pnon+Nom^DB+Adj+With
beceriksiz	becerik+Noun+A3sg+Pnon+Nom^DB+Adj+Without
katmerli	katmer+Noun+A3sg+Pnon+Nom^DB+Adj+With
hareli	hare+Noun+A3sg+Pnon+Nom^DB+Adj+With
pahalı	paha+Noun+A3sg+Pnon+Nom^DB+Adj+With
tahsilli	tahsil+Noun+A3sg+Pnon+Nom^DB+Adj+With
markalı	marka+Noun+A3sg+Pnon+Nom^DB+Adj+With
çamurlu	çamur+Noun+A3sg+Pnon+Nom^DB+Adj+With
kalitesiz	kalite+Noun+A3sg+Pnon+Nom^DB+Adj+Without
ayrıcalıklı	ayrıcalık+Noun+A3sg+Pnon+Nom^DB+Adj+With
ödüllü	ödül+Noun+A3sg+Pnon+Nom^DB+Adj+With
pürüzsüz	pürüz+Noun+A3sg+Pnon+Nom^DB+Adj+Without
engebeli	engebe+Noun+A3sg+Pnon+Nom^DB+Adj+With
dolambaçlı	dolambaç+Noun+A3sg+Pnon+Nom^DB+Adj+With
hummalı	humma+Noun+A3sg+Pnon+Nom^DB+Adj+With
bilinçli	bilinç+Noun+A3sg+Pnon+Nom^DB+Adj+With
cilalı	cila+Noun+A3sg+Pnon+Nom^DB+Adj+With
sahanlıktaki	sahan+Noun+A3sg+Pnon+Nom^DB+Noun+Ness+A3sg+Pnon+Loc^DB+Adj+Rel
alacalı	alaca+Noun+A3sg+Pnon+Nom^DB+Adj+With
astımlı	astım+Noun+A3sg+Pnon+Nom^DB+Adj+With
filizlendirdiği	filiz+Noun+A3sg+Pnon+Nom^DB+Verb+Acquire^DB+Verb+Caus+Pos^DB+Adj+PastPart+P3sg
riyasız	riya+Noun+A3sg+Pnon+Nom^DB+Adj+Without
kültürlü	kültür+Noun+A3sg+Pnon+Nom^DB+Adj+With
karşılıksız	karşılık+Noun+A3sg+Pnon+Nom^DB+Adj+Without
cezaevindeki	cezaevi+Noun+A3sg+P3sg+Loc^DB+Adj+Rel
ıztıraplı	ıztırap+Noun+A3sg+Pnon+Nom^DB+Adj+With
adaleli	adale+Noun+A3sg+Pnon+Nom^DB+Adj+With
ütülü	ütü+Noun+A3sg+Pnon+Nom^DB+Adj+With
imalı	ima+Noun+A3sg+Pnon+Nom^DB+Adj+With
ebatlardaki	ebat+Noun+A3pl+Pnon+Loc^DB+Adj+Rel
jandarmasız	jandarma+Noun+A3sg+Pnon+Nom^DB+Adj+Without
cüsseli	cüsse+Noun+A3sg+Pnon+Nom^DB+Adj+With
zehirli	zehir+Noun+A3sg+Pnon+Nom^DB+Adj+With
bilgisayarlarındaki	bilgisayar+Noun+A3pl+P3sg+Loc^DB+Adj+Rel
takılardaki	takı+Noun+A3pl+Pnon+Loc^DB+Adj+Rel
listelerdeki	liste+Noun+A3pl+Pnon+Loc^DB+Adj+Rel
klasörünüzdeki	klasör+Noun+A3sg+P2pl+Loc^DB+Adj+Rel
etkileşimli	etkileşim+Noun+A3sg+Pnon+Nom^DB+Adj+With
bölgesindeki	bölge+Noun+A3sg+P3sg+Loc^DB+Adj+Rel
veritabanındaki	veritabanı+Noun+A3sg+P3sg+Loc^DB+Adj+Rel
tablosundaki	tablo+Noun+A3sg+P3sg+Loc^DB+Adj+Rel
sayfadaki	sayfa+Noun+A3sg+Pnon+Loc^DB+Adj+Rel
gruptaki	grup+Noun+A3sg+Pnon+Loc^DB+Adj+Rel
seçili	seçi+Noun+A3sg+Pnon+Nom^DB+Adj+With
çubuğundaki	çubuk+Noun+A3sg+P3sg+Loc^DB+Adj+Rel
diskli	disk+Noun+A3sg+Pnon+Nom^DB+Adj+With
dağıtımlı	dağıtım+Noun+A3sg+Pnon+Nom^DB+Adj+With
kutusundaki	kutu+Noun+A3sg+P3sg+Loc^DB+Adj+Rel
şeritli	şerit+Noun+A3sg+Pnon+Nom^DB+Adj+With
yetkisiz	yetki+Noun+A3sg+Pnon+Nom^DB+Adj+Without
şablonundaki	şablon+Noun+A3sg+P3sg+Loc^DB+Adj+Rel
sertifikalı	sertifika+Noun+A3sg+Pnon+Nom^DB+Adj+With
birimindeki	birim+Noun+A3sg+P3sg+Loc^DB+Adj+Rel
eşzamanlı	eşzaman+Noun+A3sg+Pnon+Nom^DB+Adj+With
satırlardaki	satır+Noun+A3pl+Pnon+Loc^DB+Adj+Rel
kılavuzundaki	kılavuz+Noun+A3sg+P3sg+Loc^DB+Adj+Rel
şifreli	şifre+Noun+A3sg+Pnon+Nom^DB+Adj+With
dizindeki	dizin+Noun+A3sg+Pnon+Loc^DB+Adj+Rel
nesnedeki	nesne+Noun+A3sg+Pnon+Loc^DB+Adj+Rel
ücretsiz	ücret+Noun+A3sg+Pnon+Nom^DB+Adj+Without
sunucudaki	sunucu+Noun+A3sg+Pnon+Loc^DB+Adj+Rel
hücresindeki	hücre+Noun+A3sg+P3sg+Loc^DB+Adj+Rel
girdideki	girdi+Noun+A3sg+Pnon+Loc^DB+Adj+Rel
aşamalı	aşama+Noun+A3sg+Pnon+Nom^DB+Adj+With
kablosuz	kablo+Noun+A3sg+Pnon+Nom^DB+Adj+Without
kodlu	kod+Noun+A3sg+Pnon+Nom^DB+Adj+With
etiketli	etiket+Noun+A3sg+Pnon+Nom^DB+Adj+With
koşulsuz	koşul+Noun+A3sg+Pnon+Nom^DB+Adj+Without
grafiklendiği	grafik+Noun+A3sg+Pnon+Nom^DB+Verb+Acquire+Pos^DB+Adj+PastPart+P3sg
ekranlı	ekran+Noun+A3sg+Pnon+Nom^DB+Adj+With
başvurudaki	başvuru+Noun+A3sg+Pnon+Loc^DB+Adj+Rel
kesirli	kesir+Noun+A3sg+Pnon+Nom^DB+Adj+With
dağılımlı	dağılım+Noun+A3sg+Pnon+Nom^DB+Adj+With
sihirbazındaki	sihirbaz+Noun+A3sg+P3sg+Loc^DB+Adj+Rel
ofisteki	ofis+Noun+A3sg+Pnon+Loc^DB+Adj+Rel
kimliğindeki	kimlik+Noun+A3sg+P3sg+Loc^DB+Adj+Rel
paketindeki	paket+Noun+A3sg+P3sg+Loc^DB+Adj+Rel
ilkeli	ilke+Noun+A3sg+Pnon+Nom^DB+Adj+With
katmanındaki	katman+Noun+A3sg+P3sg+Loc^DB+Adj+Rel
istasyonundaki	istasyon+Noun+A3sg+P3sg+Loc^DB+Adj+Rel
öğeli	öğe+Noun+A3sg+Pnon+Nom^DB+Adj+With
hasarlı	hasar+Noun+A3sg+Pnon+Nom^DB+Adj+With
sitedeki	site+Noun+A3sg+Pnon+Loc^DB+Adj+Rel
mesafedeki	mesafe+Noun+A3sg+Pnon+Loc^DB+Adj+Rel
ayarlarınızdaki	ayar+Noun+A3pl+P2pl+Loc^DB+Adj+Rel
dosyasındaki	dosya+Noun+A3sg+P3sg+Loc^DB+Adj+Rel
oranlı	oran+Noun+A3sg+Pnon+Nom^DB+Adj+With
seçimli	seçim+Noun+A3sg+Pnon+Nom^DB+Adj+With
başlıklı	başlık+Noun+A3sg+Pnon+Nom^DB+Adj+With
sorunlu	sorun+Noun+A3sg+Pnon+Nom^DB+Adj+With
üslü	üs+Noun+A3sg+Pnon+Nom^DB+Adj+With
devresel	devre+Noun+A3sg+Pnon+Nom^DB+Adj+Related
işlevsiz	işlev+Noun+A3sg+Pnon+Nom^DB+Adj+Without
işlemcili	işlemci+Noun+A3sg+Pnon+Nom^DB+Adj+With
eğimli	eğim+Noun+A3sg+Pnon+Nom^DB+Adj+With
uzantılı	uzantı+Noun+A3sg+Pnon+Nom^DB+Adj+With
blögesel	blöge+Noun+A3sg+Pnon+Nom^DB+Adj+Related
simgedeki	simge+Noun+A3sg+Pnon+Loc^DB+Adj+Rel
menüsündeki	menü+Noun+A3sg+P3sg+Loc^DB+Adj+Rel
programlı	program+Noun+A3sg+Pnon+Nom^DB+Adj+With
işyerinizdeki	işyeri+Noun+A3sg+P2pl+Loc^DB+Adj+Rel
eksenli	eksen+Noun+A3sg+Pnon+Nom^DB+Adj+With
sakıncalı	sakınca+Noun+A3sg+Pnon+Nom^DB+Adj+With
ağımdaki	ağım+Noun+A3sg+Pnon+Loc^DB+Adj+Rel
orantılı	orantı+Noun+A3sg+Pnon+Nom^DB+Adj+With
bayraklı	bayrak+Noun+A3sg+Pnon+Nom^DB+Adj+With
nottaki	not+Noun+A3sg+Pnon+Loc^DB+Adj+Rel
aygıttaki	aygıt+Noun+A3sg+Pnon+Loc^DB+Adj+Rel
slaytlardaki	slayt+Noun+A3pl+Pnon+Loc^DB+Adj+Rel
kartındaki	kart+Noun+A3sg+P3sg+Loc^DB+Adj+Rel
kalanındaki	kalan+Noun+A3sg+P3sg+Loc^DB+Adj+Rel
serisindeki	seri+Noun+A3sg+P3sg+Loc^DB+Adj+Rel
cetveldeki	cetvel+Noun+A3sg+Pnon+Loc^DB+Adj+Rel
ölçekli	ölçek+Noun+A3sg+Pnon+Nom^DB+Adj+With
bağlantısız	bağlantı+Noun+A3sg+Pnon+Nom^DB+Adj+Without
belgedeki	belge+Noun+A3sg+Pnon+Loc^DB+Adj+Rel
tırtıklı	tırtık+Noun+A3sg+Pnon+Nom^DB+Adj+With
kategorisindeki	kategori+Noun+A3sg+P3sg+Loc^DB+Adj+Rel
sürücüsündeki	sürücü+Noun+A3sg+P3sg+Loc^DB+Adj+Rel
paylaşımlı	paylaşım+Noun+A3sg+Pnon+Nom^DB+Adj+With
öncelikli	öncelik+Noun+A3sg+Pnon+Nom^DB+Adj+With
komutundaki	komut+Noun+A3sg+P3sg+Loc^DB+Adj+Rel
konsolsuz	konsol+Noun+A3sg+Pnon+Nom^DB+Adj+Without
içeriklerindeki	içerik+Noun+A3pl+P3sg+Loc^DB+Adj+Rel
çıktıdaki	çıktı+Noun+A3sg+Pnon+Loc^DB+Adj+Rel
yürürlükteki	yürürlük+Noun+A3sg+Pnon+Loc^DB+Adj+Rel
uluslararası	ulus+Noun+A3pl+Pnon+Nom^DB+Adj+InBetween
memeli	meme+Noun+A3sg+Pnon+Nom^DB+Adj+With
mürettebatlı	mürettebat+Noun+A3sg+Pnon+Nom^DB+Adj+With
ovadaki	ova+Noun+A3sg+Pnon+Loc^DB+Adj+Rel
palmiyeli	palmiye+Noun+A3sg+Pnon+Nom^DB+Adj+With
çilekli	çilek+Noun+A3sg+Pnon+Nom^DB+Adj+With
peynirimsi	peynir+Noun+A3sg+Pnon+Nom^DB+Adj+JustLike
soslu	sos+Noun+A3sg+Pnon+Nom^DB+Adj+With
midyeli	midye+Noun+A3sg+Pnon+Nom^DB+Adj+With
çivili	çivi+Noun+A3sg+Pnon+Nom^DB+Adj+With
sorumsuz	sorum+Noun+A3sg+Pnon+Nom^DB+Adj+Without
bulutlu	bulut+Noun+A3sg+Pnon+Nom^DB+Adj+With
ihbarlı	ihbar+Noun+A3sg+Pnon+Nom^DB+Adj+With
sayısındadaki	sayısında+Noun+A3sg+Pnon+Loc^DB+Adj+Rel
kökenli	köken+Noun+A3sg+Pnon+Nom^DB+Adj+With
istikrarsız	istikrar+Noun+A3sg+Pnon+Nom^DB+Adj+Without
kılıflı	kılıf+Noun+A3sg+Pnon+Nom^DB+Adj+With
menzilindeki	menzil+Noun+A3sg+P3sg+Loc^DB+Adj+Rel
riskli	risk+Noun+A3sg+Pnon+Nom^DB+Adj+With
kazalı	kaza+Noun+A3sg+Pnon+Nom^DB+Adj+With
üniformalı	üniforma+Noun+A3sg+Pnon+Nom^DB+Adj+With
önderliğindeki	önder+Noun+A3sg+Pnon+Nom^DB+Noun+Ness+A3sg+P2sg+Loc^DB+Adj+Rel
bazlı	baz+Noun+A3sg+Pnon+Nom^DB+Adj+With
mahalleli	mahalle+Noun+A3sg+Pnon+Nom^DB+Adj+With
otelindeki	otel+Noun+A3sg+P3sg+Loc^DB+Adj+Rel
mahsullü	mahsul+Noun+A3sg+Pnon+Nom^DB+Adj+With
turizmdeki	turizm+Noun+A3sg+Pnon+Loc^DB+Adj+Rel
sektöründeki	sektör+Noun+A3sg+P3sg+Loc^DB+Adj+Rel
taksitli	taksit+Noun+A3sg+Pnon+Nom^DB+Adj+With
desilebeli	desilebe+Noun+A3sg+Pnon+Nom^DB+Adj+With
ideolojik	ideoloji+Noun+A3sg+Pnon+Nom^DB+Adj+Related
kapasiteli	kapasite+Noun+A3sg+Pnon+Nom^DB+Adj+With
çanağındaki	çanak+Noun+A3sg+P3sg+Loc^DB+Adj+Rel
sahilindeki	sahil+Noun+A3sg+P3sg+Loc^DB+Adj+Rel
kucağındaki	kucak+Noun+A3sg+P3sg+Loc^DB+Adj+Rel
güneydeki	güney+Noun+A3sg+Pnon+Loc^DB+Adj+Rel
konserdeki	konser+Noun+A3sg+Pnon+Loc^DB+Adj+Rel
tabancalı	tabanca+Noun+A3sg+Pnon+Nom^DB+Adj+With
torbadaki	torba+Noun+A3sg+Pnon+Loc^DB+Adj+Rel
ekolojik	ekoloji+Noun+A3sg+Pnon+Nom^DB+Adj+Related
iyotlu	iyot+Noun+A3sg+Pnon+Nom^DB+Adj+With
meteorolojik	meteoroloji+Noun+A3sg+Pnon+Nom^DB+Adj+Related
haneli	hane+Noun+A3sg+Pnon+Nom^DB+Adj+With
sütlü	süt+Noun+A3sg+Pnon+Nom^DB+Adj+With
macunlu	macun+Noun+A3sg+Pnon+Nom^DB+Adj+With
boncuklu	boncuk+Noun+A3sg+Pnon+Nom^DB+Adj+With
simli	sim+Noun+A3sg+Pnon+Nom^DB+Adj+With
fıstıklı	fıstık+Noun+A3sg+Pnon+Nom^DB+Adj+With
görkemli	görkem+Noun+A3sg+Pnon+Nom^DB+Adj+With
konforlu	konfor+Noun+A3sg+Pnon+Nom^DB+Adj+With
vadideki	vadi+Noun+A3sg+Pnon+Loc^DB+Adj+Rel
biyolojik	biyoloji+Noun+A3sg+Pnon+Nom^DB+Adj+Related
domatesli	domates+Noun+A3sg+Pnon+Nom^DB+Adj+With
soğanlı	soğan+Noun+A3sg+Pnon+Nom^DB+Adj+With
kaşarlı	kaşar+Noun+A3sg+Pnon+Nom^DB+Adj+With
yamaçlarındaki	yamaç+Noun+A3pl+P3sg+Loc^DB+Adj+Rel
özenli	özen+Noun+A3sg+Pnon+Nom^DB+Adj+With
gişesindeki	gişe+Noun+A3sg+P3sg+Loc^DB+Adj+Rel
şifalı	şifa+Noun+A3sg+Pnon+Nom^DB+Adj+With
doğusundaki	doğu+Noun+A3sg+P3sg+Loc^DB+Adj+Rel
kesintisiz	kesinti+Noun+A3sg+Pnon+Nom^DB+Adj+Without
depremdeki	deprem+Noun+A3sg+Pnon+Loc^DB+Adj+Rel
felçli	felç+Noun+A3sg+Pnon+Nom^DB+Adj+With
ağaçlıklı	ağaçlık+Noun+A3sg+Pnon+Nom^DB+Adj+With
logosundaki	logo+Noun+A3sg+P3sg+Loc^DB+Adj+Rel
hologramlı	hologram+Noun+A3sg+Pnon+Nom^DB+Adj+With
indirimli	indirim+Noun+A3sg+Pnon+Nom^DB+Adj+With
standlardaki	stand+Noun+A3pl+Pnon+Loc^DB+Adj+Rel
yelkenli	yelken+Noun+A3sg+Pnon+Nom^DB+Adj+With
armalı	arma+Noun+A3sg+Pnon+Nom^DB+Adj+With
sırmalı	sırma+Noun+A3sg+Pnon+Nom^DB+Adj+With
buzlu	buz+Noun+A3sg+Pnon+Nom^DB+Adj+With
mevsimlerdeki	mevsim+Noun+A3pl+Pnon+Loc^DB+Adj+Rel
krokanlı	krokan+Noun+A3sg+Pnon+Nom^DB+Adj+With
haşmetli	haşmet+Noun+A3sg+Pnon+Nom^DB+Adj+With
sezondaki	sezon+Noun+A3sg+Pnon+Loc^DB+Adj+Rel
madalyalı	madalya+Noun+A3sg+Pnon+Nom^DB+Adj+With
iddalı	idda+Noun+A3sg+Pnon+Nom^DB+Adj+With
karakterli	karakter+Noun+A3sg+Pnon+Nom^DB+Adj+With
puanlı	puan+Noun+A3sg+Pnon+Nom^DB+Adj+With
tenisteki	tenis+Noun+A3sg+Pnon+Loc^DB+Adj+Rel
lisanslı	lisans+Noun+A3sg+Pnon+Nom^DB+Adj+With
müjdeli	müjde+Noun+A3sg+Pnon+Nom^DB+Adj+With
stresli	stres+Noun+A3sg+Pnon+Nom^DB+Adj+With
futbolsuz	futbol+Noun+A3sg+Pnon+Nom^DB+Adj+Without
kamuoyundaki	kamuoyu+Noun+A3sg+P3sg+Loc^DB+Adj+Rel
golsüz	gol+Noun+A3sg+Pnon+Nom^DB+Adj+Without
maçtaki	maç+Noun+A3sg+Pnon+Loc^DB+Adj+Rel
avantajlı	avantaj+Noun+A3sg+Pnon+Nom^DB+Adj+With
stattaki	stat+Noun+A3sg+Pnon+Loc^DB+Adj+Rel
tribünlerdeki	tribün+Noun+A3pl+Pnon+Loc^DB+Adj+Rel
sahadaki	saha+Noun+A3sg+Pnon+Loc^DB+Adj+Rel
psikolojik	psikoloji+Noun+A3sg+Pnon+Nom^DB+Adj+Related
trefli	tref+Noun+A3sg+Pnon+Nom^DB+Adj+With
taktiksel	taktik+Noun+A3sg+Pnon+Nom^DB+Adj+Related
ribauntlardaki	ribaunt+Noun+A3pl+Pnon+Loc^DB+Adj+Rel
otoparklı	otopark+Noun+A3sg+Pnon+Nom^DB+Adj+With
mülkiyetli	mülkiyet+Noun+A3sg+Pnon+Nom^DB+Adj+With
peşinatsız	peşinat+Noun+A3sg+Pnon+Nom^DB+Adj+Without
havuzlardaki	havuz+Noun+A3pl+Pnon+Loc^DB+Adj+Rel
izolasyonlu	izolasyon+Noun+A3sg+Pnon+Nom^DB+Adj+With
bordürlü	bordür+Noun+A3sg+Pnon+Nom^DB+Adj+With
teknolojik	teknoloji+Noun+A3sg+Pnon+Nom^DB+Adj+Related
talihsiz	talih+Noun+A3sg+Pnon+Nom^DB+Adj+Without
basınçlı	basınç+Noun+A3sg+Pnon+Nom^DB+Adj+With
zamlı	zam+Noun+A3sg+Pnon+Nom^DB+Adj+With
klorlu	klor+Noun+A3sg+Pnon+Nom^DB+Adj+With
atılımlı	atılım+Noun+A3sg+Pnon+Nom^DB+Adj+With
kıdemli	kıdem+Noun+A3sg+Pnon+Nom^DB+Adj+With
bankalardaki	banka+Noun+A3pl+Pnon+Loc^DB+Adj+Rel
yokuşlu	yokuş+Noun+A3sg+Pnon+Nom^DB+Adj+With
mezbahalardaki	mezbaha+Noun+A3pl+Pnon+Loc^DB+Adj+Rel
ruhsatlı	ruhsat+Noun+A3sg+Pnon+Nom^DB+Adj+With
alımlı	alım+Noun+A3sg+Pnon+Nom^DB+Adj+With
ojeli	oje+Noun+A3sg+Pnon+Nom^DB+Adj+With
tasmasız	tasma+Noun+A3sg+Pnon+Nom^DB+Adj+Without
sanayileşen	sanayi+Noun+A3sg+Pnon+Nom^DB+Verb+Become+Pos^DB+Adj+PresPart
şubesindeki	şube+Noun+A3sg+P3sg+Loc^DB+Adj+Rel
vurgunundaki	vurgun+Noun+A3sg+P3sg+Loc^DB+Adj+Rel
vefalı	vefa+Noun+A3sg+Pnon+Nom^DB+Adj+With
fıkradaki	fıkra+Noun+A3sg+Pnon+Loc^DB+Adj+Rel
zirvesindeki	zirve+Noun+A3sg+P3sg+Loc^DB+Adj+Rel
hafızalardaki	hafıza+Noun+A3pl+Pnon+Loc^DB+Adj+Rel
belediyelerdeki	belediye+Noun+A3pl+Pnon+Loc^DB+Adj+Rel
eşanlamlı	eşanlam+Noun+A3sg+Pnon+Nom^DB+Adj+With
mahkemelerdeki	mahkeme+Noun+A3pl+Pnon+Loc^DB+Adj+Rel
süretli	süret+Noun+A3sg+Pnon+Nom^DB+Adj+With
problemli	problem+Noun+A3sg+Pnon+Nom^DB+Adj+With
arenadaki	arena+Noun+A3sg+Pnon+Loc^DB+Adj+Rel
başkanlığındaki	başkanlık+Noun+A3sg+P3sg+Loc^DB+Adj+Rel
tansiyonlu	tansiyon+Noun+A3sg+Pnon+Nom^DB+Adj+With
albümdeki	albüm+Noun+A3sg+Pnon+Loc^DB+Adj+Rel
maaşlı	maaş+Noun+A3sg+Pnon+Nom^DB+Adj+With
enzimlerindeki	enzim+Noun+A3pl+P3sg+Loc^DB+Adj+Rel
moralsiz	moral+Noun+A3sg+Pnon+Nom^DB+Adj+Without
hükümetteki	hükümet+Noun+A3sg+Pnon+Loc^DB+Adj+Rel
gümrüklerdeki	gümrük+Noun+A3pl+Pnon+Loc^DB+Adj+Rel
televizyonlardaki	televizyon+Noun+A3pl+Pnon+Loc^DB+Adj+Rel
ömenli	ömen+Noun+A3sg+Pnon+Nom^DB+Adj+With
mitleştirildiği	mit+Noun+A3sg+Pnon+Nom^DB+Verb+Become^DB+Verb+Caus^DB+Verb+Pass+Pos^DB+Adj+PastPart+P3sg
farlı	far+Noun+A3sg+Pnon+Nom^DB+Adj+With
kesimli	kesim+Noun+A3sg+Pnon+Nom^DB+Adj+With
pileli	pile+Noun+A3sg+Pnon+Nom^DB+Adj+With
tesettürlü	tesettür+Noun+A3sg+Pnon+Nom^DB+Adj+With
dökümlü	döküm+Noun+A3sg+Pnon+Nom^DB+Adj+With
dekolteli	dekolte+Noun+A3sg+Pnon+Nom^DB+Adj+With
yünlü	yün+Noun+A3sg+Pnon+Nom^DB+Adj+With
abartılı	abartı+Noun+A3sg+Pnon+Nom^DB+Adj+With
fonksiyonlu	fonksiyon+Noun+A3sg+Pnon+Nom^DB+Adj+With
desenli	desen+Noun+A3sg+Pnon+Nom^DB+Adj+With
özündeki	öz+Noun+A3sg+P3sg+Loc^DB+Adj+Rel
gardıroplarımızdaki	gardırop+Noun+A3pl+P1pl+Loc^DB+Adj+Rel
yırtmaçlı	yırtmaç+Noun+A3sg+Pnon+Nom^DB+Adj+With
temalı	tema+Noun+A3sg+Pnon+Nom^DB+Adj+With
puantiyeli	puantiye+Noun+A3sg+Pnon+Nom^DB+Adj+With
korsajlı	korsaj+Noun+A3sg+Pnon+Nom^DB+Adj+With
motifli	motif+Noun+A3sg+Pnon+Nom^DB+Adj+With
mineli	mine+Noun+A3sg+Pnon+Nom^DB+Adj+With
temkinli	temkin+Noun+A3sg+Pnon+Nom^DB+Adj+With
mesleğindeki	meslek+Noun+A3sg+P3sg+Loc^DB+Adj+Rel
fotograftaki	fotoğraf+Noun+A3sg+Pnon+Loc^DB+Adj+Rel
panjurlu	panjur+Noun+A3sg+Pnon+Nom^DB+Adj+With
giyimli	giyim+Noun+A3sg+Pnon+Nom^DB+Adj+With
cephedeki	cephe+Noun+A3sg+Pnon+Loc^DB+Adj+Rel
fosforlu	fosfor+Noun+A3sg+Pnon+Nom^DB+Adj+With
rakımlı	rakım+Noun+A3sg+Pnon+Nom^DB+Adj+With
ampülü	ampü+Noun+A3sg+Pnon+Nom^DB+Adj+With
mevzideki	mevzi+Noun+A3sg+Pnon+Loc^DB+Adj+Rel
mangasındaki	manga+Noun+A3sg+P3sg+Loc^DB+Adj+Rel
mayınlı	mayın+Noun+A3sg+Pnon+Nom^DB+Adj+With
ağdalı	ağda+Noun+A3sg+Pnon+Nom^DB+Adj+With
makamındaki	makam+Noun+A3sg+P3sg+Loc^DB+Adj+Rel
beyazperdedeki	beyazperde+Noun+A3sg+Pnon+Loc^DB+Adj+Rel
flatolu	flato+Noun+A3sg+Pnon+Nom^DB+Adj+With
disiplinli	disiplin+Noun+A3sg+Pnon+Nom^DB+Adj+With
stüdyodaki	stüdyo+Noun+A3sg+Pnon+Loc^DB+Adj+Rel
korumasız	koruma+Noun+A3sg+Pnon+Nom^DB+Adj+Without
özverili	özveri+Noun+A3sg+Pnon+Nom^DB+Adj+With
kumlu	kum+Noun+A3sg+Pnon+Nom^DB+Adj+With
killi	kil+Noun+A3sg+Pnon+Nom^DB+Adj+With
internetteki	internet+Noun+A3sg+Pnon+Loc^DB+Adj+Rel
fermuarlı	fermuar+Noun+A3sg+Pnon+Nom^DB+Adj+With
fileli	file+Noun+A3sg+Pnon+Nom^DB+Adj+With
kumaşlı	kumaş+Noun+A3sg+Pnon+Nom^DB+Adj+With
termoslu	termos+Noun+A3sg+Pnon+Nom^DB+Adj+With
pilili	pili+Noun+A3sg+Pnon+Nom^DB+Adj+With
müzedeki	müze+Noun+A3sg+Pnon+Loc^DB+Adj+Rel
raylı	ray+Noun+A3sg+Pnon+Nom^DB+Adj+With
buharlı	buhar+Noun+A3sg+Pnon+Nom^DB+Adj+With
tesilli	tesil+Noun+A3sg+Pnon+Nom^DB+Adj+With
geleli	gele+Noun+A3sg+Pnon+Nom^DB+Adj+With
bakanlığındaki	bakanlık+Noun+A3sg+P3sg+Loc^DB+Adj+Rel
endeksli	endeks+Noun+A3sg+Pnon+Nom^DB+Adj+With
kefenli	kefen+Noun+A3sg+Pnon+Nom^DB+Adj+With
rahatladığınız	rahatla+Verb+Pos^DB+Adj+PastPart+P2pl
gözlemeye	gözle+Verb+Pos^DB+Noun+Inf2+A3sg+Pnon+Dat
düzeltmeliyiz	düzel+Verb^DB+Verb+Caus+Pos+Neces+A1pl
çıkmadıkları	çık+Verb+Neg^DB+Adj+PastPart+P3pl
görebildiğimiz	gör+Verb+Pos^DB+Verb+Able^DB+Adj+PastPart+P1pl
indiğim	in+Verb+Pos^DB+Adj+PastPart+P1sg
gerileyeceği	gerile+Verb+Pos^DB+Adj+FutPart+P3sg
düştüğümüz	düş+Verb+Pos^DB+Adj+PastPart+P1pl
imiş	i+Verb+Pos+Narr+A3sg
ödediğim	öde+Verb+Pos^DB+Adj+PastPart+P1sg
bulunduran	bulun+Verb^DB+Verb+Caus+Pos^DB+Adj+PresPart
olamadıkları	ol+Verb^DB+Verb+Able+Neg^DB+Adj+PastPart+P3pl
etmediğiniz	et+Verb+Neg^DB+Adj+PastPart+P2pl
verdiğimiz	ver+Verb+Pos^DB+Adj+PastPart+P1pl
belirtildiği	belir+Verb^DB+Verb+Caus^DB+Verb+Pass+Pos^DB+Adj+PastPart+P3sg
bildigi	bil+Verb+Pos^DB+Adj+PastPart+P3sg
yaptıramadığı	yap+Verb^DB+Verb+Caus^DB+Verb+Able+Neg^DB+Adj+PastPart+P3sg
söyleyemediği	söyle+Verb^DB+Verb+Able+Neg^DB+Adj+PastPart+P3sg
seçtiği	seç+Verb+Pos^DB+Adj+PastPart+P3sg
koyabildiğiniz	koy+Verb+Pos^DB+Verb+Able^DB+Adj+PastPart+P2pl
çektirdiğim	çek+Verb^DB+Verb+Caus+Pos^DB+Adj+PastPart+P1sg
istenildiği	iste+Verb^DB+Verb+Pass+Pos^DB+Adj+PastPart+P3sg
gelindiği	gel+Verb^DB+Verb+Pass+Pos^DB+Adj+PastPart+P3sg
yumuşamıştım	yumuşa+Verb+Pos+Narr+Past+A1sg
biliyoruz	bile+Verb+Pos+Prog1+A1pl
gittiğimiz	git+Verb+Pos^DB+Adj+PastPart+P1pl
attıkları	at+Verb+Pos^DB+Adj+PastPart+P3pl
imzalandığı	imzala+Verb^DB+Verb+Pass+Pos^DB+Adj+PastPart+P3sg
benzeyecek	benze+Verb+Pos^DB+Adj+FutPart+Pnon
tartışıldığı	tartış+Verb^DB+Verb+Pass+Pos^DB+Adj+PastPart+P3sg
sanılan	san+Verb^DB+Verb+Pass+Pos^DB+Adj+PresPart
sevdikleri	sev+Verb+Pos^DB+Adj+PastPart+P3pl
bağıran	bağır+Verb+Pos^DB+Adj+PresPart
çekinen	çekin+Verb+Pos^DB+Adj+PresPart
binen	bin+Verb+Pos^DB+Adj+PresPart
geçebilecek	geç+Verb+Pos^DB+Verb+Able^DB+Adj+FutPart+Pnon
gerektirecek	gerek+Verb^DB+Verb+Caus+Pos^DB+Adj+FutPart+Pnon
yarattığım	yara+Verb^DB+Verb+Caus+Pos^DB+Adj+PastPart+P1sg
tiksiniyordu	tiksin+Verb+Pos+Prog1+Past+A3sg
ayırmadığım	ayır+Verb+Neg^DB+Adj+PastPart+P1sg
varan	var+Verb+Pos^DB+Adj+PresPart
dolanan	dola+Verb^DB+Verb+Pass+Pos^DB+Adj+PresPart
okşanan	okşa+Verb^DB+Verb+Pass+Pos^DB+Adj+PresPart
beklediğimiz	bekle+Verb+Pos^DB+Adj+PastPart+P1pl
oturulacak	otur+Verb^DB+Verb+Pass+Pos^DB+Adj+FutPart+Pnon
dolaştırdığım	dolaş+Verb^DB+Verb+Caus+Pos^DB+Adj+PastPart+P1sg
işittiği	işit+Verb+Pos^DB+Adj+PastPart+P3sg
ittiği	it+Verb+Pos^DB+Adj+PastPart+P3sg
aldıran	al+Verb^DB+Verb+Caus+Pos^DB+Adj+PresPart
düşünmediği	düşün+Verb+Neg^DB+Adj+PastPart+P3sg
izleyeceği	izle+Verb+Pos^DB+Adj+FutPart+P3sg
dökülürkenki	dök+Verb^DB+Verb+Pass+Pos+Aor^DB+Adverb+While^DB+Adj+Rel
durduran	dur+Verb^DB+Verb+Caus+Pos^DB+Adj+PresPart
baktıkları	bak+Verb+Pos^DB+Adj+PastPart+P3pl
ıslanan	ısla+Verb^DB+Verb+Pass+Pos^DB+Adj+PresPart
döndürülen	dön+Verb^DB+Verb+Caus^DB+Verb+Pass+Pos^DB+Adj+PresPart
dediğiniz	de+Verb+Pos^DB+Adj+PastPart+P2pl
dolandırılmış	dolan+Verb^DB+Verb+Caus^DB+Verb+Pass+Pos+Narr+A3sg
soluya	solu+Verb+Pos+Opt+A3sg
çatıyordu	çat+Verb+Pos+Prog1+Past+A3sg
duymayan	duy+Verb+Neg^DB+Adj+PresPart
hatırlattığımız	hatırla+Verb^DB+Verb+Caus+Pos^DB+Adj+PastPart+P1pl
acıyan	acı+Verb+Pos^DB+Adj+PresPart
adayan	ada+Verb+Pos^DB+Adj+PresPart
sallamakla	salla+Verb+Pos^DB+Noun+Inf1+A3sg+Pnon+Ins
yaşadığımız	yaşa+Verb+Pos^DB+Adj+PastPart+P1pl
haykırmak	haykır+Verb+Pos^DB+Noun+Inf1+A3sg+Pnon+Nom
dolduran	dol+Verb^DB+Verb+Caus+Pos^DB+Adj+PresPart
silinen	sil+Verb^DB+Verb+Pass+Pos^DB+Adj+PresPart
fısıldanan	fısılda+Verb^DB+Verb+Pass+Pos^DB+Adj+PresPart
öpüşür	öp+Verb^DB+Verb+Recip+Pos^DB+Adj+AorPart
kalıveren	kal+Verb+Pos^DB+Verb+Hastily^DB+Adj+PresPart
bulunabilen	bul+Verb^DB+Verb+Pass+Pos^DB+Verb+Able^DB+Adj+PresPart
öldürüldüğü	öl+Verb^DB+Verb+Caus^DB+Verb+Pass+Pos^DB+Adj+PastPart+P3sg
göstereceğimiz	göster+Verb+Pos^DB+Adj+FutPart+P1pl
kestiremeyen	kes+Verb^DB+Verb+Caus^DB+Verb+Able+Neg^DB+Adj+PresPart
koşuldukları	koş+Verb^DB+Verb+Pass+Pos^DB+Adj+PastPart+P3pl
kaybolan	kaybol+Verb+Pos^DB+Adj+PresPart
yıprandı	yıpran+Verb+Pos+Past+A3sg
açıkladığı	açıkla+Verb+Pos^DB+Adj+PastPart+P3sg
hissettiren	hisset+Verb^DB+Verb+Caus+Pos^DB+Adj+PresPart
hazırladığımız	hazırla+Verb+Pos^DB+Adj+PastPart+P1pl
eğmeleri	eğ+Verb+Pos^DB+Noun+Inf2+A3pl+P3pl+Nom
değiliz	değil+Verb+Neg+Pres+A1pl
ilgilenen	ilgilen+Verb+Pos^DB+Adj+PresPart
nişanlandığından	nişanla+Verb^DB+Verb+Pass+Pos^DB+Noun+PastPart+A3sg+P3sg+Abl
silkindi	silkin+Verb+Pos+Past+A3sg
inanmadığım	inan+Verb+Neg^DB+Adj+PastPart+P1sg
kaybeden	kaybet+Verb+Pos^DB+Adj+PresPart
sakladığı	sakla+Verb+Pos^DB+Adj+PastPart+P3sg
evlendiği	evlen+Verb+Pos^DB+Adj+PastPart+P3sg
geliştiren	geliş+Verb^DB+Verb+Caus+Pos^DB+Adj+PresPart
unutturan	unut+Verb^DB+Verb+Caus+Pos^DB+Adj+PresPart
üzen	üz+Verb+Pos^DB+Adj+PresPart
onaylatmadığı	onayla+Verb^DB+Verb+Caus+Neg^DB+Adj+PastPart+P3sg
sorduğumuz	sor+Verb+Pos^DB+Adj+PastPart+P1pl
karışan	karış+Verb+Pos^DB+Adj+PresPart
büyüleyen	büyüle+Verb+Pos^DB+Adj+PresPart
vurduğum	vur+Verb+Pos^DB+Adj+PastPart+P1sg
kılan	kıl+Verb+Pos^DB+Adj+PresPart
yitirdiği	yit+Verb^DB+Verb+Caus+Pos^DB+Adj+PastPart+P3sg
getirdikleri	getir+Verb+Pos^DB+Adj+PastPart+P3pl
ekledikleri	ekle+Verb+Pos^DB+Adj+PastPart+P3pl
kastettiği	kastet+Verb+Pos^DB+Adj+PastPart+P3sg
gülen	gül+Verb+Pos^DB+Adj+PresPart
korkan	kork+Verb+Pos^DB+Adj+PresPart
zanneden	zannet+Verb+Pos^DB+Adj+PresPart
sağlanamadığı	sağla+Verb^DB+Verb+Pass^DB+Verb+Able+Neg^DB+Adj+PastPart+P3sg
övmenize	öv+Verb+Pos^DB+Noun+Inf2+A3sg+P2pl+Dat
buluyor	bula+Verb+Pos+Prog1+A3sg
çürümeye	çürü+Verb+Pos^DB+Noun+Inf2+A3sg+Pnon+Dat
taşıdığı	taşı+Verb+Pos^DB+Adj+PastPart+P3sg
kutluyordu	kutla+Verb+Pos+Prog1+Past+A3sg
görünüşlü	görün+Verb+Pos^DB+Noun+Inf3+A3sg+Pnon+Nom^DB+Adj+With
affettireceğini	affet+Verb^DB+Verb+Caus+Pos^DB+Noun+FutPart+A3sg+P3sg+Acc
anlamayan	anla+Verb+Neg^DB+Adj+PresPart
giyindiğim	giy+Verb^DB+Verb+Reflex+Pos^DB+Adj+PastPart+P1sg
yemekli	ye+Verb+Pos^DB+Noun+Inf1+A3sg+Pnon+Nom^DB+Adj+With
oynamayan	oyna+Verb+Neg^DB+Adj+PresPart
süslemek	süsle+Verb+Pos^DB+Noun+Inf1+A3sg+Pnon+Nom
taşan	taş+Verb+Pos^DB+Adj+PresPart
topladığı	topla+Verb+Pos^DB+Adj+PastPart+P3sg
doğuran	doğ+Verb^DB+Verb+Caus+Pos^DB+Adj+PresPart
ilerleyen	ilerle+Verb+Pos^DB+Adj+PresPart
konuşabilen	konuş+Verb+Pos^DB+Verb+Able^DB+Adj+PresPart
peydahlandı	peydahla+Verb^DB+Verb+Pass+Pos+Past+A3sg
yaklaştığı	yaklaş+Verb+Pos^DB+Adj+PastPart+P3sg
titreyen	titre+Verb+Pos^DB+Adj+PresPart
ürperten	ürper+Verb^DB+Verb+Caus+Pos^DB+Adj+PresPart
kurtaran	kurtar+Verb+Pos^DB+Adj+PresPart
sarılan	sar+Verb^DB+Verb+Pass+Pos^DB+Adj+PresPart
bıraktığınız	bırak+Verb+Pos^DB+Adj+PastPart+P2pl
yudumladığını	yudumla+Verb+Pos^DB+Noun+PastPart+A3sg+P3sg+Acc
mırıldanıyordum	mırıldan+Verb+Pos+Prog1+Past+A1sg
feshedilemez	feshet+Verb^DB+Verb+Pass^DB+Verb+Able+Neg+Aor+A3sg
değiştikleri	değiş+Verb+Pos^DB+Adj+PastPart+P3pl
zorlanan	zorla+Verb^DB+Verb+Pass+Pos^DB+Adj+PresPart
yükledikleri	yükle+Verb+Pos^DB+Adj+PastPart+P3pl
yetmeyen	yet+Verb+Neg^DB+Adj+PresPart
silkti	silk+Verb+Pos+Past+A3sg
kullanmadığımız	kullan+Verb+Neg^DB+Adj+PastPart+P1pl
davrandığı	davran+Verb+Pos^DB+Adj+PastPart+P3sg
ederler	ederle+Verb+Pos+Aor+A3sg
hoşlanacağım	hoşlan+Verb+Pos^DB+Adj+FutPart+P1sg
boşver	boşver+Verb+Pos+Imp+A2sg
bayılan	bayıl+Verb+Pos^DB+Adj+PresPart
dayanmak	daya+Verb^DB+Verb+Pass+Pos^DB+Noun+Inf1+A3sg+Pnon+Nom
kapladığı	kapla+Verb+Pos^DB+Adj+PastPart+P3sg
giremediği	gir+Verb^DB+Verb+Able+Neg^DB+Adj+PastPart+P3sg
götürüldüğü	götür+Verb^DB+Verb+Pass+Pos^DB+Adj+PastPart+P3sg
karşılaştıkları	karşılaş+Verb+Pos^DB+Adj+PastPart+P3pl
oyalayan	oyala+Verb+Pos^DB+Adj+PresPart
asmalı	as+Verb+Pos^DB+Noun+Inf2+A3sg+Pnon+Nom^DB+Adj+With
paylaştırıldığı	paylaş+Verb^DB+Verb+Caus^DB+Verb+Pass+Pos^DB+Adj+PastPart+P3sg
dilediği	dile+Verb+Pos^DB+Adj+PastPart+P3sg
öğretmeyen	öğret+Verb+Neg^DB+Adj+PresPart
yaratabilmiş	yarat+Verb+Pos^DB+Verb+Able^DB+Adj+NarrPart
mahvediyordu	mahvet+Verb+Pos+Prog1+Past+A3sg
sürdürülen	sür+Verb^DB+Verb+Caus^DB+Verb+Pass+Pos^DB+Adj+PresPart
kalktığı	kalk+Verb+Pos^DB+Adj+PastPart+P3sg
başlanan	başla+Verb^DB+Verb+Pass+Pos^DB+Adj+PresPart
saldıran	sal+Verb^DB+Verb+Caus+Pos^DB+Adj+PresPart
uğradığım	uğra+Verb+Pos^DB+Adj+PastPart+P1sg
vurgulayan	vurgula+Verb+Pos^DB+Adj+PresPart
yaraşır	yaraş+Verb+Pos+Aor+A3sg
okutamayan	oku+Verb^DB+Verb+Caus^DB+Verb+Able+Neg^DB+Adj+PresPart
saçtığı	saç+Verb+Pos^DB+Adj+PastPart+P3sg
yazdıkları	yaz+Verb+Pos^DB+Adj+PastPart+P3pl
dağılacağıydı	dağıl+Verb+Pos^DB+Noun+FutPart+A3sg+P3sg+Nom^DB+Verb+Zero+Past+A3sg
kapılan	kap+Verb^DB+Verb+Pass+Pos^DB+Adj+PresPart
saydığımız	say+Verb+Pos^DB+Adj+PastPart+P1pl
çizen	çiz+Verb+Pos^DB+Adj+PresPart
kemiriyordu	kemir+Verb+Pos+Prog1+Past+A3sg
denediğim	dene+Verb+Pos^DB+Adj+PastPart+P1sg
yanıltıcı	yanıl+Verb^DB+Verb+Caus+Pos^DB+Adj+Agt
karardığı	karar+Verb+Pos^DB+Adj+PastPart+P3sg
tanıdığımız	tanı+Verb+Pos^DB+Adj+PastPart+P1pl
öğrenen	öğren+Verb+Pos^DB+Adj+PresPart
yaydığı	yay+Verb+Pos^DB+Adj+PastPart+P3sg
çakışmasıydı	çakış+Verb+Pos^DB+Noun+Inf2+A3sg+P3sg+Nom^DB+Verb+Zero+Past+A3sg
dayanan	dayan+Verb+Pos^DB+Adj+PresPart
içtiğim	iç+Verb+Pos^DB+Adj+PastPart+P1sg
bastığı	bas+Verb+Pos^DB+Adj+PastPart+P3sg
beğendikleri	beğen+Verb+Pos^DB+Adj+PastPart+P3pl
biçici	biç+Verb+Pos^DB+Noun+Agt+A3sg+Pnon+Nom
uyanan	uyan+Verb+Pos^DB+Adj+PresPart
tuttukları	tut+Verb+Pos^DB+Adj+PastPart+P3pl
güvenen	güven+Verb+Pos^DB+Adj+PresPart
dalan	dal+Verb+Pos^DB+Adj+PresPart
batıran	bat+Verb^DB+Verb+Caus+Pos^DB+Adj+PresPart
uyaran	uyar+Verb+Pos^DB+Adj+PresPart
yuvarlanan	yuvarla+Verb^DB+Verb+Pass+Pos^DB+Adj+PresPart
cıvıttı	cıvı+Verb^DB+Verb+Caus+Pos+Past+A3sg
çalışmayan	çalış+Verb+Neg^DB+Adj+PresPart
somurtuyorlardı	somur+Verb^DB+Verb+Caus+Pos+Prog1+A3pl+Past
bürünen	bürü+Verb^DB+Verb+Pass+Pos^DB+Adj+PresPart
umursanmayan	umursa+Verb^DB+Verb+Pass+Neg^DB+Adj+PresPart
bitirdiğim	bit+Verb^DB+Verb+Caus+Pos^DB+Adj+PastPart+P1sg
anlattığın	anlat+Verb+Pos^DB+Adj+PastPart+P2sg
içerecek	içer+Verb+Pos^DB+Adj+FutPart+Pnon
gizleyeceği	gizle+Verb+Pos^DB+Adj+FutPart+P3sg
bakındım	bakın+Verb+Pos+Past+A1sg
bahsettiğimiz	bahset+Verb+Pos^DB+Adj+PastPart+P1pl
giderdiği	gider+Verb+Pos^DB+Adj+PastPart+P3sg
tıkandığı	tıka+Verb^DB+Verb+Pass+Pos^DB+Adj+PastPart+P3sg
dikişsiz	dik+Verb+Pos^DB+Noun+Inf3+A3sg+Pnon+Nom^DB+Adj+Without
dinlediğimiz	dinle+Verb+Pos^DB+Adj+PastPart+P1pl
yürüten	yürü+Verb^DB+Verb+Caus+Pos^DB+Adj+PresPart
uğraştığım	uğraş+Verb+Pos^DB+Adj+PastPart+P1sg
püslenecektim	püsle+Verb^DB+Verb+Reflex+Pos+Fut+Past+A1sg
yapıştıkları	yapış+Verb+Pos^DB+Adj+PastPart+P3pl
çarptırılan	çarp+Verb^DB+Verb+Caus^DB+Verb+Pass+Pos^DB+Adj+PresPart
atadığı	ata+Verb+Pos^DB+Adj+PastPart+P3sg
eğlenen	eğlen+Verb+Pos^DB+Adj+PresPart
kopan	kop+Verb+Pos^DB+Adj+PresPart
gevşemiş	gevşe+Verb+Pos+Narr+A3sg
sustu	sus+Verb+Pos+Past+A3sg
seziş	sez+Verb+Pos^DB+Noun+Inf3+A3sg+Pnon+Nom
kaldıracak	kaldır+Verb+Pos^DB+Adj+FutPart+Pnon
yormaya	yor+Verb+Pos^DB+Noun+Inf2+A3sg+Pnon+Dat
süzülen	süz+Verb^DB+Verb+Pass+Pos^DB+Adj+PresPart
yıkanabilen	yıka+Verb^DB+Verb+Pass+Pos^DB+Verb+Able^DB+Adj+PresPart
eriyen	eri+Verb+Pos^DB+Adj+PresPart
çaldığın	çal+Verb+Pos^DB+Adj+PastPart+P2sg
geçinen	geçin+Verb+Pos^DB+Adj+PresPart
tanıştığı	tanış+Verb+Pos^DB+Adj+PastPart+P3sg
işlenen	işle+Verb^DB+Verb+Pass+Pos^DB+Adj+PresPart
coşmuştu	coş+Verb+Pos+Narr+Past+A3sg
diriltin	diril+Verb^DB+Verb+Caus+Pos+Imp+A2pl
seslenen	seslen+Verb+Pos^DB+Adj+PresPart
geveliyordu	gevele+Verb+Pos+Prog1+Past+A3sg
reddeden	reddet+Verb+Pos^DB+Adj+PresPart
kazanmadığı	kazan+Verb+Neg^DB+Adj+PastPart+P3sg
ihtiyarlar	ihtiyarla+Verb+Pos+Aor+A3sg
gezdikleri	gez+Verb+Pos^DB+Adj+PastPart+P3pl
tekrarladığı	tekrarla+Verb+Pos^DB+Adj+PastPart+P3sg
yalvaran	yalvar+Verb+Pos^DB+Adj+PresPart
çöktüğü	çök+Verb+Pos^DB+Adj+PastPart+P3sg
anlaşılmayan	anlaş+Verb^DB+Verb+Pass+Neg^DB+Adj+PresPart
körükleyin	körükle+Verb+Pos+Imp+A2pl
kucaklamasından	kucakla+Verb+Pos^DB+Noun+Inf2+A3sg+P3sg+Abl
seyreden	seyret+Verb+Pos^DB+Adj+PresPart
çevirdiği	çevir+Verb+Pos^DB+Adj+PastPart+P3sg
uzayan	uza+Verb+Pos^DB+Adj+PresPart
kekeledi	kekele+Verb+Pos+Past+A3sg
korumayan	koru+Verb+Neg^DB+Adj+PresPart
parlayan	parla+Verb+Pos^DB+Adj+PresPart
serdiğim	ser+Verb+Pos^DB+Adj+PastPart+P1sg
kalkışan	kalkış+Verb+Pos^DB+Adj+PresPart
sokamadıkları	sok+Verb^DB+Verb+Able+Neg^DB+Adj+PastPart+P3pl
kapanan	kapa+Verb^DB+Verb+Pass+Pos^DB+Adj+PresPart
tüketecek	tüket+Verb+Pos+Fut+A3sg
yatırırlar	yatır+Verb+Pos+Aor+A3pl
kapaklanıyordu	kapaklan+Verb+Pos+Prog1+Past+A3sg
sıkan	sık+Verb+Pos^DB+Adj+PresPart
kenetlenmiş	kenetle+Verb^DB+Verb+Pass+Pos+Narr+A3sg
yaşarmıştı	yaşar+Verb+Pos+Narr+Past+A3sg
açıldığı	aç+Verb^DB+Verb+Pass+Pos^DB+Adj+PastPart+P3sg
ezilen	ez+Verb^DB+Verb+Pass+Pos^DB+Adj+PresPart
suçladığı	suçla+Verb+Pos^DB+Adj+PastPart+P3sg
buruşturmuştu	buruş+Verb^DB+Verb+Caus+Pos+Narr+Past+A3sg
köpürdü	köpür+Verb+Pos+Past+A3sg
sarsılan	sars+Verb^DB+Verb+Pass+Pos^DB+Adj+PresPart
kavrar	kavra+Verb+Pos^DB+Adj+AorPart
vuruldunuz	vurul+Verb+Pos+Past+A2pl
şaşılacak	şaş+Verb^DB+Verb+Pass+Pos^DB+Adj+FutPart+Pnon
iliştirilen	iliş+Verb^DB+Verb+Caus^DB+Verb+Pass+Pos^DB+Adj+PresPart
fırlatan	fırla+Verb^DB+Verb+Caus+Pos^DB+Adj+PresPart
kınayın	kına+Verb+Pos+Imp+A2pl
inceleyen	incele+Verb+Pos^DB+Adj+PresPart
çatırdatacak	çatırda+Verb^DB+Verb+Caus+Pos+Fut+A3sg
küçümseyen	küçümse+Verb+Pos^DB+Adj+PresPart
büksün	bük+Verb+Pos+Imp+A3sg
kötülemek	kötüle+Verb+Pos^DB+Noun+Inf1+A3sg+Pnon+Nom
başvurduğu	başvur+Verb+Pos^DB+Adj+PastPart+P3sg
ağladığı	ağla+Verb+Pos^DB+Adj+PastPart+P3sg
kazıyorsunuz	kaz+Verb+Pos+Prog1+A2pl
konduğu	kon+Verb+Pos^DB+Adj+PastPart+P3sg
homurdanır	homurda+Verb^DB+Verb+Pass+Pos+Aor+A3sg
hesaplayan	hesapla+Verb+Pos^DB+Adj+PresPart
girişilen	giriş+Verb^DB+Verb+Pass+Pos^DB+Adj+PresPart
şakıyorsunuz	şakı+Verb+Pos+Prog1+A2pl
şaşırtır	şaşır+Verb^DB+Verb+Caus+Pos^DB+Adj+AorPart
gücenebileceğim	gücen+Verb+Pos^DB+Verb+Able+Fut+A1sg
karşılayamadığınız	karşıla+Verb^DB+Verb+Able+Neg^DB+Adj+PastPart+P2pl
bağışlandığı	bağışla+Verb^DB+Verb+Pass+Pos^DB+Adj+PastPart+P3sg
yaslayan	yasla+Verb+Pos^DB+Adj+PresPart
kıpırdamadan	kıpırda+Verb+Pos^DB+Noun+Inf2+A3sg+Pnon+Abl
kollayan	kolla+Verb+Pos^DB+Adj+PresPart
ulaşabildiğim	ulaş+Verb+Pos^DB+Verb+Able^DB+Adj+PastPart+P1sg
inleten	inle+Verb^DB+Verb+Caus+Pos^DB+Adj+PresPart
kavuşan	kavuş+Verb+Pos^DB+Adj+PresPart
savmıştı	sav+Verb+Pos+Narr+Past+A3sg
kaçtığım	kaç+Verb+Pos^DB+Adj+PastPart+P1sg
bulandıran	bulan+Verb^DB+Verb+Caus+Pos^DB+Adj+PresPart
tartmaya	tart+Verb+Pos^DB+Noun+Inf2+A3sg+Pnon+Dat
mahvolan	mahvol+Verb+Pos^DB+Adj+PresPart
vazgeçemeyen	vazgeç+Verb^DB+Verb+Able+Neg^DB+Adj+PresPart
ısmarlamıştı	ısmarla+Verb+Pos+Narr+Past+A3sg
yığılıverdi	yığ+Verb^DB+Verb+Pass+Pos^DB+Verb+Hastily+Past+A3sg
hıçkıra	hıçkır+Verb+Pos+Opt+A3sg
bozulan	boz+Verb^DB+Verb+Pass+Pos^DB+Adj+PresPart
kıyılan	kıy+Verb^DB+Verb+Pass+Pos^DB+Adj+PresPart
sıkıştırılmamış	sıkış+Verb^DB+Verb+Caus^DB+Verb+Pass+Neg^DB+Adj+NarrPart
kurulandı	kurula+Verb^DB+Verb+Pass+Pos+Past+A3sg
emredersiniz	emret+Verb+Pos+Aor+A2pl
kıvırtması	kıvır+Verb^DB+Verb+Caus+Pos^DB+Noun+Inf2+A3sg+P3sg+Nom
yakışan	yakış+Verb+Pos^DB+Adj+PresPart
kokan	kok+Verb+Pos^DB+Adj+PresPart
estiği	es+Verb+Pos^DB+Adj+PastPart+P3sg
yükselten	yüksel+Verb^DB+Verb+Caus+Pos^DB+Adj+PresPart
sersemlemiş	sersemle+Verb+Pos+Narr+A3sg
bağlayan	bağla+Verb+Pos^DB+Adj+PresPart
dokunmadığı	dokun+Verb+Neg^DB+Adj+PastPart+P3sg
yakalayan	yakala+Verb+Pos^DB+Adj+PresPart
alıştığımız	alış+Verb+Pos^DB+Adj+PastPart+P1pl
yatan	yat+Verb+Pos^DB+Adj+PresPart
takmalı	tak+Verb+Pos^DB+Noun+Inf2+A3sg+Pnon+Nom^DB+Adj+With
oluştukları	oluş+Verb+Pos^DB+Adj+PastPart+P3pl
doyurucu	doy+Verb^DB+Verb+Caus+Pos^DB+Adj+Agt
harcattığı	harca+Verb^DB+Verb+Caus+Pos^DB+Adj+PastPart+P3sg
abandığı	aban+Verb+Pos^DB+Adj+PastPart+P3sg
kudurmuş	kudur+Verb+Pos^DB+Adj+NarrPart
kovalayan	kovala+Verb+Pos^DB+Adj+PresPart
gerdiği	ger+Verb+Pos^DB+Adj+PastPart+P3sg
takırdadı	takırda+Verb+Pos+Past+A3sg
yetişen	yetiş+Verb+Pos^DB+Adj+PresPart
dürülmüş	dür+Verb^DB+Verb+Pass+Pos+Narr+A3sg
incinen	incin+Verb+Pos^DB+Adj+PresPart
dokumalı	doku+Verb+Pos^DB+Noun+Inf2+A3sg+Pnon+Nom^DB+Adj+With
yatıştırana	yatış+Verb^DB+Verb+Caus+Pos^DB+Adj+PresPart^DB+Noun+Zero+A3sg+Pnon+Dat
yöneltilen	yönel+Verb^DB+Verb+Caus^DB+Verb+Pass+Pos^DB+Adj+PresPart
kabartıyordu	kabar+Verb^DB+Verb+Caus+Pos+Prog1+Past+A3sg
parçaladığı	parçala+Verb+Pos^DB+Adj+PastPart+P3sg
kaynaklanacak	kaynakla+Verb^DB+Verb+Pass+Pos^DB+Adj+FutPart+Pnon
yetinen	yetin+Verb+Pos^DB+Adj+PresPart
yumacak	yum+Verb+Pos^DB+Adj+FutPart+Pnon
yerleştikleri	yerleş+Verb+Pos^DB+Adj+PastPart+P3pl
dürttü	dürt+Verb+Pos+Past+A3sg
kışkırtıyordu	kışkırt+Verb+Pos+Prog1+Past+A3sg
savuşuyordu	savuş+Verb+Pos+Prog1+Past+A3sg
edinmeyen	edin+Verb+Neg^DB+Adj+PresPart
engellendiği	engelle+Verb^DB+Verb+Pass+Pos^DB+Adj+PastPart+P3sg
beslenen	besle+Verb^DB+Verb+Pass+Pos^DB+Adj+PresPart
sırnaşmıyordu	sırnaş+Verb+Neg+Prog1+Past+A3sg
katlandığınız	katla+Verb^DB+Verb+Pass+Pos^DB+Adj+PastPart+P2pl
esirgeyen	esirge+Verb+Pos^DB+Adj+PresPart
sataşmamayı	sataş+Verb+Neg^DB+Noun+Inf2+A3sg+Pnon+Acc
ören	ör+Verb+Pos^DB+Adj+PresPart
çiğnenen	çiğne+Verb^DB+Verb+Pass+Pos^DB+Adj+PresPart
perçinleniyordu	perçinle+Verb^DB+Verb+Pass+Pos+Prog1+Past+A3sg
yaralandığı	yarala+Verb^DB+Verb+Pass+Pos^DB+Adj+PastPart+P3sg
düzenleyen	düzenle+Verb+Pos^DB+Adj+PresPart
gezinen	gezin+Verb+Pos^DB+Adj+PresPart
atlayan	atla+Verb+Pos^DB+Adj+PresPart
tamamlayan	tamamla+Verb+Pos^DB+Adj+PresPart
yağladım	yağla+Verb+Pos+Past+A1sg
gözetlemiş	gözetle+Verb+Pos+Narr+A3sg
tırmandığı	tırman+Verb+Pos^DB+Adj+PastPart+P3sg
beceremiyordu	becer+Verb^DB+Verb+Able+Neg+Prog1+Past+A3sg
ısırmaktaydı	ısır+Verb+Pos^DB+Noun+Inf1+A3sg+Pnon+Loc^DB+Verb+Zero+Past+A3sg
azarlayan	azarla+Verb+Pos^DB+Adj+PresPart
pataklıyordu	patakla+Verb+Pos+Prog1+Past+A3sg
dilenciler	dil+Verb+Pos^DB+Adj+PresPart^DB+Noun+Agt+A3pl+Pnon+Nom
ürktüğünüz	ürk+Verb+Pos^DB+Adj+PastPart+P2pl
rastladığınız	rastla+Verb+Pos^DB+Adj+PastPart+P2pl
kazımışımdır	kazı+Verb+Pos+Narr+A1sg+Cop
onaracağım	onar+Verb+Pos+Fut+A1sg
böbürlenir	böbürlen+Verb+Pos+Aor+A3sg
boyamalı	boya+Verb+Pos^DB+Noun+Inf2+A3sg+Pnon+Nom^DB+Adj+With
oynatan	oynat+Verb+Pos^DB+Adj+PresPart
taşınan	taşın+Verb+Pos^DB+Adj+PresPart
bur	bur+Verb+Pos+Imp+A2sg
kahroluyorum	kahrol+Verb+Pos+Prog1+A1sg
hafiflemiştim	hafifle+Verb+Pos+Narr+Past+A1sg
selamlayacaklarmış	selamla+Verb+Pos^DB+Noun+FutPart+A3pl+Pnon+Nom^DB+Verb+Zero+Narr+A3sg
tütmekte	tüt+Verb+Pos^DB+Noun+Inf1+A3sg+Pnon+Loc
boğucu	boğ+Verb+Pos^DB+Noun+Agt+A3sg+Pnon+Nom
alçaltmıştı	alçal+Verb^DB+Verb+Caus+Pos+Narr+Past+A3sg
dönüştüğü	dönüş+Verb+Pos^DB+Adj+PastPart+P3sg
burkuldu	burk+Verb^DB+Verb+Pass+Pos+Past+A3sg
gömüldükleri	göm+Verb^DB+Verb+Pass+Pos^DB+Adj+PastPart+P3pl
çekiştirilirdi	çekiş+Verb^DB+Verb+Caus^DB+Verb+Pass+Pos+Aor+Past+A3sg
doğrulmak	doğrul+Verb+Pos^DB+Noun+Inf1+A3sg+Pnon+Nom
sürünen	sürü+Verb^DB+Verb+Pass+Pos^DB+Adj+PresPart
gözüken	gözük+Verb+Pos^DB+Adj+PresPart
şükretsin	şükret+Verb+Pos+Imp+A3sg
yeltenmemesi	yelten+Verb+Neg^DB+Noun+Inf2+A3sg+P3sg+Nom
yeğledi	yeğle+Verb+Pos+Past+A3sg
boşanan	boşa+Verb^DB+Verb+Pass+Pos^DB+Adj+PresPart
artıracak	art+Verb^DB+Verb+Caus+Pos^DB+Adj+FutPart+Pnon
kovulmuş	kov+Verb^DB+Verb+Pass+Pos^DB+Adj+NarrPart
darılmadığımı	darıl+Verb+Neg^DB+Noun+PastPart+A3sg+P1sg+Acc
başaran	başar+Verb+Pos^DB+Adj+PresPart
yakan	yak+Verb+Pos^DB+Adj+PresPart
sağol	sağol+Verb+Pos+Imp+A2sg
kırdığı	kır+Verb+Pos^DB+Adj+PastPart+P3sg
sevinen	sevin+Verb+Pos^DB+Adj+PresPart
görüşen	görüş+Verb+Pos^DB+Adj+PresPart
yüzdüğü	yüz+Verb+Pos^DB+Adj+PastPart+P3sg
düşlemekle	düşle+Verb+Pos^DB+Noun+Inf1+A3sg+Pnon+Ins
paralıyordu	parala+Verb+Pos+Prog1+Past+A3sg
çağıran	çağır+Verb+Pos^DB+Adj+PresPart
uydukları	uy+Verb+Pos^DB+Adj+PastPart+P3pl
benimsediğiniz	benimse+Verb+Pos^DB+Adj+PastPart+P2pl
yadırganıyordu	yadırga+Verb^DB+Verb+Pass+Pos+Prog1+Past+A3sg
gülümseyen	gülümse+Verb+Pos^DB+Adj+PresPart
yıktığı	yık+Verb+Pos^DB+Adj+PastPart+P3sg
satabileceği	sat+Verb+Pos^DB+Verb+Able^DB+Adj+FutPart+P3sg
boşalan	boşal+Verb+Pos^DB+Adj+PresPart
serperdi	serp+Verb+Pos+Aor+Past+A3sg
iliklemeyen	ilikle+Verb+Neg^DB+Adj+PresPart
yırtan	yırt+Verb+Pos^DB+Adj+PresPart
sendeleye	sendele+Verb+Pos+Opt+A3sg
uyutan	uyu+Verb^DB+Verb+Caus+Pos^DB+Adj+PresPart
utandığı	utan+Verb+Pos^DB+Noun+PastPart+A3sg+P3sg+Nom
büzülmüştü	büz+Verb^DB+Verb+Pass+Pos+Narr+Past+A3sg
boylayan	boyla+Verb+Pos^DB+Adj+PresPart
tıka	tık+Verb+Pos+Opt+A3sg
kaydıkları	kay+Verb+Pos^DB+Adj+PastPart+P3pl
kırpıştırıyordu	kırpış+Verb^DB+Verb+Caus+Pos+Prog1+Past+A3sg
bunaltacak	bunal+Verb^DB+Verb+Caus+Pos^DB+Adj+FutPart+Pnon
bıkmış	bık+Verb+Pos+Narr+A3sg
usanmış	usan+Verb+Pos+Narr+A3sg
soğutulan	soğu+Verb^DB+Verb+Caus^DB+Verb+Pass+Pos^DB+Adj+PresPart
yutuyordum	yut+Verb+Pos+Prog1+Past+A1sg
yarılan	yar+Verb^DB+Verb+Pass+Pos^DB+Adj+PresPart
akıtılan	ak+Verb^DB+Verb+Caus^DB+Verb+Pass+Pos^DB+Adj+PresPart
şişirilen	şiş+Verb^DB+Verb+Caus^DB+Verb+Pass+Pos^DB+Adj+PresPart
çapalamaya	çapala+Verb+Pos^DB+Noun+Inf2+A3sg+Pnon+Dat
bölmedeki	böl+Verb+Pos^DB+Noun+Inf2+A3sg+Pnon+Loc^DB+Adj+Rel
zımparalayacaktı	zımparala+Verb+Pos+Fut+Past+A3sg
terkedilmiş	terket+Verb^DB+Verb+Pass+Pos+Narr+A3sg
çömeldi	çömel+Verb+Pos+Past+A3sg
kısmış	kıs+Verb+Pos+Narr+A3sg
değdiğinden	değ+Verb+Pos^DB+Noun+PastPart+A3sg+P3sg+Abl
farketmişti	farket+Verb+Pos+Narr+Past+A3sg
sarkıtılan	sarkıt+Verb^DB+Verb+Pass+Pos^DB+Adj+PresPart
sırıttı	sırıt+Verb+Pos+Past+A3sg
toparlandığı	toparla+Verb^DB+Verb+Pass+Pos^DB+Adj+PastPart+P3sg
saçmalıyorsun	saçmala+Verb+Pos+Prog1+A2sg
büyüdüğüm	büyü+Verb+Pos^DB+Adj+PastPart+P1sg
baltalanacaksın	baltala+Verb^DB+Verb+Pass+Pos+Fut+A2sg
pişen	piş+Verb+Pos^DB+Adj+PresPart
tekmeledi	tekmele+Verb+Pos+Past+A3sg
böğürdü	böğür+Verb+Pos+Past+A3sg
damlayan	damla+Verb+Pos^DB+Adj+PresPart
azdığı	az+Verb+Pos^DB+Adj+PastPart+P3sg
kötümsersin	kötümse+Verb+Pos+Aor+A2sg
katlanılabilir	katlan+Verb^DB+Verb+Pass+Pos^DB+Verb+Able^DB+Adj+AorPart
sarfedilir	sarfet+Verb^DB+Verb+Pass+Pos+Aor+A3sg
donatıyormuş	dona+Verb^DB+Verb+Caus+Pos+Prog1+Narr+A3sg
kaşıdı	kaşı+Verb+Pos+Past+A3sg
huylanıyor	huylan+Verb+Pos+Prog1+A3sg
sarkan	sark+Verb+Pos^DB+Adj+PresPart
yumurtlayan	yumurtla+Verb+Pos^DB+Adj+PresPart
cevapladım	cevapla+Verb+Pos+Past+A1sg
sabitlediğinde	sabitle+Verb+Pos^DB+Noun+PastPart+A3sg+P3sg+Loc
takınırlardı	takın+Verb+Pos+Aor+A3pl+Past
kilitlediğinden	kilitle+Verb+Pos^DB+Noun+PastPart+A3sg+P3sg+Abl
çevreleyen	çevrele+Verb+Pos^DB+Adj+PresPart
yağışlı	yağ+Verb+Pos^DB+Noun+Inf3+A3sg+Pnon+Nom^DB+Adj+With
çakan	çak+Verb+Pos^DB+Adj+PresPart
aydınlatır	aydınlat+Verb+Pos^DB+Adj+AorPart
anımsatan	anımsa+Verb^DB+Verb+Caus+Pos^DB+Adj+PresPart
daraltır	daral+Verb^DB+Verb+Caus+Pos^DB+Adj+AorPart
desteklemeyen	destekle+Verb+Neg^DB+Adj+PresPart
sürünüyorduk	sürün+Verb+Pos+Prog1+Past+A1pl
süpürüyor	süpür+Verb+Pos+Prog1+A3sg
kaynaşma	kaynaş+Verb+Pos^DB+Noun+Inf2+A3sg+Pnon+Nom
yavaşlatabilecek	yavaşla+Verb^DB+Verb+Caus+Pos^DB+Verb+Able^DB+Adj+FutPart+Pnon
sararmıştı	sarar+Verb+Pos+Narr+Past+A3sg
bulaştırıyordu	bulaş+Verb^DB+Verb+Caus+Pos+Prog1+Past+A3sg
çırptı	çırp+Verb+Pos+Past+A3sg
sıçrayan	sıçra+Verb+Pos^DB+Adj+PresPart
döven	döv+Verb+Pos^DB+Adj+PresPart
susuyor	susa+Verb+Pos+Prog1+A3sg
küçültmeden	küçül+Verb^DB+Verb+Caus+Pos^DB+Noun+Inf2+A3sg+Pnon+Abl
morarmış	morar+Verb+Pos+Narr+A3sg
lekelemişti	lekele+Verb+Pos+Narr+Past+A3sg
kanayan	kana+Verb+Pos^DB+Adj+PresPart
örtecek	ört+Verb+Pos^DB+Adj+FutPart+Pnon
özetleyen	özetle+Verb+Pos^DB+Adj+PresPart
aşağılayan	aşağıla+Verb+Pos^DB+Adj+PresPart
elleyen	elle+Verb+Pos^DB+Adj+PresPart
dağıttığı	dağıt+Verb+Pos^DB+Adj+PastPart+P3sg
yolladığı	yolla+Verb+Pos^DB+Adj+PastPart+P3sg
sığmayan	sığ+Verb+Neg^DB+Adj+PresPart
tasarlanan	tasarla+Verb^DB+Verb+Pass+Pos^DB+Adj+PresPart
sökerim	sök+Verb+Pos+Aor+A1sg
şapırdattı	şapırda+Verb^DB+Verb+Caus+Pos+Past+A3sg
direniyordu	dire+Verb^DB+Verb+Pass+Pos+Prog1+Past+A3sg
gönderdikleri	gönder+Verb+Pos^DB+Adj+PastPart+P3pl
aşamadığınız	aş+Verb^DB+Verb+Able+Neg^DB+Adj+PastPart+P2pl
aydınlanmıştı	aydınlan+Verb+Pos+Narr+Past+A3sg
bezenmişti	beze+Verb^DB+Verb+Pass+Pos+Narr+Past+A3sg
saptıkları	sap+Verb+Pos^DB+Adj+PastPart+P3pl
etkilemeyen	etkile+Verb+Neg^DB+Adj+PresPart
tutuklandı	tutukla+Verb^DB+Verb+Pass+Pos+Past+A3sg
birleştiği	birleş+Verb+Pos^DB+Adj+PastPart+P3sg
yayımlanan	yayımla+Verb^DB+Verb+Pass+Pos^DB+Adj+PresPart
müjdeliyordu	müjdele+Verb+Pos+Prog1+Past+A3sg
aktarmalı	aktar+Verb+Pos^DB+Noun+Inf2+A3sg+Pnon+Nom^DB+Adj+With
karşılaştırılacak	karşılaştır+Verb^DB+Verb+Pass+Pos^DB+Adj+FutPart+Pnon
sergilendiği	sergile+Verb^DB+Verb+Pass+Pos^DB+Adj+PastPart+P3sg
tanımlayacağı	tanımla+Verb+Pos^DB+Adj+FutPart+P3sg
yaladı	yala+Verb+Pos+Past+A3sg
biriktirivereyim	birik+Verb^DB+Verb+Caus+Pos^DB+Verb+Hastily+Opt+A1sg
sızmış	sız+Verb+Pos^DB+Adj+NarrPart
sürüklediğiniz	sürükle+Verb+Pos^DB+Adj+PastPart+P2pl
berelenmiş	berele+Verb^DB+Verb+Pass+Pos+Narr+A3sg
övünülecek	övün+Verb^DB+Verb+Pass+Pos^DB+Adj+FutPart+Pnon
döğüşmüşlerdi	döğ+Verb^DB+Verb+Recip+Pos+Narr+A3pl+Past
savurduğu	savur+Verb+Pos^DB+Adj+PastPart+P3sg
çırpınan	çırpın+Verb+Pos^DB+Adj+PresPart
defol	defol+Verb+Pos+Imp+A2sg
çatladı	çatla+Verb+Pos+Past+A3sg
kokladı	kokla+Verb+Pos+Past+A3sg
süzülüyordu	süzül+Verb+Pos+Prog1+Past+A3sg
tıngırdıyordu	tıngırda+Verb+Pos+Prog1+Past+A3sg
azaldığı	azal+Verb+Pos^DB+Adj+PastPart+P3sg
seslendiğinde	sesle+Verb^DB+Verb+Pass+Pos^DB+Noun+PastPart+A3sg+P3sg+Loc
sevişiyor	seviş+Verb+Pos+Prog1+A3sg
yasaklanan	yasakla+Verb^DB+Verb+Pass+Pos^DB+Adj+PresPart
hapsediyorsunuz	hapset+Verb+Pos+Prog1+A2pl
kabullenmişlerdi	kabullen+Verb+Pos+Narr+A3pl+Past
yinelenen	yinele+Verb^DB+Verb+Pass+Pos^DB+Adj+PresPart
küllenmiş	külle+Verb^DB+Verb+Pass+Pos+Narr+A3sg
sözediyordu	sözet+Verb+Pos+Prog1+Past+A3sg
zayıflamıştı	zayıfla+Verb+Pos+Narr+Past+A3sg
alıkoyacak	alıkoy+Verb+Pos^DB+Adj+FutPart+Pnon
sahnelenen	sahnele+Verb^DB+Verb+Pass+Pos^DB+Adj+PresPart
tutunmuş	tutun+Verb+Pos+Narr+A3sg
belirledikleri	belirle+Verb+Pos^DB+Adj+PastPart+P3pl
sarmalayabilir	sarmala+Verb+Pos^DB+Verb+Able+Aor+A3sg
uyuşturmak	uyuş+Verb^DB+Verb+Caus+Pos^DB+Noun+Inf1+A3sg+Pnon+Nom
algılayan	algıla+Verb+Pos^DB+Adj+PresPart
büyütmedim	büyüt+Verb+Neg+Past+A1sg
derdim	der+Verb+Pos+Past+A1sg
keşfetmediği	keşfet+Verb+Neg^DB+Adj+PastPart+P3sg
temizler	temizle+Verb+Pos+Aor+A3sg
kurtulan	kurtul+Verb+Pos^DB+Adj+PresPart
çıldırtan	çıldır+Verb^DB+Verb+Caus+Pos^DB+Adj+PresPart
öksürtmeye	öksür+Verb^DB+Verb+Caus+Pos^DB+Noun+Inf2+A3sg+Pnon+Dat
çınlatan	çınla+Verb^DB+Verb+Caus+Pos^DB+Adj+PresPart
sürttü	sürt+Verb+Pos+Past+A3sg
ısıtamıyordum	ısıt+Verb^DB+Verb+Able+Neg+Prog1+Past+A1sg
kaykılmış	kaykıl+Verb+Pos+Narr+A3sg
üşüme	üşü+Verb+Pos^DB+Noun+Inf2+A3sg+Pnon+Nom
oyulan	oy+Verb^DB+Verb+Pass+Pos^DB+Adj+PresPart
küfretmeye	küfret+Verb+Pos^DB+Noun+Inf2+A3sg+Pnon+Dat
ıskalayan	ıskala+Verb+Pos^DB+Adj+PresPart
tökezledi	tökezle+Verb+Pos+Past+A3sg
tembihledim	tembihle+Verb+Pos+Past+A1sg
erdiği	er+Verb+Pos^DB+Adj+PastPart+P3sg
değiller	değille+Verb+Pos+Aor+A3sg
danışır	danış+Verb+Pos+Aor+A3sg
tutuşturulan	tutuş+Verb^DB+Verb+Caus^DB+Verb+Pass+Pos^DB+Adj+PresPart
avutacak	avut+Verb+Pos^DB+Adj+FutPart+Pnon
ezberledim	ezberle+Verb+Pos+Past+A1sg
afallamıştım	afalla+Verb+Pos+Narr+Past+A1sg
sunuculu	sun+Verb+Pos^DB+Noun+Agt+A3sg+Pnon+Nom^DB+Adj+With
eleştiren	eleştir+Verb+Pos^DB+Adj+PresPart
kirletmeyecek	kirlet+Verb+Neg+Fut+A3sg
iletebilen	ilet+Verb+Pos^DB+Verb+Able^DB+Adj+PresPart
üşüşmüştü	üşüş+Verb+Pos+Narr+Past+A3sg
irkiliyor	irkil+Verb+Pos+Prog1+A3sg
sönen	sön+Verb+Pos^DB+Adj+PresPart
abartacaklardı	abart+Verb+Pos+Fut+A3pl+Past
önemsediğim	önemse+Verb+Pos^DB+Adj+PastPart+P1sg
dalıyordum	dala+Verb+Pos+Prog1+Past+A1sg
yargılayan	yargıla+Verb+Pos^DB+Adj+PresPart
bürüneceğini	bürün+Verb+Pos^DB+Noun+FutPart+A3sg+P3sg+Acc
kakacağım	kak+Verb+Pos+Fut+A1sg
kiraladığım	kirala+Verb+Pos^DB+Adj+PastPart+P1sg
kuruyan	kuru+Verb+Pos^DB+Adj+PresPart
savunan	savun+Verb+Pos^DB+Adj+PresPart
tarandıkları	tara+Verb^DB+Verb+Pass+Pos^DB+Adj+PastPart+P3pl
serpiştirilmiş	serpiş+Verb^DB+Verb+Caus^DB+Verb+Pass+Pos+Narr+A3sg
uçuştuğu	uçuş+Verb+Pos^DB+Adj+PastPart+P3sg
arzuladığı	arzula+Verb+Pos^DB+Adj+PastPart+P3sg
kırışmış	kırış+Verb+Pos+Narr+A3sg
önerdiğim	öner+Verb+Pos^DB+Adj+PastPart+P1sg
aldatıcı	aldat+Verb+Pos^DB+Noun+Agt+A3sg+Pnon+Nom
ovuşturmaya	ovuştur+Verb+Pos^DB+Noun+Inf2+A3sg+Pnon+Dat
direnen	diren+Verb+Pos^DB+Adj+PresPart
buyurur	buyur+Verb+Pos+Aor+A3sg
sayıklıyordu	sayıkla+Verb+Pos+Prog1+Past+A3sg
sızlayan	sızla+Verb+Pos^DB+Adj+PresPart
hastalanmamıştı	hastalan+Verb+Neg+Narr+Past+A3sg
ummadıkları	um+Verb+Neg^DB+Adj+PastPart+P3pl
kaçınmayan	kaçın+Verb+Neg^DB+Adj+PresPart
kızardığını	kızar+Verb+Pos^DB+Noun+PastPart+A3sg+P3sg+Acc
şakalaşıyor	şakalaş+Verb+Pos+Prog1+A3sg
zamanlandığı	zamanla+Verb^DB+Verb+Pass+Pos^DB+Adj+PastPart+P3sg
dışlandı	dışla+Verb^DB+Verb+Pass+Pos+Past+A3sg
yayınladığı	yayınla+Verb+Pos^DB+Adj+PastPart+P3sg
pazarlamacıydı	pazarla+Verb+Pos^DB+Noun+Inf2+A3sg+Pnon+Nom^DB+Noun+Agt+A3sg+Pnon+Nom^DB+Verb+Zero+Past+A3sg
çözümlenemeyen	çözümle+Verb^DB+Verb+Pass^DB+Verb+Able+Neg^DB+Adj+PresPart
paketlememişti	paketle+Verb+Neg+Narr+Past+A3sg
önlediği	önle+Verb+Pos^DB+Adj+PastPart+P3sg
acıkmıştı	acık+Verb+Pos+Narr+Past+A3sg
varsayılan	varsay+Verb^DB+Verb+Pass+Pos^DB+Adj+PresPart
gıcırdayan	gıcırda+Verb+Pos^DB+Adj+PresPart
kımıldamadı	kımılda+Verb+Neg+Past+A3sg
savsaklıyorsunuz	savsakla+Verb+Pos+Prog1+A2pl
aralandı	arala+Verb^DB+Verb+Pass+Pos+Past+A3sg
yankılanıyordu	yankıla+Verb^DB+Verb+Pass+Pos+Prog1+Past+A3sg
havalandığı	havalan+Verb+Pos^DB+Adj+PastPart+P3sg
hışırdayan	hışırda+Verb+Pos^DB+Adj+PresPart
sıyrılmıştı	sıyrıl+Verb+Pos+Narr+Past+A3sg
topallayan	topalla+Verb+Pos^DB+Adj+PresPart
uygulanabilen	uygula+Verb^DB+Verb+Pass+Pos^DB+Verb+Able^DB+Adj+PresPart
noktalanırsa	noktala+Verb^DB+Verb+Pass+Pos+Aor+Cond+A3sg
donan	don+Verb+Pos^DB+Adj+PresPart
yendiği	yen+Verb+Pos^DB+Adj+PastPart+P3sg
geğirdi	geğir+Verb+Pos+Past+A3sg
nitelendirilebilecek	nitelen+Verb^DB+Verb+Caus^DB+Verb+Pass+Pos^DB+Verb+Able+Fut+A3sg
üstlenen	üstlen+Verb+Pos^DB+Adj+PresPart
incelir	incel+Verb+Pos+Aor+A3sg
oflar	ofla+Verb+Pos+Aor+A3sg
çabalasa	çabala+Verb+Pos+Desr+A3sg
çözebilen	çöz+Verb+Pos^DB+Verb+Able^DB+Adj+PresPart
ışıldayan	ışılda+Verb+Pos^DB+Adj+PresPart
zaptedemiyordum	zaptet+Verb^DB+Verb+Able+Neg+Prog1+Past+A1sg
kahrediyorsunuz	kahret+Verb+Pos+Prog1+A2pl
araştırdığınız	araştır+Verb+Pos^DB+Adj+PastPart+P2pl
ferahlaması	ferahla+Verb+Pos^DB+Noun+Inf2+A3sg+P3sg+Nom
uğurlama	uğurla+Verb+Pos^DB+Noun+Inf2+A3sg+Pnon+Nom
dizdiği	diz+Verb+Pos^DB+Adj+PastPart+P3sg
kıyaslanabilecek	kıyasla+Verb^DB+Verb+Pass+Pos^DB+Verb+Able^DB+Adj+FutPart+Pnon
zehirleyen	zehirle+Verb+Pos^DB+Adj+PresPart
taparlar	tap+Verb+Pos^DB+Adj+AorPart^DB+Noun+Zero+A3pl+Pnon+Nom
alkışlamaya	alkışla+Verb+Pos^DB+Noun+Inf2+A3sg+Pnon+Dat
ayarlayacak	ayarla+Verb+Pos^DB+Adj+FutPart+Pnon
savaşan	savaş+Verb+Pos^DB+Adj+PresPart
geciken	gecik+Verb+Pos^DB+Adj+PresPart
çalkalandığını	çalkala+Verb^DB+Verb+Pass+Pos^DB+Noun+PastPart+A3sg+P3sg+Acc
ayıplamaya	ayıpla+Verb+Pos^DB+Noun+Inf2+A3sg+Pnon+Dat
gözettiğimi	göze+Verb^DB+Verb+Caus+Pos^DB+Noun+PastPart+A3sg+P1sg+Acc
öğütlememe	öğütle+Verb+Neg^DB+Noun+Inf2+A3sg+Pnon+Nom
halletmek	hallet+Verb+Pos^DB+Noun+Inf1+A3sg+Pnon+Nom
toslamamak	tosla+Verb+Neg^DB+Noun+Inf1+A3sg+Pnon+Nom
dizginlemeye	dizginle+Verb+Pos^DB+Noun+Inf2+A3sg+Pnon+Dat
hırlayan	hırla+Verb+Pos^DB+Adj+PresPart
hırpalanmış	hırpala+Verb^DB+Verb+Pass+Pos^DB+Adj+NarrPart
dalaşmadan	dalaş+Verb+Pos^DB+Noun+Inf2+A3sg+Pnon+Abl
kanıtlayabilmeli	kanıtla+Verb+Pos^DB+Verb+Able^DB+Noun+Inf2+A3sg+Pnon+Nom^DB+Adj+With
saplanan	sapla+Verb^DB+Verb+Pass+Pos^DB+Adj+PresPart
paylamadan	payla+Verb+Pos^DB+Noun+Inf2+A3sg+Pnon+Abl
ısınan	ısın+Verb+Pos^DB+Adj+PresPart
eğitmek	eğit+Verb+Pos^DB+Noun+Inf1+A3sg+Pnon+Nom
tünemeye	tüne+Verb+Pos^DB+Noun+Inf2+A3sg+Pnon+Dat
tıklattığınız	tıkla+Verb^DB+Verb+Caus+Pos^DB+Adj+PastPart+P2pl
tükenmek	tüken+Verb+Pos^DB+Noun+Inf1+A3sg+Pnon+Nom
şaklamasıyla	şakla+Verb+Pos^DB+Noun+Inf2+A3sg+P3sg+Ins
ötesinden	öt+Verb+Pos^DB+Noun+FeelLike+A3sg+P2sg+Abl
mırıldanmak	mırılda+Verb^DB+Verb+Pass+Pos^DB+Noun+Inf1+A3sg+Pnon+Nom
buluşan	buluş+Verb+Pos^DB+Adj+PresPart
genişletilen	genişle+Verb^DB+Verb+Caus^DB+Verb+Pass+Pos^DB+Adj+PresPart
yakarış	yakar+Verb+Pos^DB+Noun+Inf3+A3sg+Pnon+Nom
tepesinden	tep+Verb+Pos^DB+Noun+FeelLike+A3sg+P2sg+Abl
alınan	alın+Verb+Pos^DB+Adj+PresPart
yumruklamaya	yumrukla+Verb+Pos^DB+Noun+Inf2+A3sg+Pnon+Dat
üfledikten	üfle+Verb+Pos^DB+Noun+PastPart+A3sg+Pnon+Abl
yansıyacak	yansı+Verb+Pos^DB+Adj+FutPart+Pnon
eklemlerimi	eklemle+Verb+Pos^DB+Adj+AorPart^DB+Noun+Zero+A3sg+P1sg+Acc
esnemesini	esne+Verb+Pos^DB+Noun+Inf2+A3sg+P3sg+Acc
seğirmeler	seğir+Verb+Pos^DB+Noun+Inf2+A3pl+Pnon+Nom
patlamak	patla+Verb+Pos^DB+Noun+Inf1+A3sg+Pnon+Nom
kağıtlarımı	kağıtla+Verb+Pos^DB+Adj+AorPart^DB+Noun+Zero+A3sg+P1sg+Acc
filizlenmeye	filizle+Verb^DB+Verb+Pass+Pos^DB+Noun+Inf2+A3sg+Pnon+Dat
soyunmuş	soyun+Verb+Pos^DB+Adj+NarrPart
diklendiği	dikle+Verb^DB+Verb+Pass+Pos^DB+Adj+PastPart+P3sg
kısıtlanmış	kısıtla+Verb^DB+Verb+Pass+Pos^DB+Adj+NarrPart
yonttuğu	yont+Verb+Pos^DB+Adj+PastPart+P3sg
sümküren	sümkür+Verb+Pos^DB+Adj+PresPart
kamaştıran	kamaş+Verb^DB+Verb+Caus+Pos^DB+Adj+PresPart
kaynayan	kayna+Verb+Pos^DB+Adj+PresPart
tırmalayan	tırmala+Verb+Pos^DB+Adj+PresPart
koşuşturan	koşuş+Verb^DB+Verb+Caus+Pos^DB+Adj+PresPart
yönetir	yönet+Verb+Pos^DB+Adj+AorPart
denetleyicisindeki	denetle+Verb+Pos^DB+Noun+Agt+A3sg+P3sg+Loc^DB+Adj+Rel
avlanan	avla+Verb^DB+Verb+Pass+Pos^DB+Adj+PresPart
hortladığı	hortla+Verb+Pos^DB+Adj+PastPart+P3sg
yağmaladığı	yağmala+Verb+Pos^DB+Adj+PastPart+P3sg
kanlar	kanla+Verb+Pos^DB+Adj+AorPart
azıttığı	azıt+Verb+Pos^DB+Adj+PastPart+P3sg
incitici	incit+Verb+Pos^DB+Adj+Agt
varolan	varol+Verb+Pos^DB+Adj+PresPart
üretmeyen	üre+Verb^DB+Verb+Caus+Neg^DB+Adj+PresPart
uluyan	ulu+Verb+Pos^DB+Adj+PresPart
bahşettiği	bahşet+Verb+Pos^DB+Adj+PastPart+P3sg
ağrıyan	ağrı+Verb+Pos^DB+Adj+PresPart
döşenmiş	döşe+Verb^DB+Verb+Pass+Pos^DB+Adj+NarrPart
budanmış	buda+Verb^DB+Verb+Pass+Pos^DB+Adj+NarrPart
kesişen	kesiş+Verb+Pos^DB+Adj+PresPart
ayaklanan	ayaklan+Verb+Pos^DB+Adj+PresPart
fışkıran	fışkır+Verb+Pos^DB+Adj+PresPart
şenlendirdiği	şenlen+Verb^DB+Verb+Caus+Pos^DB+Adj+PastPart+P3sg
uğuldayan	uğulda+Verb+Pos^DB+Adj+PresPart
pekiştiren	pekiş+Verb^DB+Verb+Caus+Pos^DB+Adj+PresPart
iğrenilecek	iğren+Verb^DB+Verb+Pass+Pos^DB+Adj+FutPart+Pnon
sorgulayan	sorgula+Verb+Pos^DB+Adj+PresPart
delen	del+Verb+Pos^DB+Adj+PresPart
dikilen	dikil+Verb+Pos^DB+Adj+PresPart
rastgeldiği	rastgel+Verb+Pos^DB+Adj+PastPart+P3sg
ağarmış	ağar+Verb+Pos^DB+Adj+NarrPart
hedeflendiği	hedefle+Verb^DB+Verb+Pass+Pos^DB+Adj+PastPart+P3sg
defnedildiği	defnet+Verb^DB+Verb+Pass+Pos^DB+Adj+PastPart+P3sg
otladığı	otla+Verb+Pos^DB+Adj+PastPart+P3sg
değinen	değin+Verb+Pos^DB+Adj+PresPart
püskürten	püskür+Verb^DB+Verb+Caus+Pos^DB+Adj+PresPart
doğrulayan	doğrula+Verb+Pos^DB+Adj+PresPart
yanaşamadığı	yanaş+Verb^DB+Verb+Able+Neg^DB+Adj+PastPart+P3sg
güttüğüm	güt+Verb+Pos^DB+Adj+PastPart+P1sg
uyuklayan	uyukla+Verb+Pos^DB+Adj+PresPart
dinlenen	dinlen+Verb+Pos^DB+Adj+PresPart
kuşanan	kuşan+Verb+Pos^DB+Adj+PresPart
şıngırdayacak	şıngırda+Verb+Pos^DB+Adj+FutPart+Pnon
kurcalayan	kurcala+Verb+Pos^DB+Adj+PresPart
devrilen	devir+Verb^DB+Verb+Pass+Pos^DB+Adj+PresPart
takılan	takıl+Verb+Pos^DB+Adj+PresPart
özlediği	özle+Verb+Pos^DB+Adj+PastPart+P3sg
yadsıyan	yadsı+Verb+Pos^DB+Adj+PresPart
bütünleyen	bütünle+Verb+Pos^DB+Adj+PresPart
aşılayan	aşıla+Verb+Pos^DB+Adj+PresPart
kıvranan	kıvran+Verb+Pos^DB+Adj+PresPart
aldırdığı	aldır+Verb+Pos^DB+Adj+PastPart+P3sg
görüntülendiği	görüntüle+Verb^DB+Verb+Pass+Pos^DB+Adj+PastPart+P3sg
işaretlenen	işaretle+Verb^DB+Verb+Pass+Pos^DB+Adj+PresPart
devraldığı	devral+Verb+Pos^DB+Adj+PastPart+P3sg
kısalan	kısal+Verb+Pos^DB+Adj+PresPart
planladığınız	planla+Verb+Pos^DB+Adj+PastPart+P2pl
kaydettiği	kaydet+Verb+Pos^DB+Adj+PastPart+P3sg
ölçüldüğü	ölç+Verb^DB+Verb+Pass+Pos^DB+Adj+PastPart+P3sg
tetikleyen	tetikle+Verb+Pos^DB+Adj+PresPart
şifreleyen	şifrele+Verb+Pos^DB+Adj+PresPart
odaklanılan	odakla+Verb^DB+Verb+Pass+Pos^DB+Adj+PresPart
önyüklemesiz	önyükle+Verb+Pos^DB+Noun+Inf2+A3sg+Pnon+Nom^DB+Adj+Without
depolayan	depola+Verb+Pos^DB+Adj+PresPart
eriştiği	eriş+Verb+Pos^DB+Adj+PastPart+P3sg
listelenecek	listele+Verb^DB+Verb+Pass+Pos^DB+Adj+FutPart+Pnon
yorumlayan	yorumla+Verb+Pos^DB+Adj+PresPart
kopyalanan	kopyala+Verb^DB+Verb+Pass+Pos^DB+Adj+PresPart
barındırdığı	barın+Verb^DB+Verb+Caus+Pos^DB+Adj+PastPart+P3sg
önizlediğim	önizle+Verb+Pos^DB+Adj+PastPart+P1sg
yedeklediğiniz	yedekle+Verb+Pos^DB+Adj+PastPart+P2pl
sekmeli	sek+Verb+Pos^DB+Noun+Inf2+A3sg+Pnon+Nom^DB+Adj+With
sınamadığınız	sın+Verb^DB+Verb+Able+Neg^DB+Adj+PastPart+P2pl
kapsayacak	kapsa+Verb+Pos^DB+Adj+FutPart+Pnon
bileşenlerindeki	bileş+Verb+Pos^DB+Adj+PresPart^DB+Noun+Zero+A3pl+P3sg+Loc^DB+Adj+Rel
sınırlayan	sınırla+Verb+Pos^DB+Adj+PresPart
eşitlendiği	eşitle+Verb^DB+Verb+Pass+Pos^DB+Adj+PastPart+P3sg
yönlendirildiği	yönlen+Verb^DB+Verb+Caus^DB+Verb+Pass+Pos^DB+Adj+PastPart+P3sg
simgeleyecek	simgele+Verb+Pos^DB+Adj+FutPart+Pnon
sıralandığı	sırala+Verb^DB+Verb+Pass+Pos^DB+Adj+PastPart+P3sg
dengeleyen	dengele+Verb+Pos^DB+Adj+PresPart
grupladığınız	grupla+Verb+Pos^DB+Adj+PastPart+P2pl
rendelenmiş	rendele+Verb^DB+Verb+Pass+Pos^DB+Adj+NarrPart
başgösteren	başgöster+Verb+Pos^DB+Adj+PresPart
yeralan	yeral+Verb+Pos^DB+Adj+PresPart
devredilen	devret+Verb^DB+Verb+Pass+Pos^DB+Adj+PresPart
fakslanan	faksla+Verb^DB+Verb+Pass+Pos^DB+Adj+PresPart
addetmeyen	addet+Verb+Neg^DB+Adj+PresPart
göğüsleyen	göğüsle+Verb+Pos^DB+Adj+PresPart
sollayan	solla+Verb+Pos^DB+Adj+PresPart
konakladığınız	konakla+Verb+Pos^DB+Adj+PastPart+P2pl
sahiplenen	sahiplen+Verb+Pos^DB+Adj+PresPart
amaçlayan	amaçla+Verb+Pos^DB+Adj+PresPart
yenilediği	yenile+Verb+Pos^DB+Adj+PastPart+P3sg
nitelediği	nitele+Verb+Pos^DB+Adj+PastPart+P3sg
öngördüğü	öngör+Verb+Pos^DB+Adj+PastPart+P3sg
duyuran	duyur+Verb+Pos^DB+Adj+PresPart
çimdikleyen	çimdikle+Verb+Pos^DB+Adj+PresPart
eğiren	eğir+Verb+Pos^DB+Adj+PresPart
yazıştığım	yazış+Verb+Pos^DB+Adj+PastPart+P1sg
tokatlayan	tokatla+Verb+Pos^DB+Adj+PresPart
çağrıştırdığı	çağrış+Verb^DB+Verb+Caus+Pos^DB+Adj+PastPart+P3sg
güreşen	güreş+Verb+Pos^DB+Adj+PresPart
gözlemleyen	gözlemle+Verb+Pos^DB+Adj+PresPart
yanıtlayan	yanıtla+Verb+Pos^DB+Adj+PresPart
sevkettiği	sevket+Verb+Pos^DB+Adj+PastPart+P3sg
haczedilen	haczet+Verb^DB+Verb+Pass+Pos^DB+Adj+PresPart
kıskandıracak	kıskan+Verb^DB+Verb+Caus+Pos^DB+Adj+FutPart+Pnon
harmanladığımız	harmanla+Verb+Pos^DB+Adj+PastPart+P1pl
sıkılan	sıkıl+Verb+Pos^DB+Adj+PresPart
yıprattıkları	yıprat+Verb+Pos^DB+Adj+PastPart+P3pl
yeşerdiği	yeşer+Verb+Pos^DB+Adj+PastPart+P3sg
çoğalan	çoğal+Verb+Pos^DB+Adj+PresPart
cezbeden	cezbet+Verb+Pos^DB+Adj+PresPart
ertelenen	ertele+Verb^DB+Verb+Pass+Pos^DB+Adj+PresPart
sığınmayan	sığın+Verb+Neg^DB+Adj+PresPart
frenler	frenle+Verb+Pos^DB+Adj+AorPart
