almayacaklarını	al	Verb	Noun
aşmamak	aş	Verb	Noun
bulunmadığını	bulun	Verb	Noun
verilmediğini	ver	Verb	Noun
olmadığını	ol	Verb	Noun
edemez	et	Verb	Verb
bilmiyor	bil	Verb	Verb
gitmeyecek	git	Verb	Verb
imzalanmamış	imzala	Verb	Verb
tartışmayacağım	tartış	Verb	Verb
vermeyeceğini	ver	Verb	Noun
vermezsin	ver	Verb	Verb
olmadığından	ol	Verb	Noun
olmayan	ol	Verb	Adj
vermedi	ver	Verb	Verb
duymuyordu	duy	Verb	Verb
çıkmamıştı	çık	Verb	Verb
düşünmüyorum	düşün	Verb	Verb
etmedi	et	Verb	Verb
değildir	değil	Verb	Verb
ilgilendirmiyor	ilgilen	Verb	Verb
inanamıyorum	inan	Verb	Verb
söylemedim	söyle	Verb	Verb
nişanlanmadığımı	nişanla	Verb	Noun
istemem	iste	Verb	Verb
yanılmaz	yan	Verb	Verb
unutmazsa	unut	Verb	Verb
onaylamam	onayla	Verb	Verb
onaylamamam	onayla	Verb	Noun
gelmedik	gel	Verb	Verb
etmiyorum	et	Verb	Verb
karışmıyorum	karış	Verb	Verb
olmasın	ol	Verb	Verb
olmazdı	ol	Verb	Verb
olmadığımı	ol	Verb	Noun
değiştirmedikleri	değiş	Verb	Noun
kastetmiyorsun	kastet	Verb	Verb
olmaz	ol	Verb	Adj
dokunmayacakları	doku	Verb	Noun
olmamıştım	ol	Verb	Verb
etmemeni	et	Verb	Noun
affetmeyeceğim	affet	Verb	Verb
görünmemişti	görün	Verb	Verb
görmediği	gör	Verb	Noun
rastlamadığım	rastla	Verb	Adj
edemem	et	Verb	Verb
anlatmamam	anla	Verb	Noun
söylemedi	söyle	Verb	Verb
bilmiyorum	bil	Verb	Verb
konuşmadım	konuş	Verb	Verb
olmamak	ol	Verb	Noun
benzemez	benze	Verb	Verb
etmez	et	Verb	Verb
sinirlenmez	sinir	Noun	Verb
anlamıyorum	anla	Verb	Verb
dönülmez	dön	Verb	Verb
etme	et	Verb	Verb
feshedilemez	feshet	Verb	Verb
edemeyeceğim	et	Verb	Verb
ödemez	öde	Verb	Verb
yetmemesidir	yet	Verb	Verb
olmasa	ol	Verb	Verb
kullanmadıklarıdır	kullan	Verb	Verb
duymaz	duy	Verb	Verb
bilmez	bil	Verb	Verb
olamaz	ol	Verb	Verb
bilmem	bil	Verb	Verb
edemeyeceğin	et	Verb	Noun
bilmediğiniz	bil	Verb	Noun
olmayacak	ol	Verb	Verb
dayanamazdı	daya	Verb	Verb
olmayacağını	ol	Verb	Noun
dilemem	dile	Verb	Verb
düşünmüyordum	düşün	Verb	Verb
tamamlanmamış	tamamla	Verb	Adj
alamıyordu	al	Verb	Verb
kullanamıyordu	kullan	Verb	Verb
edemediler	et	Verb	Verb
edilemezdi	et	Verb	Verb
değildi	değil	Verb	Verb
etmiyormuş	et	Verb	Verb
yapamıyor	yap	Verb	Verb
kalmamalısın	kal	Verb	Verb
görülmemiş	gör	Verb	Verb
kaybetmiyordu	kaybet	Verb	Verb
söylemiyordu	söyle	Verb	Verb
kalmazdı	kal	Verb	Verb
durmuyordu	dur	Verb	Verb
bahsetmediği	bahset	Verb	Adj
yanıltmazdı	yanıl	Verb	Verb
bilmediği	bil	Verb	Noun
bilinmemekle	bil	Verb	Noun
yapılamaz	yap	Verb	Verb
öğrenilemedi	öğren	Verb	Verb
dönmediler	dön	Verb	Verb
alamazdım	al	Verb	Verb
hoşlanmıyorlardı	hoşlan	Verb	Verb
sayılmazdı	say	Verb	Verb
görünmüyor	görün	Verb	Verb
evlenmeyeceğini	evlen	Verb	Noun
edemiyordu	et	Verb	Verb
uyandıramazdı	uyan	Verb	Verb
duymamış	duy	Verb	Verb
gelmeyeni	gel	Verb	Noun
koymayacaklarını	koy	Verb	Noun
tutamazdı	tut	Verb	Verb
damlamayacaklarına	damla	Verb	Noun
başlamamıştı	başla	Verb	Verb
etmeyeceğiz	et	Verb	Verb
bilmiyordu	bil	Verb	Verb
dönmeyeceğine	dön	Verb	Noun
koymadı	koy	Verb	Verb
alışmayan	alış	Verb	Adj
çekemiyordu	çek	Verb	Verb
umursamaz	umursa	Verb	Verb
başlayamazdı	başla	Verb	Verb
bitmez	bit	Verb	Verb
beklenmedik	bekle	Verb	Adj
varılmıyormuş	var	Verb	Verb
basmadım	bas	Verb	Verb
gelmez	gel	Verb	Verb
çıkıvermez	çık	Verb	Verb
hatırlamıyorum	hatırla	Verb	Verb
istememiştiniz	iste	Verb	Verb
düşünmem	düşün	Verb	Verb
sanmam	san	Verb	Verb
hatırlatmam	hatırla	Verb	Verb
çıkmayacağım	çık	Verb	Verb
unutmayın	unut	Verb	Verb
konuşmayın	konuş	Verb	Verb
dinleyemem	dinle	Verb	Verb
yapamazsanız	yap	Verb	Verb
yapmıyorum	yap	Verb	Verb
değilmiş	değil	Verb	Verb
duramıyordu	dur	Verb	Verb
susmaz	sus	Verb	Verb
kaçırmamak	kaç	Verb	Noun
dayanamadı	dayan	Verb	Verb
tanımıyorsunuz	tanı	Verb	Verb
bırakmazlar	bırak	Verb	Verb
bulunmaz	bulun	Verb	Verb
değilim	değil	Verb	Verb
çıkmazdı	çık	Verb	Verb
ayıramıyor	ayır	Verb	Verb
bitiremedi	bit	Verb	Verb
unutmadım	unut	Verb	Verb
ayrılmamak	ayır	Verb	Noun
görmüyor	gör	Verb	Verb
sevmemiş	sev	Verb	Verb
kastetmiyorum	kastet	Verb	Verb
anlamıyor	anla	Verb	Verb
yorulmadınızsa	yor	Verb	Verb
istemiyorum	iste	Verb	Verb
tutamadı	tut	Verb	Verb
anlaşılmıyordu	anlaş	Verb	Verb
bırakmam	bırak	Verb	Verb
çıkarmıyordu	çık	Verb	Verb
bırakmayacağım	bırak	Verb	Verb
bahsedemem	bahset	Verb	Verb
edilmez	et	Verb	Verb
bulamıyorum	bul	Verb	Verb
söyleyemeyeceğimi	söyle	Verb	Noun
bildirmemiş	bil	Verb	Verb
çevirmediniz	çevir	Verb	Verb
reddetmediniz	reddet	Verb	Verb
çevirmedimse	çevir	Verb	Verb
dememem	de	Verb	Noun
reddetmezsiniz	reddet	Verb	Verb
edemezsiniz	et	Verb	Verb
görmedim	gör	Verb	Verb
darılmadığımı	darıl	Verb	Noun
saklayamadık	sakla	Verb	Verb
istemedik	iste	Verb	Verb
istemiyoruz	iste	Verb	Verb
değilse	değil	Verb	Verb
gitmemişti	git	Verb	Verb
değilsiniz	değil	Verb	Verb
olmadığı	ol	Verb	Noun
etmeme	et	Verb	Noun
şaşmamalıyım	şaş	Verb	Verb
olmazsa	ol	Verb	Verb
söyleyemem	söyle	Verb	Verb
kandıramazsınız	kan	Verb	Verb
konuşmamam	konuş	Verb	Noun
olmayabilirdi	ol	Verb	Verb
bulmayın	bul	Verb	Verb
söylemediğinizi	söyle	Verb	Noun
bırakmamışsınız	bırak	Verb	Verb
sayılmaz	say	Verb	Verb
sevmese	sev	Verb	Verb
bilmiyorsunuz	bil	Verb	Verb
çıkmadı	çık	Verb	Verb
karıştırmayın	karış	Verb	Verb
bilemeyecektir	bil	Verb	Verb
durmuyorum	dur	Verb	Verb
anlayamazsınız	anla	Verb	Verb
kalmamış	kal	Verb	Verb
alamadığım	al	Verb	Noun
konuşmama	konuş	Verb	Noun
düşünmez	düşün	Verb	Verb
ayrılmadığımızı	ayır	Verb	Noun
düşünmediğimi	düşün	Verb	Noun
yanılmamışım	yanıl	Verb	Verb
olmadığına	ol	Verb	Noun
gücendirmediniz	gücen	Verb	Verb
etmediniz	et	Verb	Verb
kuvvetlendirmediniz	kuvvet	Noun	Verb
kesmeyin	kes	Verb	Verb
koyamam	koy	Verb	Verb
inanmamıştım	inan	Verb	Verb
dayanılmaz	daya	Verb	Verb
geçilmez	geç	Verb	Verb
gitmediğinizi	git	Verb	Noun
öğütlememe	öğütle	Verb	Noun
kollayamaz	kolla	Verb	Verb
varmamak	var	Verb	Noun
hesaplayamamak	hesapla	Verb	Noun
görmemek	gör	Verb	Noun
bilmiyordunuz	bil	Verb	Verb
gelmeseniz	gel	Verb	Verb
ölmezse	öl	Verb	Verb
ekmesin	ek	Verb	Verb
dayanamayacağım	daya	Verb	Verb
üzmeyin	üz	Verb	Verb
basmayın	bas	Verb	Verb
tartamamışım	tart	Verb	Verb
bırakmayıp	bırak	Verb	Verb
dayanamaz	daya	Verb	Verb
kaldırmadı	kal	Verb	Verb
oturamıyordu	otur	Verb	Verb
saklamayalım	sakla	Verb	Verb
açıklayamadığı	açıkla	Verb	Adj
uzatmamalı	uza	Verb	Verb
inanmadığımız	inan	Verb	Adj
olmayacağına	ol	Verb	Noun
atmaz	at	Verb	Verb
dayanamayacak	daya	Verb	Verb
istemeyecek	iste	Verb	Adj
demeyecekti	de	Verb	Verb
kesilmemiş	kes	Verb	Verb
emretmemiş	emret	Verb	Verb
yapmadın	yap	Verb	Verb
yaramayan	yara	Verb	Adj
vermiyorlar	ver	Verb	Verb
ayrılmıyordu	ayır	Verb	Verb
çıkaramıyordu	çık	Verb	Verb
bırakmadı	bırak	Verb	Verb
dokundurtmuyor	dokun	Verb	Verb
şaşırmadı	şaşır	Verb	Verb
erdiremeyeceğini	er	Verb	Noun
etmeyin	et	Verb	Verb
gelmediğini	gel	Verb	Noun
toslamamak	tosla	Verb	Noun
alamayarak	al	Verb	Verb
saldıramazdı	sal	Verb	Verb
gerekmiyordu	gerek	Verb	Verb
yetemezmiş	yet	Verb	Verb
bulunmadı	bulun	Verb	Verb
istemiyordu	iste	Verb	Verb
aldırmayın	al	Verb	Verb
bırakmıyordu	bırak	Verb	Verb
kalmadı	kal	Verb	Verb
kaybetmedi	kaybet	Verb	Verb
uzaklaşmamıştı	uzak	Adj	Verb
yetişmemiş	yetiş	Verb	Verb
benzemiyordu	benze	Verb	Verb
görünmüyordu	görün	Verb	Verb
yeltenmemesi	yelten	Verb	Noun
bilmediklerinden	bil	Verb	Noun
inanamayan	inan	Verb	Adj
bulamadı	bul	Verb	Verb
kaynaklanmıyordu	kaynakla	Verb	Verb
girmemişti	gir	Verb	Verb
sataşmamayı	sataş	Verb	Noun
unutmamıştı	unut	Verb	Verb
umursamıyordu	umursa	Verb	Verb
gelmeyeceğini	gel	Verb	Noun
göstermiyordu	göster	Verb	Verb
gelmezdi	gel	Verb	Verb
geçiremiyordu	geç	Verb	Verb
saplamamak	sapla	Verb	Noun
etmemeyi	et	Verb	Noun
çıkmamayı	çık	Verb	Noun
unutmamak	unut	Verb	Noun
yetmiyormuş	yet	Verb	Verb
yanılmayan	yan	Verb	Adj
sevememişti	sev	Verb	Verb
çektirmemişlerdi	çek	Verb	Verb
bilemezdi	bil	Verb	Verb
engelleyemiyordu	engelle	Verb	Verb
olmuyordu	ol	Verb	Verb
kalmıyordu	kal	Verb	Verb
beslemiyordu	besle	Verb	Verb
sırnaşmıyordu	sırnaş	Verb	Verb
katlanamaz	katla	Verb	Verb
etmiyordu	et	Verb	Verb
koşmazdı	koş	Verb	Verb
çıkmaz	çık	Verb	Verb
görmez	gör	Verb	Verb
çıkmıyordu	çık	Verb	Verb
edemiyorlardı	et	Verb	Verb
sataşmıyor	sataş	Verb	Verb
yaklaşmıyorlardı	yaklaş	Verb	Verb
bitmiyordu	bit	Verb	Verb
eğmez	eğ	Verb	Verb
acıtmasa	acı	Verb	Verb
görmediğini	gör	Verb	Noun
düşünmemişti	düşün	Verb	Verb
almadı	al	Verb	Verb
durmamış	dur	Verb	Verb
geçemediği	geç	Verb	Adj
bilmediğinden	bil	Verb	Noun
yemez	ye	Verb	Verb
demedi	de	Verb	Verb
etmemiş	et	Verb	Verb
yanılmamıştı	yan	Verb	Verb
almamıştı	al	Verb	Verb
gizleyememiş	gizle	Verb	Verb
dokunmamayı	dokun	Verb	Noun
vermeyeceğim	ver	Verb	Verb
hoşlanmasa	hoşlan	Verb	Verb
kalkışmadı	kalkış	Verb	Verb
alamıyordum	al	Verb	Verb
anlayamıyordum	anla	Verb	Verb
rastlamıyordum	rastla	Verb	Verb
tanımaz	tanı	Verb	Verb
görmezsek	gör	Verb	Verb
görememiştik	gör	Verb	Verb
tanıştırılmamıştık	tanış	Verb	Verb
etmesinler	et	Verb	Verb
unutamam	unut	Verb	Verb
acımamışlar	acı	Verb	Verb
edemedim	et	Verb	Verb
hissedemiyordum	hisset	Verb	Verb
tanıyamayacak	tanı	Verb	Adj
olmamış	ol	Verb	Adj
düşünememiştim	düşün	Verb	Verb
değişmeyen	değiş	Verb	Adj
almadım	al	Verb	Verb
bilmeyen	bil	Verb	Adj
anlaşılamayan	anlaş	Verb	Adj
dönmeyeceğinden	dön	Verb	Noun
bilememelerinden	bil	Verb	Noun
kurmadığım	kur	Verb	Adj
istemez	iste	Verb	Verb
bozmadı	boz	Verb	Verb
yanılmıyordum	yanıl	Verb	Verb
kalamazdım	kal	Verb	Verb
edilmemiş	et	Verb	Verb
duramayacak	dur	Verb	Adj
gözükmüyordu	gözük	Verb	Verb
beklenmeyen	bekle	Verb	Adj
tanımadığım	tanı	Verb	Adj
yeltenmez	yelten	Verb	Verb
bilinmeyen	bil	Verb	Adj
bilmeyecek	bil	Verb	Verb
yapmasaydınız	yap	Verb	Verb
gelmeyecekti	gel	Verb	Verb
tanımıyordum	tanı	Verb	Verb
bilmediğimi	bil	Verb	Noun
gelmedi	gel	Verb	Verb
dokunmamış	doku	Verb	Verb
sayılmam	say	Verb	Verb
beceremem	becer	Verb	Verb
söylemediniz	söyle	Verb	Verb
bilemez	bil	Verb	Verb
hoşlanmadım	hoşlan	Verb	Verb
sevmemiştir	sev	Verb	Verb
tanışmadım	tanış	Verb	Verb
tanımadığınız	tanı	Verb	Noun
kovmamalıydı	kov	Verb	Verb
sevmiyor	sev	Verb	Verb
etmemek	et	Verb	Noun
yakışmazdı	yakış	Verb	Verb
görmemeye	gör	Verb	Noun
darılmayın	darıl	Verb	Verb
esirgemezdi	esirge	Verb	Verb
bilemezsiniz	bil	Verb	Verb
söylemiyorsunuz	söyle	Verb	Verb
bilemiyorum	bil	Verb	Verb
hissetmemiştim	hisset	Verb	Verb
dayanamadım	dayan	Verb	Verb
duymam	duy	Verb	Verb
etmedim	et	Verb	Verb
etmeyelim	et	Verb	Verb
göremeyecek	gör	Verb	Verb
yapamam	yap	Verb	Verb
yapamayacağımı	yap	Verb	Noun
yaşamama	yaşa	Verb	Noun
bilmezsiniz	bil	Verb	Verb
vazgeçiremeyeceğimi	vazgeç	Verb	Noun
gelmemem	gel	Verb	Noun
düşünmeyin	düşün	Verb	Verb
gelmem	gel	Verb	Verb
darılmam	darıl	Verb	Verb
geçmez	geç	Verb	Verb
varmayın	var	Verb	Verb
sanmayın	san	Verb	Verb
vermezdim	ver	Verb	Verb
bulunmayacağım	bulun	Verb	Verb
kalkmayın	kalk	Verb	Verb
yadırgamayın	yadırga	Verb	Verb
edemezsin	et	Verb	Verb
atamazlardı	at	Verb	Verb
değildin	değil	Verb	Verb
yıkılmamıştı	yık	Verb	Verb
atılmamıştı	at	Verb	Verb
satmamıştım	sat	Verb	Verb
yaramaz	yara	Verb	Verb
ayrılmaz	ayır	Verb	Verb
vuramamıştı	vur	Verb	Verb
sinirlenmemişti	sinir	Noun	Verb
veremezdi	ver	Verb	Verb
göstermezdi	göster	Verb	Verb
bilmemekle	bil	Verb	Noun
söyleyemiyordu	söyle	Verb	Verb
yapmazdı	yap	Verb	Verb
hissetmiyordu	hisset	Verb	Verb
boylamamıştı	boyla	Verb	Verb
dinlemiyor	dinle	Verb	Verb
ayırmamak	ayır	Verb	Noun
çıkamıyordu	çık	Verb	Verb
bilmiyordum	bil	Verb	Verb
konuşmadı	konuş	Verb	Verb
anlamaz	anla	Verb	Verb
göremedim	gör	Verb	Verb
uğramıyor	uğra	Verb	Verb
ayırmayan	ayır	Verb	Adj
çalışmıyordu	çalış	Verb	Verb
yaramazdım	yar	Verb	Verb
yiyemediğim	ye	Verb	Noun
bahsetmediniz	bahset	Verb	Verb
olmadı	ol	Verb	Verb
bilmiyorsun	bil	Verb	Verb
tanımazsın	tanı	Verb	Verb
bilemedin	bil	Verb	Verb
götüremeyecek	götür	Verb	Verb
götürmememiz	götür	Verb	Noun
yakışmıyor	yakış	Verb	Verb
unutmayacaktı	unut	Verb	Verb
tanımazdım	tanı	Verb	Verb
hoşlanmayacağını	hoşlan	Verb	Noun
gelemem	gel	Verb	Verb
satamam	sat	Verb	Verb
almıyorsun	al	Verb	Verb
inmem	in	Verb	Verb
götüremem	götür	Verb	Verb
anlamıyorsun	anla	Verb	Verb
anlayamazsın	anla	Verb	Verb
anlatmayacak	anla	Verb	Verb
gülmediler	gül	Verb	Verb
gülemediler	gül	Verb	Verb
başlayamayız	başla	Verb	Verb
kalmasa	kal	Verb	Verb
zannetmem	zannet	Verb	Verb
bilmezsek	bil	Verb	Verb
yaşayamazsın	yaşa	Verb	Verb
tutmayan	tut	Verb	Adj
yakışmaz	yakış	Verb	Verb
düşünmemelisin	düşün	Verb	Verb
olmazmış	ol	Verb	Verb
durmazlar	dur	Verb	Verb
anlatmıyor	anla	Verb	Verb
uyutmazlar	uyu	Verb	Verb
istemedi	iste	Verb	Verb
iliklemeyen	ilikle	Verb	Adj
karışamaz	karış	Verb	Verb
alamadım	al	Verb	Verb
hoşlanmazdı	hoşlan	Verb	Verb
görmemiştim	gör	Verb	Verb
görünmeyen	görün	Verb	Adj
oturmam	otur	Verb	Verb
bulamıyoruz	bul	Verb	Verb
görünmez	görün	Verb	Verb
evlenemeyeceğini	evlen	Verb	Noun
görmedi	gör	Verb	Verb
ilgilenmiyordu	ilgilen	Verb	Verb
denemezdi	de	Verb	Verb
düşünemiyordum	düşün	Verb	Verb
bulamayacaktı	bul	Verb	Verb
bulamadığını	bul	Verb	Noun
ilgilenmedi	ilgilen	Verb	Verb
kullanılmayan	kullan	Verb	Adj
erimemişti	eri	Verb	Verb
göremiyordum	gör	Verb	Verb
bilmiyormuş	bil	Verb	Verb
çaktırmasınlar	çak	Verb	Verb
yapmaması	yap	Verb	Noun
edemeyeceğine	et	Verb	Noun
edemeyiz	et	Verb	Verb
bilmedi	bil	Verb	Verb
öğrenemeyecek	öğren	Verb	Verb
gelmemesi	gel	Verb	Noun
ağlamıyorsun	ağla	Verb	Verb
ağlamayacağım	ağla	Verb	Verb
görünmeyecek	görün	Verb	Verb
olamayacağını	ol	Verb	Noun
değişmemişti	değiş	Verb	Verb
sanmıyorum	san	Verb	Verb
oynayamaz	oyna	Verb	Verb
istemiyorsun	iste	Verb	Verb
aydınlatmıyordu	aydınlat	Verb	Verb
edememişti	et	Verb	Verb
bilemedim	bil	Verb	Verb
görünmüyorum	görün	Verb	Verb
beklenemez	bekle	Verb	Verb
kıyamam	kıy	Verb	Verb
durmadı	dur	Verb	Verb
düşünmemek	düşün	Verb	Noun
bağlamaz	bağla	Verb	Verb
olmasaydım	ol	Verb	Verb
çekmeme	çek	Verb	Noun
durmamıştık	dur	Verb	Verb
kaynaşmaz	kaynaş	Verb	Verb
gelmiyor	gel	Verb	Verb
anlaşılmaz	anlaş	Verb	Verb
şaşırmadım	şaşır	Verb	Verb
gösteremedikleri	göster	Verb	Noun
edemezler	et	Verb	Verb
dokunmuyordu	doku	Verb	Verb
çıkarmıyordum	çık	Verb	Verb
görmem	gör	Verb	Verb
tırmanmam	tırman	Verb	Verb
olamayıp	ol	Verb	Verb
bulunmayan	bulun	Verb	Adj
etmemiştim	et	Verb	Verb
görünmese	görün	Verb	Verb
şaşırmamıştım	şaşır	Verb	Verb
vuramadı	vur	Verb	Verb
olmasam	ol	Verb	Verb
kapanmayacağına	kapa	Verb	Noun
veremeyeceğini	ver	Verb	Noun
atmadım	at	Verb	Verb
inanılmaz	inan	Verb	Verb
istemeyeceğinden	iste	Verb	Noun
bahsedilmedi	bahset	Verb	Verb
anlaşılmamıştı	anlaş	Verb	Verb
görmesin	gör	Verb	Verb
gitmeme	git	Verb	Noun
güzelleşmiyor	güzel	Adj	Verb
anlaşılamıyordu	anlaş	Verb	Verb
olmasaydı	ol	Verb	Verb
güvenmiyordum	güven	Verb	Verb
kesilmiyor	kes	Verb	Verb
konuşamazmış	konuş	Verb	Verb
alamazsınız	al	Verb	Verb
işlemediğini	işle	Verb	Noun
girmedi	gir	Verb	Verb
sığmaz	sığ	Verb	Verb
edilmezler	et	Verb	Verb
getirilmezlerse	getir	Verb	Verb
bulunmadığı	bulun	Verb	Noun
olmadıklarını	ol	Verb	Noun
görmediklerini	gör	Verb	Noun
bitirmez	bit	Verb	Verb
dinlememeye	dinle	Verb	Noun
çıkarmamamı	çık	Verb	Noun
değildim	değil	Verb	Verb
kalmayarak	kal	Verb	Verb
inmedim	in	Verb	Verb
olmaması	ol	Verb	Noun
sayılmazsa	say	Verb	Verb
edilemiyor	et	Verb	Verb
kullanmamaya	kullan	Verb	Noun
söylememeye	söyle	Verb	Noun
bulamadığı	bula	Verb	Noun
dayanamadığı	daya	Verb	Noun
yitirmeyen	yit	Verb	Adj
kopartmamış	kop	Verb	Verb
vazgeçilmez	vazgeç	Verb	Verb
saklamadı	sakla	Verb	Verb
sergilemese	sergile	Verb	Verb
giremeyişinden	gir	Verb	Noun
istenmez	iste	Verb	Verb
benimsemedi	benimse	Verb	Verb
bakılmamış	bak	Verb	Verb
tanımlama	tanımla	Verb	Verb
bırakmayan	bırak	Verb	Adj
edinmeyen	edin	Verb	Adj
alışmadıkça	alış	Verb	Verb
atamayacağız	at	Verb	Verb
bulamamış	bul	Verb	Verb
yaşanmamış	yaşa	Verb	Verb
edemedikleri	et	Verb	Noun
ayrılmayarak	ayır	Verb	Verb
çarpmaz	çarp	Verb	Verb
tartışamazdı	tartış	Verb	Verb
olmamalarına	ol	Verb	Noun
anlamadıkları	anla	Verb	Adj
karışamayarak	karış	Verb	Verb
sevmezdi	sev	Verb	Verb
sezmez	sez	Verb	Verb
istemezdi	iste	Verb	Verb
istemeyeceksin	iste	Verb	Verb
tutmadı	tut	Verb	Verb
ayrılmazdı	ayır	Verb	Verb
dövmez	döv	Verb	Verb
azarlamazdı	azarla	Verb	Verb
okşamazdı	okşa	Verb	Verb
kaldırmasa	kaldır	Verb	Verb
ölmedi	öl	Verb	Verb
dönmedi	dön	Verb	Verb
etmemişti	et	Verb	Verb
yapmamalıydın	yap	Verb	Verb
olmuyor	ol	Verb	Verb
çıkamayan	çık	Verb	Adj
almamış	al	Verb	Verb
bulamadıkları	bula	Verb	Noun
davranmadığını	davran	Verb	Noun
bulmuyorum	bul	Verb	Verb
gelmiyordu	gel	Verb	Verb
anlamadığı	anla	Verb	Adj
gitmiyorsun	git	Verb	Verb
yapmadığı	yap	Verb	Adj
bakmayarak	bak	Verb	Verb
yansıtmadıkları	yansı	Verb	Noun
gelmemişti	gel	Verb	Verb
bulamayarak	bul	Verb	Verb
değmez	değ	Verb	Verb
yaşamadı	yaşa	Verb	Verb
bilmezdi	bil	Verb	Verb
bulamayınca	bula	Verb	Verb
söylemediği	söyle	Verb	Noun
olmamıştı	ol	Verb	Verb
alışmadığı	alış	Verb	Adj
azalmayan	azal	Verb	Adj
söyleyemedi	söyle	Verb	Verb
tanımadığı	tanı	Verb	Adj
söylemeseydin	söyle	Verb	Verb
alıkoyamam	alıkoy	Verb	Verb
bilemeyen	bil	Verb	Adj
bitirilmedi	bit	Verb	Verb
birleştiremezdim	birleş	Verb	Verb
görmediğimden	gör	Verb	Noun
yapmayın	yap	Verb	Verb
olmama	ol	Verb	Noun
ağlamamak	ağla	Verb	Noun
vermedim	ver	Verb	Verb
yaşamayacağını	yaşa	Verb	Noun
hissetmem	hisset	Verb	Verb
bulanmaz	bula	Verb	Verb
kalkışmazsan	kalkış	Verb	Verb
yapamazsan	yap	Verb	Verb
vermesin	ver	Verb	Verb
rastlayamadım	rastla	Verb	Verb
çekmediğini	çek	Verb	Noun
çıkarmadığını	çık	Verb	Noun
anlamıyordum	anla	Verb	Verb
dönmemiş	dön	Verb	Adj
çıkarmadığımı	çık	Verb	Noun
söylememişti	söyle	Verb	Verb
edemiyordum	et	Verb	Verb
ayırmam	ayır	Verb	Verb
bulamayabilirdim	bul	Verb	Verb
dokunulmamış	doku	Verb	Verb
almıyordu	al	Verb	Verb
kaçmadı	kaç	Verb	Verb
olamazsın	ol	Verb	Verb
ölmedin	öl	Verb	Verb
gelmemişse	gel	Verb	Verb
düşünmedim	düşün	Verb	Verb
görmüyordum	gör	Verb	Verb
getirmem	getir	Verb	Verb
ölmeyeceğini	öl	Verb	Noun
öldürmemesi	öl	Verb	Noun
olmamıştır	ol	Verb	Verb
karıştırmam	karış	Verb	Verb
yapılamayacak	yap	Verb	Verb
anlamadım	anla	Verb	Verb
söyletmezsin	söyle	Verb	Verb
anlamadı	anla	Verb	Verb
olmayacaksanız	ol	Verb	Verb
büyütmedim	büyüt	Verb	Verb
soymam	soy	Verb	Verb
yapmama	yap	Verb	Noun
sürtmem	sürt	Verb	Verb
kaybedemezdim	kaybet	Verb	Verb
etmemesini	et	Verb	Noun
gelmedikleri	gel	Verb	Noun
bilmezlerdi	bil	Verb	Verb
ısıtamıyordum	ısıt	Verb	Verb
görmeseydi	gör	Verb	Verb
söylemiyorsun	söyle	Verb	Verb
getirmedin	getir	Verb	Verb
takmadın	tak	Verb	Verb
etmemesinden	et	Verb	Noun
kaçınamayınca	kaçın	Verb	Verb
katılmam	kat	Verb	Verb
yapmazsa	yap	Verb	Verb
beklememesi	bekle	Verb	Noun
ulaşamayacaklarını	ulaş	Verb	Noun
çalamayacağını	çal	Verb	Noun
çalmamasına	çal	Verb	Noun
telaşlanmayacağım	telaş	Noun	Verb
korkmayacak	kork	Verb	Adj
söylemeyeceğim	söyle	Verb	Verb
inandıramam	inan	Verb	Verb
inanmamanızı	inan	Verb	Noun
söylememe	söyle	Verb	Noun
korkmuyorum	kork	Verb	Verb
ermemiştim	er	Verb	Verb
tanıştırılmadı	tanış	Verb	Verb
değilimdir	değil	Verb	Verb
istemediği	iste	Verb	Noun
olmadığım	ol	Verb	Adj
yakalayamıyorum	yakala	Verb	Verb
görünemiyorum	görün	Verb	Verb
etmiyorlar	et	Verb	Verb
girmiyorum	gir	Verb	Verb
endişelenmeyin	endişe	Noun	Verb
kestiremiyordu	kes	Verb	Verb
bekleyemezsek	bekle	Verb	Verb
tanımadı	tanı	Verb	Verb
konuşmayan	konuş	Verb	Adj
bilemezler	bil	Verb	Verb
keşfedemedi	keşfet	Verb	Verb
dönmemesini	dön	Verb	Noun
etmedik	et	Verb	Verb
olamıyorum	ol	Verb	Verb
örmediniz	ör	Verb	Verb
çağırtmadım	çağır	Verb	Verb
bitmeyeceğini	bit	Verb	Noun
alamadı	al	Verb	Verb
istememesi	iste	Verb	Noun
anlaşılmayacak	anlaş	Verb	Verb
tasalanmayın	tasa	Noun	Verb
koymadığımı	koy	Verb	Noun
çıkarmayın	çık	Verb	Verb
kabartmaz	kabar	Verb	Verb
zannetmeyin	zannet	Verb	Verb
demezler	de	Verb	Verb
bitirmedim	bit	Verb	Verb
çaktırmamak	çak	Verb	Noun
etmemesi	et	Verb	Noun
şüphelenmemeli	şüphe	Noun	Verb
demez	de	Verb	Verb
yemem	ye	Verb	Verb
lekelememek	lekele	Verb	Noun
unutamaz	unut	Verb	Verb
unutmazlar	unut	Verb	Verb
yapmadı	yap	Verb	Verb
bayılmadı	bayıl	Verb	Verb
doymasın	doy	Verb	Verb
bakma	bak	Verb	Verb
duymuyor	duy	Verb	Verb
olamamak	ol	Verb	Noun
alamadılar	al	Verb	Verb
kalmasınlar	kal	Verb	Verb
hoşlanmam	hoşlan	Verb	Verb
göndermedi	gönder	Verb	Verb
yanaşamadığı	yanaş	Verb	Adj
erdiremez	er	Verb	Verb
yaramazdı	yara	Verb	Verb
göstermedi	göster	Verb	Verb
kirletmeyecek	kirlet	Verb	Verb
anlamamıştım	anla	Verb	Verb
anımsamıyordum	anımsa	Verb	Verb
olmazdım	ol	Verb	Verb
istemeyerek	iste	Verb	Verb
kovmayacağım	kov	Verb	Verb
getiremedim	getir	Verb	Verb
anlamam	anla	Verb	Verb
beklemeyin	bekle	Verb	Verb
değiliz	değil	Verb	Verb
titrememesine	titre	Verb	Noun
konuşmamışımdır	konuş	Verb	Verb
istemedim	iste	Verb	Verb
gitmedi	git	Verb	Verb
edemesem	et	Verb	Verb
konuşamazdım	konuş	Verb	Verb
düşmemek	düş	Verb	Noun
kalmasın	kal	Verb	Verb
duymazdım	duy	Verb	Verb
görmediğim	gör	Verb	Noun
beklemiyordun	bekle	Verb	Verb
kullanmayacaksa	kullan	Verb	Verb
bulmasaydı	bul	Verb	Verb
ayıramıyorum	ayır	Verb	Verb
çekmem	çek	Verb	Verb
gelmeyecek	gel	Verb	Verb
konuşmamak	konuş	Verb	Noun
bırakmamam	bırak	Verb	Noun
yaşamam	yaşa	Verb	Verb
görünmeyecekti	görün	Verb	Verb
istemediğini	iste	Verb	Noun
düşünülmüyordu	düşün	Verb	Verb
gidemezdim	git	Verb	Verb
bilememiştim	bil	Verb	Verb
yapılamazdı	yap	Verb	Verb
sokmamak	sok	Verb	Noun
uyandırmamak	uyan	Verb	Noun
çıkarmadı	çık	Verb	Verb
görmedik	gör	Verb	Verb
bulamadık	bul	Verb	Verb
almadığını	al	Verb	Noun
dönmediğinden	dön	Verb	Noun
önemsememişti	önemse	Verb	Verb
bilmediğim	bil	Verb	Adj
istemezsen	iste	Verb	Verb
bitiremedim	bit	Verb	Verb
girmezdi	gir	Verb	Verb
içemeseydim	iç	Verb	Verb
binmeyecek	bin	Verb	Verb
konuşmayacağım	konuş	Verb	Verb
tanınmayıp	tanı	Verb	Verb
yakalanmamanız	yakala	Verb	Noun
bakmadım	bak	Verb	Verb
bahsetmeyin	bahset	Verb	Verb
söylemezse	söyle	Verb	Verb
dönmeyeceğim	dön	Verb	Verb
korkmam	kork	Verb	Verb
tutmazsa	tut	Verb	Verb
söylemeyecekti	söyle	Verb	Verb
görmediklerinden	gör	Verb	Noun
çıkamadım	çık	Verb	Verb
açmaması	aç	Verb	Noun
söyleme	söyle	Verb	Verb
edemiyorum	et	Verb	Verb
bakmıyordu	bak	Verb	Verb
girmeyeceğim	gir	Verb	Verb
bırakmamamı	bırak	Verb	Noun
kakmayacaksın	kak	Verb	Verb
doğmamayı	doğ	Verb	Noun
kalmazsam	kal	Verb	Verb
etmeyeceği	et	Verb	Noun
biçilmez	biç	Verb	Verb
çıkmıyorsun	çık	Verb	Verb
dağıtılmıyor	dağıt	Verb	Verb
gidemem	git	Verb	Verb
vermeyecek	ver	Verb	Verb
gitmemeyi	git	Verb	Noun
düşünmemiştim	düşün	Verb	Verb
edilmemek	et	Verb	Noun
bulamadılar	bul	Verb	Verb
bulamıyorlardı	bul	Verb	Verb
bakmadın	bak	Verb	Verb
bulamamıştı	bul	Verb	Verb
bulmamıştı	bul	Verb	Verb
satmamasını	sat	Verb	Noun
açmadı	aç	Verb	Verb
koymaz	koy	Verb	Verb
taranmamış	tara	Verb	Verb
kaybetmeseydi	kaybet	Verb	Verb
tanımamış	tanı	Verb	Verb
görüşmeyeli	görüş	Verb	Verb
etmemiştin	et	Verb	Verb
yanmamıştı	yan	Verb	Verb
görmedikleri	gör	Verb	Adj
keşfedilmemiş	keşfet	Verb	Verb
girmemiş	gir	Verb	Verb
değmemiş	değ	Verb	Verb
işlenmemiş	işle	Verb	Adj
karışmayan	karış	Verb	Adj
öğrenemedi	öğren	Verb	Verb
anlamamış	anla	Verb	Verb
hissetmemişti	hisset	Verb	Verb
olmadım	ol	Verb	Verb
arzulamıyordu	arzula	Verb	Verb
olamazdı	ol	Verb	Verb
çıkartamadığı	çık	Verb	Noun
satmamaya	sat	Verb	Noun
getirmeyin	getir	Verb	Verb
açmayın	aç	Verb	Verb
değişmiyor	değiş	Verb	Verb
uğraşmıyorsunuz	uğraş	Verb	Verb
olmuyorsunuz	ol	Verb	Verb
gitmez	git	Verb	Verb
diyemem	de	Verb	Verb
uyumadı	uyu	Verb	Verb
söylenemez	söyle	Verb	Verb
vazgeçmediği	vazgeç	Verb	Noun
yaşlanmamıştı	yaş	Noun	Verb
olgunlaşmadığına	olgun	Adj	Noun
yemiyorsunuz	ye	Verb	Verb
olmadığımızı	ol	Verb	Noun
istemeyeceğim	iste	Verb	Verb
tekrarlatmadı	tekrarla	Verb	Verb
yemiyordu	ye	Verb	Verb
içmiyordu	iç	Verb	Verb
demem	de	Verb	Verb
bitirmemişti	bit	Verb	Verb
çekinmeyin	çekin	Verb	Verb
bakmaz	bak	Verb	Verb
bulamazdım	bul	Verb	Verb
yollamadım	yolla	Verb	Verb
yanaşmayacağımı	yanaş	Verb	Noun
gelmesin	gel	Verb	Verb
etmesin	et	Verb	Verb
görmezler	gör	Verb	Verb
anlayamıyor	anla	Verb	Verb
yapmadım	yap	Verb	Verb
evlenmediği	evlen	Verb	Noun
veremezdim	ver	Verb	Verb
karşılaşmaması	karşılaş	Verb	Noun
korkmadığınız	kork	Verb	Noun
utanmadınız	utan	Verb	Verb
koymadınız	koy	Verb	Verb
içmeyecek	iç	Verb	Verb
ödememe	öde	Verb	Noun
vermezsiniz	ver	Verb	Verb
anlatmayacağım	anlat	Verb	Verb
yıkmaması	yık	Verb	Noun
yatmamış	yat	Verb	Verb
tanımamıştı	tanı	Verb	Verb
düşünemez	düşün	Verb	Verb
konuşamazdı	konuş	Verb	Verb
anlatamayınca	anla	Verb	Verb
gelememişti	gel	Verb	Verb
söndürmemiştim	sön	Verb	Verb
atamıyordu	at	Verb	Verb
kaybolmuyordu	kaybol	Verb	Verb
anlamadığımı	anla	Verb	Noun
geçmediğini	geç	Verb	Noun
çekmemiş	çek	Verb	Verb
durmadığım	dur	Verb	Adj
anlayamadığım	anla	Verb	Adj
umulmadık	um	Verb	Verb
almaz	al	Verb	Adj
istemeyebilir	iste	Verb	Verb
istemediğinden	iste	Verb	Noun
düşmüyordu	düş	Verb	Verb
gülmemek	gül	Verb	Noun
yapmazsanız	yap	Verb	Verb
anlayamadım	anla	Verb	Verb
görülmez	gör	Verb	Verb
açamadığı	aç	Verb	Adj
söylemeyip	söyle	Verb	Verb
getiremedi	getir	Verb	Verb
ağlamayın	ağla	Verb	Verb
doyamıyormuş	doy	Verb	Verb
ayırmıyordu	ayır	Verb	Verb
neşelenmem	neşe	Noun	Verb
istemiyor	iste	Verb	Verb
dinlemediğimi	dinle	Verb	Noun
sevmediği	sev	Verb	Adj
etmiyordum	et	Verb	Verb
gelemez	gel	Verb	Verb
kırılmadı	kır	Verb	Verb
dokunmadı	doku	Verb	Verb
beklemezler	bekle	Verb	Verb
karşılaşmaman	karşılaş	Verb	Noun
gelmediğimi	gel	Verb	Noun
tanımıyorum	tanı	Verb	Verb
veremedim	ver	Verb	Verb
ulaşmayan	ulaş	Verb	Adj
olmayışı	ol	Verb	Noun
ulaşamayacağı	ulaş	Verb	Noun
vermiyordu	ver	Verb	Verb
kazanamayan	kazan	Verb	Adj
anlayamadığı	anla	Verb	Adj
çalmamış	çal	Verb	Verb
söylenemezdi	söyle	Verb	Verb
paketlememişti	paketle	Verb	Verb
önleyemezdi	önle	Verb	Verb
gitmese	git	Verb	Verb
kaçmazdı	kaç	Verb	Verb
hastalanmamıştı	hastalan	Verb	Verb
çıkmama	çık	Verb	Noun
yetişmeyecek	yetiş	Verb	Verb
inanamayacağı	inan	Verb	Noun
geçirmiyordu	geç	Verb	Verb
olamadığı	ol	Verb	Adj
kestiremediği	kes	Verb	Adj
oynamıyordu	oyna	Verb	Verb
yitirmemesi	yit	Verb	Noun
kalkamayacağını	kalk	Verb	Noun
kalkmadı	kalk	Verb	Verb
yaralanmayacaktı	yarala	Verb	Verb
görmezdi	gör	Verb	Verb
koruyamayacak	koru	Verb	Verb
açmazlar	aç	Verb	Verb
çıkamayacak	çık	Verb	Verb
çekmeyen	çek	Verb	Adj
tutamadığı	tut	Verb	Noun
gelemeyeceğini	gel	Verb	Noun
gitmediğini	git	Verb	Noun
bilmiyoruz	bil	Verb	Verb
çıkmıyor	çık	Verb	Verb
edemezdik	et	Verb	Verb
kımıldamadı	kımılda	Verb	Verb
açıklayamıyorum	açıkla	Verb	Verb
gitmiyordu	git	Verb	Verb
geçirmemişti	geç	Verb	Verb
kalkamadığı	kalk	Verb	Noun
sokmadığı	sok	Verb	Noun
isteyemezdi	iste	Verb	Verb
düşünülemezdi	düşün	Verb	Verb
geçemeyeceğim	geç	Verb	Verb
gelmeyişinizin	gel	Verb	Noun
olamayacağı	ol	Verb	Noun
duymuyorum	duy	Verb	Verb
harcamama	harca	Verb	Noun
öğrenmemesi	öğren	Verb	Noun
olmamalıdır	ol	Verb	Verb
kalkamadım	kalk	Verb	Verb
toparlayamadım	toparla	Verb	Verb
okumamış	oku	Verb	Verb
aldırmıyordu	al	Verb	Verb
duyulmadı	duy	Verb	Verb
anlamıyorlardı	anla	Verb	Verb
benzememesinden	benze	Verb	Noun
güvenemiyordu	güven	Verb	Verb
aldırmıyor	al	Verb	Verb
yuvarlanmamak	yuvarla	Verb	Noun
gözükmeyecek	gözük	Verb	Adj
verememişçesine	ver	Verb	Verb
dinmemişti	de	Verb	Verb
kaybetmeyen	kaybet	Verb	Adj
yaşayamazdım	yaşa	Verb	Verb
çalışamayacak	çalış	Verb	Adj
zorlaştırmayın	zor	Adj	Verb
sevilmez	sev	Verb	Verb
duyulmaz	duy	Verb	Verb
gitmeyin	git	Verb	Verb
başlamaz	başla	Verb	Verb
anlayamıyorlardı	anla	Verb	Verb
anlaşılmadığını	anlaş	Verb	Noun
beceremiyordu	becer	Verb	Verb
gidemediğinin	git	Verb	Noun
etmediği	et	Verb	Adj
geçemeyecek	geç	Verb	Adj
geçmedi	geç	Verb	Verb
vermeyecekti	ver	Verb	Verb
kalmamıştı	kal	Verb	Verb
hoşlanmamıştı	hoşlan	Verb	Verb
duyulmuyordu	duy	Verb	Verb
uygulanmaz	uygula	Verb	Verb
gitmemek	git	Verb	Noun
açılmadı	aç	Verb	Verb
gelmeyeceği	gel	Verb	Noun
engelleyemeyerek	engelle	Verb	Verb
kaldıramamasına	kal	Verb	Noun
sığamayacak	sığ	Verb	Adj
aydınlanmamışken	aydınlan	Verb	Verb
göremedi	gör	Verb	Verb
tutamayıp	tut	Verb	Verb
sürmediğini	sür	Verb	Noun
yenmez	yen	Verb	Verb
dokunmayacağını	doku	Verb	Noun
çekmiyordu	çek	Verb	Verb
olamayan	ol	Verb	Adj
dokunmadığı	dokun	Verb	Adj
dönmez	dön	Verb	Verb
anlaşılmadığı	anlaş	Verb	Noun
düşünmüyordu	düşün	Verb	Verb
yemediğinde	ye	Verb	Noun
öğrenemiyorsa	öğren	Verb	Verb
almayan	al	Verb	Adj
bırakılamayacağından	bırak	Verb	Noun
istememiş	iste	Verb	Verb
anlatmayacağına	anla	Verb	Noun
içmiyorlardı	iç	Verb	Verb
vermeyince	ver	Verb	Verb
açılmıyordu	aç	Verb	Verb
kalmadığını	kal	Verb	Noun
sormamıştı	sor	Verb	Verb
yaşanamadılar	yaşa	Verb	Verb
düşünülemeyecek	düşün	Verb	Verb
hoşlanmazlardı	hoşlan	Verb	Verb
veremiyor	ver	Verb	Verb
ilgilenmediği	ilgilen	Verb	Noun
dokunulmayan	doku	Verb	Adj
harcanmamış	harca	Verb	Verb
dokunulmaması	doku	Verb	Noun
edilemez	et	Verb	Verb
ezilmeyecekti	ez	Verb	Verb
girmez	gir	Verb	Verb
görmemesi	gör	Verb	Noun
girmeseydi	gir	Verb	Verb
olmayacaktı	ol	Verb	Verb
girmemekle	gir	Verb	Noun
dayanamayacağını	daya	Verb	Noun
kaçmamak	kaç	Verb	Noun
göremeyecekti	gör	Verb	Verb
giremediler	gir	Verb	Verb
üzmemek	üz	Verb	Noun
yapamazdı	yap	Verb	Verb
edemezdi	et	Verb	Verb
bitiremezlerdi	bit	Verb	Verb
bilmiyorlardı	bil	Verb	Verb
anlamadığından	anla	Verb	Noun
sağlayamadığı	sağla	Verb	Noun
geçiremediği	geç	Verb	Adj
olmadıkça	ol	Verb	Verb
anlayamazlar	anla	Verb	Verb
olmadığınız	ol	Verb	Adj
vermezdi	ver	Verb	Verb
olmasaydınız	ol	Verb	Verb
bilemediğim	bil	Verb	Adj
çekilmez	çek	Verb	Verb
kızamıyorum	kız	Verb	Verb
dayanamayıp	dayan	Verb	Verb
anlatmıyorsunuz	anla	Verb	Verb
uyumamış	uyu	Verb	Verb
anlayamamıştım	anla	Verb	Verb
uymuyor	uy	Verb	Verb
beğenmediğinizi	beğen	Verb	Noun
söyleyemezsiniz	söyle	Verb	Verb
bulamıyordum	bul	Verb	Verb
gelmeyişi	gel	Verb	Noun
kaçırmadım	kaç	Verb	Verb
gelemezdi	gel	Verb	Verb
üzülmeyin	üz	Verb	Verb
olmayabilir	ol	Verb	Verb
geçmemiştir	geç	Verb	Verb
yapmaz	yap	Verb	Verb
anlamamak	anla	Verb	Noun
olmuyorlar	ol	Verb	Verb
aktarmıyoruz	aktar	Verb	Verb
ulaşılmaz	ulaş	Verb	Verb
sarsılmaz	sars	Verb	Verb
söylenmemiş	söyle	Verb	Verb
kalmam	kal	Verb	Verb
olmadığınızı	ol	Verb	Noun
dilemiyorum	dil	Verb	Verb
yanılmayız	yan	Verb	Verb
bilemezsin	bil	Verb	Verb
duramaz	dur	Verb	Verb
duymadığım	duy	Verb	Adj
görüşmediniz	görüş	Verb	Verb
kaldıramayacak	kal	Verb	Verb
çalışmayın	çalış	Verb	Verb
konuşamıyordu	konuş	Verb	Verb
tanımamışım	tanı	Verb	Verb
getiremezdim	getir	Verb	Verb
gelmeyeceksin	gel	Verb	Verb
istemiyorsa	iste	Verb	Verb
yazmadı	yaz	Verb	Verb
almamıştır	al	Verb	Verb
davranılmaz	davran	Verb	Verb
demeyin	de	Verb	Verb
sevmiyorum	sev	Verb	Verb
davranmazdınız	davran	Verb	Verb
bırakmazdınız	bırak	Verb	Verb
oynamazdınız	oyna	Verb	Verb
geçiremediğini	geç	Verb	Noun
zaptedemez	zaptet	Verb	Verb
bastıramadım	bas	Verb	Verb
yetmiyor	yet	Verb	Verb
duramayacağım	dur	Verb	Verb
zaptedemiyordum	zaptet	Verb	Verb
gerçekleşmeyeceğini	gerçek	Adj	Noun
yapamayacağım	yap	Verb	Verb
beklemediğim	bekle	Verb	Adj
incitemem	incit	Verb	Verb
üzemem	üz	Verb	Verb
oturmayacağım	otur	Verb	Verb
duramam	dur	Verb	Verb
göremeyeceksiniz	gör	Verb	Verb
öğrenemeyecektiniz	öğren	Verb	Verb
tutamadım	tut	Verb	Verb
kovamazsınız	kov	Verb	Verb
kovmuyorsunuz	kov	Verb	Verb
dayanamazdım	daya	Verb	Verb
yaramıyordu	yara	Verb	Verb
yapamadım	yap	Verb	Verb
uzlaşamadı	uzlaş	Verb	Verb
vermediler	ver	Verb	Verb
etkilemedi	etkile	Verb	Verb
direnmeme	diren	Verb	Noun
açmayacak	aç	Verb	Adj
ölmez	öl	Verb	Verb
duymamıştı	duy	Verb	Verb
yeşermemesi	yeşer	Verb	Noun
vazgeçmiyorlardı	vazgeç	Verb	Verb
anlatmıyordu	anla	Verb	Verb
evlenmemiş	evlen	Verb	Adj
olmamakla	ol	Verb	Noun
beslenmiyor	besle	Verb	Verb
edemese	et	Verb	Verb
çalışamadı	çalış	Verb	Verb
bulamıyordu	bula	Verb	Verb
önemsemiyordu	önemse	Verb	Verb
beklemesin	bekle	Verb	Verb
alamadığınız	al	Verb	Adj
bilemem	bil	Verb	Verb
kabullenmemişti	kabullen	Verb	Verb
koyamamış	koy	Verb	Verb
gelmemezlik	gel	Verb	Noun
görmüyordu	gör	Verb	Verb
vermedikçe	ver	Verb	Verb
gelmeyişinden	gel	Verb	Noun
gönderemediğim	gönder	Verb	Noun
gitmeyen	git	Verb	Adj
taşımadığı	taşı	Verb	Noun
bitmemiş	bit	Verb	Verb
ilerleyemiyor	ilerle	Verb	Verb
ilerlemem	ilerle	Verb	Verb
önemsemez	önemse	Verb	Verb
evlenmemeli	evlen	Verb	Verb
veremediği	ver	Verb	Noun
görüştürülmemesi	görüş	Verb	Noun
çürütmeyin	çürü	Verb	Verb
çıkaramayacağınızdan	çık	Verb	Noun
koyamıyorsanız	koy	Verb	Verb
göstermeyin	göster	Verb	Verb
gerçekleştiremediği	gerçek	Adj	Adj
konmayacaktır	kon	Verb	Verb
karıştırılmam	karış	Verb	Verb
olmayacağım	ol	Verb	Verb
bulunamayacaksınız	bul	Verb	Verb
çıkmamalı	çık	Verb	Verb
görüştürülmeyenlerin	görüş	Verb	Noun
gerçekleştiremeyeceği	gerçek	Adj	Noun
bulamazsınız	bul	Verb	Verb
kıpırdatamazsınız	kıpırda	Verb	Verb
yararlanamayacağı	yarar	Noun	Noun
erişilemiyor	eriş	Verb	Verb
uyandırmayacağından	uyan	Verb	Noun
göremiyorum	gör	Verb	Verb
katılamıyorum	kat	Verb	Verb
olmamasını	ol	Verb	Noun
erişilemez	eriş	Verb	Verb
olmayabilirsiniz	ol	Verb	Verb
bağlanamıyorum	bağla	Verb	Verb
bağlanamıyor	bağla	Verb	Verb
yapamazsınız	yap	Verb	Verb
çalıştırılamayacağını	çalış	Verb	Noun
görüntülenmez	görüntüle	Verb	Verb
kullanılamamasına	kullan	Verb	Noun
ayarlamaz	ayarla	Verb	Verb
vermez	ver	Verb	Verb
görüntüleyemeyebilirsiniz	görüntüle	Verb	Verb
vermemesidir	ver	Verb	Verb
değiştiremezsiniz	değiş	Verb	Verb
ayarlanamaz	ayarla	Verb	Verb
planlamadığınız	planla	Verb	Adj
içermediğinde	içer	Verb	Noun
istemiyorsanız	iste	Verb	Verb
gerekmez	gerek	Verb	Verb
istemediğiniz	iste	Verb	Adj
görüntülenmiyorsa	görüntüle	Verb	Verb
kaldırılmaz	kal	Verb	Verb
kullanılamaz	kullan	Verb	Verb
sağlamıyorsa	sağla	Verb	Verb
karşılamıyorsa	karşıla	Verb	Verb
görüntülemez	görüntüle	Verb	Verb
görüntüleyemezsiniz	görüntüle	Verb	Verb
bağlanmamış	bağla	Verb	Verb
kullanılamıyor	kullan	Verb	Verb
göremezseniz	gör	Verb	Verb
etkilemez	etkile	Verb	Adj
kullanılamıyorsa	kullan	Verb	Verb
kullanamazsınız	kullan	Verb	Verb
görüntülenmemesi	görüntüle	Verb	Noun
gösterilmeyen	göster	Verb	Adj
tamamlayamazsınız	tamamla	Verb	Verb
işaretlemediyseniz	işaretle	Verb	Verb
eklenmez	ekle	Verb	Verb
koymamanız	koy	Verb	Noun
seçmeyin	seç	Verb	Verb
seçilmediği	seç	Verb	Noun
vermeyen	ver	Verb	Adj
sıfırlamayın	sıfırla	Verb	Verb
verilmez	ver	Verb	Verb
bırakılmadığından	bırak	Verb	Noun
silmez	sil	Verb	Verb
devralmaz	devral	Verb	Verb
kurtarılamaz	kurtar	Verb	Verb
silinemez	sil	Verb	Verb
atanmazsa	ata	Verb	Verb
erişemiyorum	eriş	Verb	Verb
açmamanız	aç	Verb	Noun
gerektirmediği	gerek	Verb	Noun
gerçekleşmeyen	gerçek	Adj	Adj
denenmez	dene	Verb	Verb
ayrılmamış	ayır	Verb	Adj
genişletemezsiniz	genişle	Verb	Verb
yapılmayacaksa	yap	Verb	Verb
bağlanmayacaksa	bağla	Verb	Verb
onarılmayacaksa	onar	Verb	Verb
takılmayacaksa	tak	Verb	Verb
silmeyin	sil	Verb	Verb
erişemezsiniz	eriş	Verb	Verb
belirtilmezse	belir	Verb	Verb
biçimlendirmedikçe	biçim	Noun	Verb
içermiyorsa	içer	Verb	Verb
bağlanmaz	bağla	Verb	Verb
atanmaz	ata	Verb	Verb
duymuyorsanız	duy	Verb	Verb
içermez	içer	Verb	Verb
ayarlayamazsınız	ayarla	Verb	Verb
verilmediği	ver	Verb	Noun
engellenmediği	engelle	Verb	Noun
kullanamıyorsa	kullan	Verb	Verb
kurulmaz	kur	Verb	Verb
kaydolamıyorum	kaydol	Verb	Verb
kullanamıyorum	kullan	Verb	Verb
kullanılamıyordur	kullan	Verb	Verb
alınamamasından	al	Verb	Noun
seçemezsiniz	seç	Verb	Verb
bağlanamaz	bağla	Verb	Verb
kaldıramazsınız	kal	Verb	Verb
kullanmayın	kullan	Verb	Verb
çıkamaz	çık	Verb	Verb
yenileyemez	yenile	Verb	Verb
deneyemezsiniz	dene	Verb	Verb
olmadığında	ol	Verb	Noun
görüntülenmeyeceğini	görüntüle	Verb	Noun
kullanılmadığından	kullan	Verb	Noun
etkinleştirilmemiş	etkin	Adj	Verb
görüntülenmiyor	görüntüle	Verb	Verb
oluşamaz	oluş	Verb	Verb
silinmemiş	sil	Verb	Verb
gerektirmez	gerek	Verb	Verb
bulunmasa	bulun	Verb	Verb
içermediğine	içer	Verb	Noun
değiştiremeyeceğini	değiş	Verb	Noun
bırakılmadığını	bırak	Verb	Noun
bırakılamaz	bırak	Verb	Verb
açamayacağı	aç	Verb	Noun
kullanılmaz	kullan	Verb	Verb
silinmez	sil	Verb	Verb
duymayacağınızdan	duy	Verb	Noun
eklenemez	ekle	Verb	Verb
kapsamadığı	kapsa	Verb	Noun
önerilmez	öner	Verb	Verb
istenmeyen	iste	Verb	Adj
vermediği	ver	Verb	Adj
açmadıysanız	aç	Verb	Verb
etkinleştirmezseniz	etkin	Adj	Verb
denetlenmez	denetle	Verb	Adj
engellemez	engelle	Verb	Verb
görmüyorsanız	gör	Verb	Verb
açılmıyorsa	aç	Verb	Verb
alınmaz	alın	Verb	Verb
düzeltemezsiniz	düzel	Verb	Verb
görüntülenmezse	görüntüle	Verb	Verb
tanımayabilir	tanı	Verb	Verb
ekleyemiyorum	ekle	Verb	Verb
yapmamanız	yap	Verb	Noun
gönderilmemiş	gönder	Verb	Verb
gideremezsiniz	gider	Verb	Verb
çözülemeyen	çöz	Verb	Adj
görüntüleyemez	görüntüle	Verb	Verb
düzenleyemezsiniz	düzenle	Verb	Verb
yükleyemeyebilir	yükle	Verb	Verb
görüntüleyemeyebilir	görüntüle	Verb	Verb
olmadığınızdan	ol	Verb	Noun
verilmeyen	ver	Verb	Adj
içermeyecektir	içer	Verb	Verb
okuyamaz	oku	Verb	Verb
değiştirilemez	değiş	Verb	Verb
tanıyamazsa	tanı	Verb	Verb
taşıyamazsınız	taşı	Verb	Verb
içermeyen	içer	Verb	Adj
yükseltmediğinize	yüksel	Verb	Noun
ekleyemez	ekle	Verb	Verb
kullanmayarak	kullan	Verb	Verb
zımbalayamayacağınızı	zımbala	Verb	Noun
edemiyorsanız	et	Verb	Verb
karşılaşmazsa	karşılaş	Verb	Verb
yararlanamazsınız	yarar	Noun	Verb
seçmediğim	seç	Verb	Adj
bulunmuyorsa	bulun	Verb	Verb
taşınamaz	taşı	Verb	Verb
kullanılamadığını	kullan	Verb	Noun
görüntülenmemesini	görüntüle	Verb	Noun
kapatmam	kapa	Verb	Verb
sonlandırmam	son	Noun	Verb
sormaması	sor	Verb	Noun
biçimlendirilemez	biçim	Noun	Verb
kaldırmam	kal	Verb	Verb
gerekmediğinden	gerek	Verb	Noun
olmayanları	ol	Verb	Noun
etkilenmez	etkile	Verb	Verb
yaramazsa	yara	Verb	Verb
bulunmamaktaydı	bulun	Verb	Verb
geçmemesini	geç	Verb	Noun
kalmadığı	kal	Verb	Noun
kullanılamayacaktır	kullan	Verb	Verb
giremez	gir	Verb	Verb
seçilmedikçe	seç	Verb	Verb
gerekmeyen	gerek	Verb	Adj
silemezsiniz	sil	Verb	Verb
değilseniz	değil	Verb	Verb
kalmaz	kal	Verb	Verb
yüklenmedi	yükle	Verb	Verb
bulunmuyor	bulun	Verb	Verb
değiştirilmez	değiş	Verb	Verb
yapılmaz	yap	Verb	Verb
yazdırılamayan	yaz	Verb	Adj
sıkmayın	sık	Verb	Verb
kavramayın	kavra	Verb	Verb
kaybolmaması	kaybol	Verb	Noun
görmemesini	gör	Verb	Noun
kalmazsınız	kal	Verb	Verb
kaydettirilmemiştir	kaydet	Verb	Verb
belirlenemez	belirle	Verb	Verb
eklemeyin	ekle	Verb	Verb
yapılandıramadı	yapı	Noun	Verb
çalışmıyor	çalış	Verb	Verb
algılayamıyor	algıla	Verb	Verb
ayarlayamıyor	ayarla	Verb	Verb
değiştiremiyorsunuz	değiş	Verb	Verb
erişemiyorsunuz	eriş	Verb	Verb
desteklenmediğini	destekle	Verb	Noun
gerektirmediğine	gerek	Verb	Noun
yayınlanmayacağını	yayınla	Verb	Noun
bulunamazsa	bulun	Verb	Verb
bulunmayıp	bul	Verb	Verb
sınamadığınız	sın	Verb	Adj
değiştirmemelisiniz	değiş	Verb	Verb
otomatikleştiremediğiniz	otomatik	Adj	Adj
yönetemediğinizde	yönet	Verb	Noun
görmeme	gör	Verb	Noun
gönderilemiyor	gönder	Verb	Verb
görünmemesi	görün	Verb	Noun
edilmeyeceği	et	Verb	Noun
değiştirmeyin	değiş	Verb	Verb
değiştirmez	değiş	Verb	Verb
ayarlanmadığını	ayarla	Verb	Noun
bulunamıyor	bulun	Verb	Verb
görülemiyor	gör	Verb	Verb
göremiyorsanız	gör	Verb	Verb
göstermiyor	göster	Verb	Verb
olmamışsa	ol	Verb	Verb
bulunamadı	bulun	Verb	Verb
kaydedemiyorsanız	kaydet	Verb	Verb
çalışmamasına	çalış	Verb	Noun
çakışmayacağından	çakış	Verb	Noun
kullanılmaması	kullan	Verb	Noun
desteklemiyor	destekle	Verb	Verb
sökemez	sök	Verb	Verb
çıkaramazsınız	çık	Verb	Verb
yapılmadığını	yap	Verb	Noun
bağlanmazsa	bağla	Verb	Verb
çevirmemek	çevir	Verb	Noun
gerekmediği	gerek	Verb	Noun
olmayanlar	ol	Verb	Noun
göremezsiniz	gör	Verb	Verb
desteklenmez	destekle	Verb	Verb
atanamaz	ata	Verb	Verb
saptanamaz	sapta	Verb	Verb
açmadığından	aç	Verb	Noun
yansıtmaz	yansı	Verb	Verb
kaybolmamasını	kaybol	Verb	Noun
güncelleştirmem	güncel	Adj	Verb
kullanmadığınız	kullan	Verb	Adj
seçmediğiniz	seç	Verb	Adj
önermez	öner	Verb	Verb
açamıyorsanız	aç	Verb	Verb
açamazsınız	aç	Verb	Verb
göstermez	göster	Verb	Verb
çalıştıramazsınız	çalış	Verb	Verb
sınırlanmamışsa	sınırla	Verb	Verb
yapılandırılmayacaktır	yapı	Noun	Verb
kaldıramaz	kaldır	Verb	Verb
değiştiremez	değiş	Verb	Verb
oluşturamaz	oluş	Verb	Verb
kapatamaz	kapa	Verb	Verb
çalıştırmamalısınız	çalış	Verb	Verb
şifrelenmediğini	şifrele	Verb	Noun
kopyalamamasını	kopyala	Verb	Noun
listelenmediğini	listele	Verb	Noun
gerekmiyorsa	gerek	Verb	Verb
silmezsiniz	sil	Verb	Verb
bulamıyor	bul	Verb	Verb
görüntülenemeyebileceğini	görüntüle	Verb	Noun
sağlanmadıysa	sağla	Verb	Verb
kopyalanmaz	kopyala	Verb	Verb
kaldıramadım	kal	Verb	Verb
kaldırmadığımı	kal	Verb	Noun
yapmadıysanız	yap	Verb	Verb
ödemezsiniz	öde	Verb	Verb
karışmaz	karış	Verb	Verb
yüklenmezse	yükle	Verb	Verb
yüklenemezse	yükle	Verb	Verb
gerçekleştirilemez	gerçek	Adj	Verb
çalışmadığını	çalış	Verb	Noun
görünmüyorsa	görün	Verb	Verb
sıralayamaz	sırala	Verb	Verb
uygulayamazsınız	uygula	Verb	Verb
doğrulanmadığını	doğrula	Verb	Noun
sağlamaz	sağla	Verb	Verb
desteklemez	destekle	Verb	Verb
tanınmayan	tanı	Verb	Adj
oluşturamazsınız	oluş	Verb	Verb
sıfırlayamaz	sıfırla	Verb	Verb
açamaz	aç	Verb	Verb
vermediğini	ver	Verb	Noun
yönetmiyorsanız	yönet	Verb	Verb
kurtaramazsınız	kurtar	Verb	Verb
dönüştürülemeyen	dönüş	Verb	Adj
görüntülenmediyse	görüntüle	Verb	Verb
bağlanamazsa	bağla	Verb	Verb
sağlanmamış	sağla	Verb	Verb
yerleştirilmez	yerleş	Verb	Verb
desteklemeyen	destekle	Verb	Adj
seçilmediyse	seç	Verb	Verb
kaldırmayın	kal	Verb	Verb
bulunmadığında	bul	Verb	Noun
ekleyemezsiniz	ekle	Verb	Verb
yapılmamalıdır	yap	Verb	Verb
paylaştıramaz	paylaş	Verb	Verb
olmayacağından	ol	Verb	Noun
artmadığını	art	Verb	Noun
eşleşmeyen	eş	Noun	Adj
yapılandırılmamış	yapı	Noun	Verb
kopyalanmamışsa	kopyala	Verb	Verb
göremez	gör	Verb	Verb
atayamazsınız	ata	Verb	Verb
gizlenemez	gizle	Verb	Verb
yazılmaz	yaz	Verb	Verb
kaydedilmez	kaydet	Verb	Verb
edilmemesi	et	Verb	Noun
çözülemeyecek	çöz	Verb	Adj
yönetilemiyor	yönet	Verb	Verb
içermemelidir	içer	Verb	Verb
yapamamasına	yap	Verb	Noun
doğrulanmamış	doğrula	Verb	Adj
uymayan	uy	Verb	Adj
kullanılamayabilir	kullan	Verb	Verb
şifrelenemez	şifrele	Verb	Verb
yapmıyorsa	yap	Verb	Verb
desteklemiyorsa	destekle	Verb	Verb
kaydedilmemiş	kaydet	Verb	Adj
gideremeyeceksiniz	gider	Verb	Verb
dolduramazsınız	dol	Verb	Verb
belirtilmemişse	belir	Verb	Verb
gerçekleşmedi	gerçek	Noun	Verb
sıralanmaz	sırala	Verb	Verb
yapamaz	yap	Verb	Verb
dolmamışsa	dol	Verb	Verb
karşılayamadığı	karşıla	Verb	Adj
çözülemez	çöz	Verb	Verb
şifrelenmemiş	şifrele	Verb	Adj
gerektirmeyebilir	gerek	Verb	Verb
alınamaz	al	Verb	Verb
etkinleştirilmeyeceğini	etkin	Adj	Noun
düzenleyemiyorum	düzenle	Verb	Verb
bulunamadığını	bul	Verb	Noun
seçemiyorum	seç	Verb	Verb
bulunmadığına	bulun	Verb	Noun
gösterilemeyecek	göster	Verb	Adj
yapıştıramıyorum	yapış	Verb	Verb
yapıştırılamadı	yapış	Verb	Verb
bozmayacağından	boz	Verb	Noun
eklemiyor	ekle	Verb	Verb
görmüyorum	gör	Verb	Verb
edilmediğini	et	Verb	Noun
yenilenemiyor	yenile	Verb	Verb
kaydedemiyorum	kaydet	Verb	Verb
yenilemez	ye	Verb	Verb
edilmemektedir	et	Verb	Verb
kullanamadığı	kullan	Verb	Adj
erişemiyor	eriş	Verb	Verb
bozulmaz	boz	Verb	Verb
okuyamıyordur	oku	Verb	Verb
gerçekleştirmez	gerçek	Noun	Verb
döndürülmez	dön	Verb	Verb
istemezseniz	iste	Verb	Verb
içermemesi	içer	Verb	Noun
duymadığınızda	duy	Verb	Noun
ayarlanmamışsa	ayarla	Verb	Verb
bulmaz	bul	Verb	Verb
seçmezseniz	seç	Verb	Verb
eklemedikçe	ekle	Verb	Verb
kaldırmadıkça	kal	Verb	Verb
yüklenmediği	yükle	Verb	Noun
düşünmediğiniz	düşün	Verb	Adj
çözümlenmemiş	çözüm	Noun	Verb
temizleyemezsiniz	temizle	Verb	Verb
taşıyamaz	taşı	Verb	Verb
kesemezsiniz	kes	Verb	Verb
doğrulanamazsa	doğrula	Verb	Verb
doğrulanamayan	doğrula	Verb	Adj
kaydırılmaz	kay	Verb	Verb
içerilmez	içer	Verb	Verb
sıralayamazsınız	sırala	Verb	Verb
almıyor	al	Verb	Verb
değerlendiremiyorsa	değer	Noun	Verb
gerçekleşmezse	gerçek	Adj	Verb
biçimlendirilmediğini	biçim	Noun	Noun
eklenmediğinden	ekle	Verb	Noun
takılmamış	tak	Verb	Verb
gitmediğiniz	git	Verb	Adj
görüntülenmeyebilir	görüntüle	Verb	Verb
kapatmaz	kapa	Verb	Verb
sıkıştırılmamış	sıkış	Verb	Adj
etkinleştirilmedikçe	etkin	Adj	Verb
sağlanmayan	sağla	Verb	Adj
eklenmemiştir	ekle	Verb	Verb
kullanmadıkça	kullan	Verb	Verb
açmam	aç	Verb	Verb
yüklemediyseniz	yükle	Verb	Verb
takmadıysanız	tak	Verb	Verb
çözmezse	çöz	Verb	Verb
yaramadı	yara	Verb	Verb
gideremezse	gider	Verb	Verb
çalışmadığından	çalış	Verb	Noun
kopyalayamıyorum	kopyala	Verb	Verb
değiştiremiyorum	değiş	Verb	Verb
göremeyecektir	gör	Verb	Verb
olmasanız	ol	Verb	Verb
desteklemediğini	destekle	Verb	Noun
gidermezse	gider	Verb	Verb
oluşturulamaz	oluş	Verb	Verb
gruplandırılamaz	grup	Noun	Verb
içermemesini	içer	Verb	Noun
bulmayacağını	bul	Verb	Noun
çalışmıyorsa	çalış	Verb	Verb
kullanmayacaksanız	kullan	Verb	Verb
olmamaktadır	ol	Verb	Verb
kullanmıyorsanız	kullan	Verb	Verb
olmuyorsa	ol	Verb	Verb
atmayın	at	Verb	Verb
iyileştirmezse	iyi	Adj	Verb
taşıyamıyorum	taşı	Verb	Verb
izleyemezler	izle	Verb	Verb
dönüştüremez	dönüş	Verb	Verb
görüntülemeyebilirsiniz	görüntüle	Verb	Verb
sığmayan	sığ	Verb	Adj
yazdırılmaz	yaz	Verb	Verb
görüntülenemez	görüntüle	Verb	Verb
görünmeyebilir	görün	Verb	Verb
yüklenmez	yükle	Verb	Verb
koyamıyorum	koy	Verb	Verb
aktarılmamış	aktar	Verb	Verb
bilmeme	bil	Verb	Noun
istemediğinizde	iste	Verb	Noun
amaçlamıyorsanız	amaçla	Verb	Verb
silmemeniz	sil	Verb	Noun
istemediğim	iste	Verb	Noun
vermemenizi	ver	Verb	Noun
okunmamış	oku	Verb	Verb
eşleşmezse	eş	Noun	Verb
ilişkilendirilmez	ilişki	Noun	Verb
yüklenmemesini	yükle	Verb	Noun
istemeyeceğiniz	iste	Verb	Noun
değiştirmezsiniz	değiş	Verb	Verb
belirleyemezsiniz	belirle	Verb	Verb
yansıtılmaz	yansı	Verb	Verb
kullanmayacak	kullan	Verb	Verb
vermemek	ver	Verb	Noun
hizalanmazsa	hizala	Verb	Verb
çalışmaz	çalış	Verb	Verb
bükmeyin	bük	Verb	Verb
yüklenmediyse	yükle	Verb	Verb
başlayamıyorsanız	başla	Verb	Verb
başlamamaya	başla	Verb	Noun
vermeyin	ver	Verb	Verb
değiştirmemem	değiş	Verb	Noun
eşitlenmez	eşitle	Verb	Verb
yerleştiremezseniz	yerleş	Verb	Verb
desteklenmiyor	destekle	Verb	Verb
saklanmaz	sakla	Verb	Verb
görüntülemeyebilir	görüntüle	Verb	Verb
tıklatmadığınız	tıkla	Verb	Adj
depolanmaz	depola	Verb	Verb
açmaz	aç	Verb	Verb
girmezseniz	gir	Verb	Verb
gönderemiyorum	gönder	Verb	Verb
duymaması	duy	Verb	Noun
görüntülenmeyen	görüntüle	Verb	Adj
göremeyebilirsiniz	gör	Verb	Verb
değiştirmemeye	değiş	Verb	Noun
karşılamıyor	karşıla	Verb	Verb
depolanmazlar	depola	Verb	Verb
dönüştürülemeyebilir	dönüş	Verb	Verb
depolayamazsınız	depola	Verb	Verb
bozmadığından	boz	Verb	Noun
içermediğinden	içer	Verb	Noun
kaydedilemiyorsa	kaydet	Verb	Verb
sürükleyemezsiniz	sürükle	Verb	Verb
gizlenmemesi	gizle	Verb	Noun
görüntülenmemiştir	görüntüle	Verb	Verb
değiştirilmediğini	değiş	Verb	Noun
bilmiyorsanız	bil	Verb	Verb
çevrilemeyen	çevir	Verb	Adj
etmediğini	et	Verb	Noun
çakışmaması	çakış	Verb	Noun
boyutlandırılamaz	boyut	Noun	Verb
hatırlamıyorsanız	hatırla	Verb	Verb
etkilenmezler	etkile	Verb	Verb
edilmeyen	et	Verb	Adj
tanımıyorsanız	tanı	Verb	Verb
kullanmadıysanız	kullan	Verb	Verb
bulamazsa	bul	Verb	Verb
çalışmazsa	çalış	Verb	Verb
alınmadığından	al	Verb	Noun
görmeyen	gör	Verb	Adj
olmayanların	ol	Verb	Noun
etkinleştirilmediyse	etkin	Adj	Verb
başlatmaz	başla	Verb	Verb
vermiyorsa	ver	Verb	Verb
zamanlanmamışsa	zamanla	Verb	Verb
adlandıramazsınız	ad	Noun	Verb
yüklenmemesi	yükle	Verb	Noun
başlatılmaz	başla	Verb	Verb
veremezler	ver	Verb	Verb
algılanmaz	algıla	Verb	Verb
belirtmedikçe	belir	Verb	Verb
başlatamaz	başla	Verb	Verb
kapatmayın	kapa	Verb	Verb
başlatılmamasına	başla	Verb	Noun
başlatılmazsa	başla	Verb	Verb
kullanamaz	kullan	Verb	Verb
yapılandıramazsınız	yapı	Noun	Verb
çalıştırılmamışsa	çalış	Verb	Verb
seçilmezse	seç	Verb	Verb
döndürülmezse	dön	Verb	Verb
azaltmadığını	azal	Verb	Noun
girmeyen	gir	Verb	Adj
kapatılmadığını	kapa	Verb	Noun
çözümlenemeyen	çözümle	Verb	Adj
başlamadığını	başla	Verb	Noun
paylaşılmadı	paylaş	Verb	Verb
çözümleyemiyor	çözümle	Verb	Verb
karşılayamayan	karşıla	Verb	Adj
bırakmayın	bırak	Verb	Verb
doğrulamaz	doğrula	Verb	Verb
gerçekleştirilmezse	gerçek	Adj	Verb
kullanılmadığı	kullan	Verb	Noun
yapılandırılmayan	yapı	Noun	Adj
açmadığı	aç	Verb	Adj
çalışmayacağını	çalış	Verb	Noun
alamaz	al	Verb	Verb
biçimlendiremeyeceklerini	biçim	Noun	Noun
bağlanamayacaklarını	bağla	Verb	Noun
iletilemiyor	ilet	Verb	Verb
gönderilemez	gönder	Verb	Verb
almayacağını	al	Verb	Noun
sıralanmamış	sırala	Verb	Verb
gönderemez	gönder	Verb	Verb
oluşturulmayacağını	oluş	Verb	Noun
uygulamaz	uygula	Verb	Verb
işleyemeyeceği	işle	Verb	Adj
taşıyamazlar	taşı	Verb	Verb
ulaşmadığını	ulaş	Verb	Noun
alınmadığını	alın	Verb	Noun
çalıştırmamanız	çalış	Verb	Noun
kullanmaz	kullan	Verb	Verb
denenmeyeceğinden	dene	Verb	Noun
eklenmedikçe	ekle	Verb	Verb
görünmezler	görün	Verb	Verb
zorlayamaz	zorla	Verb	Verb
engellemezseniz	engelle	Verb	Verb
korunmaz	koru	Verb	Verb
bağlanamadığında	bağla	Verb	Noun
taşınamayan	taşı	Verb	Adj
daraltamazsınız	daral	Verb	Verb
tamamlanmamıştır	tamamla	Verb	Verb
çalışmadığında	çalış	Verb	Noun
gerçekleştirmediği	gerçek	Adj	Adj
gerekmediğini	gerek	Verb	Noun
uygulanamaz	uygula	Verb	Verb
etkinleştirilmez	etkin	Adj	Verb
bırakılmaz	bırak	Verb	Verb
başlatılamaz	başla	Verb	Verb
kaydedilmediğini	kaydet	Verb	Noun
kullanılmadığını	kullan	Verb	Noun
kullanmadığını	kullan	Verb	Noun
yönetemez	yönet	Verb	Verb
silemezler	sil	Verb	Verb
istemeyebilirsiniz	iste	Verb	Verb
olmamasıdır	ol	Verb	Verb
eşitlenmemişse	eşitle	Verb	Verb
gerçekleştiremeyeceğini	gerçek	Adj	Noun
düzenlenemez	düzenle	Verb	Verb
çözülmez	çöz	Verb	Verb
görmeyeceklerinden	gör	Verb	Noun
değiştirilmediğine	değiş	Verb	Noun
edememe	et	Verb	Noun
değerlendirilmez	değer	Noun	Verb
alınamamasına	al	Verb	Noun
anlamamakta	anla	Verb	Noun
etmemektedir	et	Verb	Verb
kullanılmayacaksa	kullan	Verb	Verb
kullanılmamalıdır	kullan	Verb	Verb
düzenlenemediğinden	düzenle	Verb	Noun
tanımlayamazsınız	tanımla	Verb	Verb
sunmaz	sun	Verb	Verb
üretmez	üre	Verb	Verb
kullanmayacağını	kullan	Verb	Noun
kaydetmeyeceğini	kaydet	Verb	Noun
belirtmeyen	belir	Verb	Adj
korumadıklarına	koru	Verb	Noun
içermeyeceğini	içer	Verb	Noun
çıkarılmamalıdır	çık	Verb	Verb
içermeyebilir	içer	Verb	Verb
bitirmem	bit	Verb	Verb
başlatmam	başla	Verb	Verb
çözemiyorum	çöz	Verb	Verb
bulamazsanız	bul	Verb	Verb
kaldırmamanız	kal	Verb	Noun
istemedikleri	iste	Verb	Noun
kıramadı	kır	Verb	Verb
gelmeyen	gel	Verb	Adj
bakamıyoruz	bak	Verb	Verb
uğraşmıyor	uğraş	Verb	Verb
düşünmüyor	düşün	Verb	Verb
unutmuyordu	unut	Verb	Verb
taslamıyor	tasla	Verb	Verb
gitmeyecektik	git	Verb	Verb
çalmamaları	çal	Verb	Noun
yazamadım	yaz	Verb	Verb
bulunmaması	bulun	Verb	Noun
kurtulamadığı	kurtul	Verb	Adj
alamazsan	al	Verb	Verb
bırakmıyor	bırak	Verb	Verb
alınamadı	alın	Verb	Verb
alamayınca	al	Verb	Verb
yapılmamasını	yap	Verb	Noun
gidilmemesi	git	Verb	Noun
takmayanlara	tak	Verb	Noun
yakalanmadıkları	yakala	Verb	Adj
beklemiyordum	bekle	Verb	Verb
kopmayacağım	kop	Verb	Verb
çıkmadım	çık	Verb	Verb
istemiyordum	iste	Verb	Verb
bırakmama	bırak	Verb	Noun
istemediğin	iste	Verb	Noun
seyretmezdim	seyret	Verb	Verb
inanmıyorum	inan	Verb	Verb
almamıştım	al	Verb	Verb
okuyamamış	oku	Verb	Verb
düşmemesi	düş	Verb	Noun
duramazsın	dur	Verb	Verb
almıyorlar	al	Verb	Verb
atmam	at	Verb	Verb
bozulmaması	boz	Verb	Noun
büyümedim	büyü	Verb	Verb
gitmezler	git	Verb	Verb
kurmazlar	kur	Verb	Verb
görmemişim	gör	Verb	Verb
olamazdım	ol	Verb	Verb
gitmedim	git	Verb	Verb
verilmezken	ver	Verb	Verb
yapmamaları	yap	Verb	Noun
uymaması	uy	Verb	Noun
kalmadıkça	kal	Verb	Verb
sollamayın	solla	Verb	Verb
olmadıklarının	ol	Verb	Noun
bulunmadığının	bul	Verb	Noun
kalmıyor	kal	Verb	Verb
uyuyamamış	uyu	Verb	Verb
dayanamamış	daya	Verb	Verb
açılmamış	aç	Verb	Verb
almadılar	al	Verb	Verb
başlamasın	başla	Verb	Verb
yapmasın	yap	Verb	Verb
etmeyenin	et	Verb	Noun
etmeyenlere	et	Verb	Noun
bilinmemesi	bil	Verb	Noun
değerlendiremiyoruz	değer	Noun	Verb
değerlendiremediğini	değer	Noun	Noun
bulmuyor	bul	Verb	Verb
yapılamıyor	yap	Verb	Verb
istemediklerini	iste	Verb	Noun
tutmuyor	tut	Verb	Verb
giderilemez	gider	Verb	Verb
almama	al	Verb	Noun
güçlendirmeyeceğidir	güç	Noun	Verb
çıkarılmadı	çık	Verb	Verb
edemeyince	et	Verb	Verb
içmeyen	iç	Verb	Adj
vurmaması	vur	Verb	Noun
çıkmaması	çık	Verb	Noun
hissettirmemeye	hisset	Verb	Noun
gelemeyen	gel	Verb	Adj
yaşanmaması	yaşa	Verb	Noun
yapmazken	yap	Verb	Verb
girmeseydik	gir	Verb	Verb
dinlenmiyor	dinle	Verb	Verb
öğrenememişler	öğren	Verb	Verb
hazmedemedi	hazmet	Verb	Verb
satmadığım	sat	Verb	Noun
oynanmamıştır	oyna	Verb	Verb
kullanamadı	kullan	Verb	Verb
sorulmuyor	sor	Verb	Verb
bilinmez	bil	Verb	Verb
sönmeyeceğine	sön	Verb	Noun
harcamamak	harca	Verb	Noun
kalmayacağını	kal	Verb	Noun
ayırtmadıysanız	ayır	Verb	Verb
dolmuyor	dol	Verb	Verb
kestiremeyen	kes	Verb	Adj
istemeyen	iste	Verb	Adj
çalışılmaması	çalış	Verb	Noun
verilmese	ver	Verb	Verb
sağlamayacağı	sağla	Verb	Noun
kaldıramayan	kal	Verb	Adj
gitmeyelim	git	Verb	Verb
beklemiyorum	bekle	Verb	Verb
sağlayamaz	sağla	Verb	Verb
yapmıyorlar	yap	Verb	Verb
addetmeyen	addet	Verb	Adj
yapılamayacağını	yap	Verb	Noun
aşamaz	aş	Verb	Verb
yaratamazsınız	yara	Verb	Verb
aşmama	aş	Verb	Noun
demiyor	de	Verb	Verb
geçmeyecek	geç	Verb	Adj
veremezsiniz	ver	Verb	Verb
aşmayın	aş	Verb	Verb
bakmasınlar	bak	Verb	Verb
korkmayın	kork	Verb	Verb
görülmeyecek	gör	Verb	Verb
karşılayamayacağını	karşıla	Verb	Noun
kapışma	kapış	Verb	Verb
yapamadı	yap	Verb	Verb
bakmadı	bak	Verb	Verb
beğenmeyin	beğen	Verb	Verb
gitmediği	git	Verb	Noun
yapmıyoruz	yap	Verb	Verb
çalışmadı	çalış	Verb	Verb
edilmiyor	et	Verb	Verb
kaçırılmamış	kaç	Verb	Verb
dışlanmamalıdır	dışla	Verb	Verb
gitmeyince	git	Verb	Verb
yapmadığım	yap	Verb	Adj
değiştiremem	değiş	Verb	Verb
yaşayamayacağını	yaşa	Verb	Noun
almasa	al	Verb	Verb
kestiremiyor	kes	Verb	Verb
verilmeseydi	ver	Verb	Verb
gelemiyordum	gel	Verb	Verb
inanmamış	inan	Verb	Verb
reddetmiyor	reddet	Verb	Verb
yitirmiyor	yit	Verb	Verb
kalmayacaktım	kal	Verb	Verb
olmamasına	ol	Verb	Noun
etmememi	et	Verb	Noun
toparlayamıyordum	toparla	Verb	Verb
yapılmamış	yap	Verb	Verb
anlatamadığım	anla	Verb	Adj
yetiştiremiyoruz	yetiş	Verb	Verb
olmayanlardan	ol	Verb	Noun
oynanmamış	oyna	Verb	Verb
tanımıyor	tanı	Verb	Verb
sürmüyor	sür	Verb	Verb
kalmayan	kal	Verb	Adj
uymamış	uy	Verb	Verb
vermiyor	ver	Verb	Verb
olmazlar	ol	Verb	Verb
yakalanmamaya	yakala	Verb	Noun
değişmeyecekti	değiş	Verb	Verb
bırakmayarak	bırak	Verb	Verb
olmadılar	ol	Verb	Verb
görülmüyor	gör	Verb	Verb
beklenmediğini	bekle	Verb	Noun
sormayın	sor	Verb	Verb
veremiyoruz	ver	Verb	Verb
çıkmamaları	çık	Verb	Noun
bulunamayabilir	bul	Verb	Verb
etmemeliler	et	Verb	Verb
kalmamaları	kal	Verb	Noun
kapılmayın	kap	Verb	Verb
bozmayın	boz	Verb	Verb
aksatmamaları	aksa	Verb	Noun
dolaşmamaları	dolaş	Verb	Noun
çıkartamadım	çık	Verb	Verb
inmez	in	Verb	Verb
girmemek	gir	Verb	Noun
çekmeyeceklerdir	çek	Verb	Verb
yanıltmasın	yanıl	Verb	Verb
gidilmiyor	git	Verb	Verb
oluşmuyor	oluş	Verb	Verb
kapanmıyor	kapa	Verb	Verb
edemiyor	et	Verb	Verb
bulunmamak	bul	Verb	Noun
bitirilemeyen	bit	Verb	Adj
geçirmez	geç	Verb	Verb
tanışmamıştı	tanış	Verb	Verb
kaybetmeyecek	kaybet	Verb	Verb
şaşırmayın	şaşır	Verb	Verb
olmamalarının	ol	Verb	Noun
kaçırılmayacak	kaç	Verb	Verb
çıkılmaması	çık	Verb	Noun
engelleyemedi	engelle	Verb	Verb
kazılmadı	kaz	Verb	Verb
rastlanmayan	rastla	Verb	Adj
giremiyor	gir	Verb	Verb
görülmeyen	gör	Verb	Adj
geçmeyen	geç	Verb	Adj
anlamayanlara	anla	Verb	Noun
keşfetmediği	keşfet	Verb	Adj
karşılaştırılmayacak	karşılaş	Verb	Adj
taşımadığını	taşı	Verb	Noun
denemiyor	de	Verb	Verb
çıkmamış	çık	Verb	Verb
getirmediğimiz	getir	Verb	Noun
koruyamamışız	koru	Verb	Verb
çıkarılmazsa	çık	Verb	Verb
yapmıyor	yap	Verb	Verb
onaylatmadığı	onayla	Verb	Adj
almaması	al	Verb	Noun
bulunmamaktadır	bulun	Verb	Verb
durmayacağını	dur	Verb	Noun
yakışmayacağını	yakış	Verb	Noun
dinlemiyorlar	dinle	Verb	Verb
bilmedikten	bil	Verb	Noun
çıkmıyorsa	çık	Verb	Verb
dinlemedi	dinle	Verb	Verb
heyecanlandırmıyordu	heyecan	Noun	Verb
bilmesem	bil	Verb	Verb
aşmadığını	aş	Verb	Noun
göremiyorlarsa	gör	Verb	Verb
istemediğimi	iste	Verb	Noun
rahatlattı	rahatla	Verb	Verb
yapan	yap	Verb	Adj
kullanabileceği	kullan	Verb	Adj
erime	eri	Verb	Noun
gözlendi	gözle	Verb	Verb
yüklenen	yükle	Verb	Adj
geçen	geç	Verb	Adj
düzeltti	düzel	Verb	Verb
kapatan	kapa	Verb	Adj
çıkardı	çık	Verb	Verb
göre	gör	Verb	Verb
olan	ol	Verb	Adj
azalışla	azal	Verb	Noun
indi	in	Verb	Verb
geriledi	gerile	Verb	Verb
düştü	düş	Verb	Verb
açılan	aç	Verb	Adj
gerilemesi	gerile	Verb	Noun
çekilen	çek	Verb	Adj
azalışı	azal	Verb	Noun
gerileme	gerile	Verb	Noun
artışla	art	Verb	Noun
çıktı	çık	Verb	Verb
ise	i	Verb	Verb
rahatlarken	rahatla	Verb	Verb
azalarak	azal	Verb	Verb
ödendi	öde	Verb	Verb
ödemeleri	öde	Verb	Noun
olarak	ol	Verb	Verb
gerçekleşti	gerçek	Noun	Verb
bulunuyor	bulun	Verb	Verb
gerçekleştirilen	gerçek	Noun	Adj
olmuştu	ol	Verb	Verb
akmasını	ak	Verb	Noun
sağlayan	sağla	Verb	Adj
uygulanması	uygula	Verb	Noun
beklenenin	bekle	Verb	Noun
artmasına	art	Verb	Noun
olurken	ol	Verb	Verb
satış	sat	Verb	Noun
belirlendiği	belirle	Verb	Noun
imzaladığı	imzala	Verb	Adj
ediliyor	et	Verb	Verb
veren	ver	Verb	Adj
satmasına	sat	Verb	Noun
veriyor	ver	Verb	Verb
tanınan	tanı	Verb	Adj
dolduracak	dol	Verb	Adj
imzalayan	imzala	Verb	Adj
çıkacak	çık	Verb	Adj
karşılaşacağı	karşılaş	Verb	Noun
arttırılmasını	art	Verb	Noun
isteyeceği	iste	Verb	Noun
belirtiliyor	belir	Verb	Verb
olmak	ol	Verb	Noun
doluncaya	dol	Verb	Noun
bildirdiler	bil	Verb	Verb
bulunduğu	bulun	Verb	Noun
tanıdığı	tanı	Verb	Noun
kalabilmek	kal	Verb	Noun
azalttığını	azal	Verb	Noun
bildirdi	bil	Verb	Verb
açıklama	açıkla	Verb	Noun
beklenenden	bekle	Verb	Noun
akacağı	ak	Verb	Noun
verince	ver	Verb	Verb
yükseltici	yüksel	Verb	Adj
yaptı	yap	Verb	Verb
arttığı	art	Verb	Adj
satmak	sat	Verb	Noun
kalacak	kal	Verb	Adj
ettiği	et	Verb	Noun
suçlamalarda	suçla	Verb	Noun
bulundu	bulun	Verb	Verb
verdiği	ver	Verb	Noun
yaptığı	yap	Verb	Adj
açıklamalarda	açıkla	Verb	Noun
bulunduğunu	bulun	Verb	Noun
etti	et	Verb	Verb
olmasından	ol	Verb	Noun
olduğunu	ol	Verb	Noun
söyledi	söyle	Verb	Verb
açtığı	aç	Verb	Noun
yapılacak	yap	Verb	Adj
getirme	getir	Verb	Noun
başlayan	başla	Verb	Adj
büyürken	büyü	Verb	Verb
hazırlanan	hazırla	Verb	Adj
uyguladıkları	uygula	Verb	Noun
seçti	seç	Verb	Verb
oluşturduğu	oluş	Verb	Noun
araştırmalar	araştır	Verb	Noun
ulaştırdığı	ulaş	Verb	Adj
savunduğu	savun	Verb	Noun
koydu	koy	Verb	Verb
uygulandığı	uygula	Verb	Noun
olmalarına	ol	Verb	Noun
çekildi	çek	Verb	Verb
sağlanan	sağla	Verb	Adj
alınmaları	al	Verb	Noun
istendi	iste	Verb	Verb
bırakma	bırak	Verb	Noun
geldi	gel	Verb	Verb
yapılan	yap	Verb	Adj
açıklamada	açıkla	Verb	Noun
yıkmaya	yık	Verb	Noun
ulaştığı	ulaş	Verb	Noun
edildi	et	Verb	Verb
sığınılarak	sığın	Verb	Verb
yürütülen	yürü	Verb	Adj
çalışmaların	çalış	Verb	Noun
düzenlemeler	düzenle	Verb	Noun
olduğuna	ol	Verb	Noun
yumuşatır	yumuşa	Verb	Verb
söylediğin	söyle	Verb	Adj
verdi	ver	Verb	Verb
konuştuğumu	konuş	Verb	Noun
biliyorum	bile	Verb	Verb
ilgileneceğini	ilgilen	Verb	Noun
olsaydım	ol	Verb	Verb
olsaydı	ol	Verb	Verb
yapardım	yap	Verb	Verb
endişelenme	endişe	Noun	Noun
oynamaya	oyna	Verb	Noun
olduğu	ol	Verb	Noun
benziyorsun	benze	Verb	Verb
gördüm	gör	Verb	Verb
görmek	gör	Verb	Noun
sevdiğin	sev	Verb	Noun
sanırım	san	Verb	Verb
seveceğim	sev	Verb	Verb
bağırdı	bağır	Verb	Verb
sevecek	sev	Verb	Adj
yapmış	yap	Verb	Verb
olur	ol	Verb	Verb
çekindi	çekin	Verb	Verb
gülerek	gül	Verb	Verb
idi	i	Verb	Verb
bindiler	bin	Verb	Verb
eskimiş	eski	Verb	Verb
indiler	in	Verb	Verb
geçmişti	geç	Verb	Verb
etmesi	et	Verb	Noun
gerekiyordu	gerek	Verb	Verb
dinlemesi	dinle	Verb	Noun
gitmek	git	Verb	Noun
istiyordu	iste	Verb	Verb
geldiğinde	gel	Verb	Noun
yaratacaktı	yara	Verb	Verb
tiksiniyordu	tiksin	Verb	Verb
ayrıldılar	ayır	Verb	Verb
girdiğini	gir	Verb	Noun
hissettiği	hisset	Verb	Noun
dolanmış	dola	Verb	Verb
dururken	dur	Verb	Verb
oynarken	oyna	Verb	Verb
öpüp	öp	Verb	Verb
okşadı	okşa	Verb	Verb
inerken	in	Verb	Verb
bekliyordu	bekle	Verb	Verb
girdiğinde	gir	Verb	Noun
vermeden	ver	Verb	Verb
oturdu	otur	Verb	Verb
uçuşup	uçuş	Verb	Verb
dolaşıyorlardı	dolaş	Verb	Verb
kalan	kal	Verb	Adj
durmaksızın	dur	Verb	Verb
yiyip	ye	Verb	Verb
bitiren	bit	Verb	Adj
işitiyordu	işit	Verb	Verb
itti	it	Verb	Verb
aldı	al	Verb	Verb
bilmek	bil	Verb	Noun
düşünüyordu	düşün	Verb	Verb
verilmiş	ver	Verb	Verb
olmalıydı	ol	Verb	Verb
izliyordu	izle	Verb	Verb
çıkarmış	çık	Verb	Verb
dökülüyordu	dök	Verb	Verb
çekiştirip	çekiş	Verb	Verb
durmaktaydı	dur	Verb	Verb
vurduğunda	vur	Verb	Noun
kalkarak	kalk	Verb	Verb
gitti	git	Verb	Verb
dönerek	dön	Verb	Verb
baktı	bak	Verb	Verb
ıslanmıştı	ısla	Verb	Verb
dileyen	dile	Verb	Adj
yalvarış	yalvar	Verb	Noun
gördü	gör	Verb	Verb
döndürdü	dön	Verb	Verb
dedi	de	Verb	Verb
bakışlarını	bak	Verb	Noun
dolandırıyordu	dolan	Verb	Verb
söyle	söyle	Verb	Verb
geçirdi	geç	Verb	Verb
ferahlama	ferahla	Verb	Noun
solumasıydı	solu	Verb	Verb
çektiği	çek	Verb	Noun
gelip	gel	Verb	Verb
çatmıştı	çat	Verb	Verb
yaratıyordu	yara	Verb	Verb
olmuş	ol	Verb	Adj
hatırlatmıştı	hatırla	Verb	Verb
acı	acı	Verb	Verb
ederek	et	Verb	Verb
sıkarak	sık	Verb	Verb
salladı	salla	Verb	Verb
biliyordum	bile	Verb	Verb
sevdik	sev	Verb	Verb
yaşasaydı	yaşa	Verb	Verb
geçinmemizi	geçin	Verb	Noun
ederdi	et	Verb	Verb
konuşma	konuş	Verb	Noun
haykırdı	haykır	Verb	Verb
verme	ver	Verb	Noun
seven	sev	Verb	Adj
söylüyor	söyle	Verb	Verb
doldu	dol	Verb	Verb
sildi	sil	Verb	Verb
fısıldadı	fısılda	Verb	Verb
duygulanmıştı	duygu	Noun	Verb
eğilip	eğ	Verb	Verb
öptü	öp	Verb	Verb
verdimse	ver	Verb	Verb
kal	kal	Verb	Verb
ilgilenmen	ilgilen	Verb	Noun
gereken	gerek	Verb	Adj
unutma	unut	Verb	Noun
verirse	ver	Verb	Verb
bulacak	bul	Verb	Verb
sürecek	sür	Verb	Adj
öldüreceğim	öl	Verb	Verb
ederim	et	Verb	Verb
eden	et	Verb	Adj
gösterdi	göster	Verb	Verb
etmesinden	et	Verb	Noun
olurdu	ol	Verb	Verb
kesti	kes	Verb	Verb
taşınması	taşı	Verb	Noun
edilmesi	et	Verb	Noun
koşturuyorlardı	koş	Verb	Verb
yerleştirilmesi	yerleş	Verb	Noun
kayboluyordu	kaybol	Verb	Verb
uğurlama	uğurla	Verb	Noun
yıpranmış	yıpran	Verb	Verb
sallarken	salla	Verb	Verb
duydu	duy	Verb	Verb
olduğunun	ol	Verb	Noun
kalmış	kal	Verb	Verb
kederlendiğini	keder	Noun	Noun
ilgilenmek	ilgilen	Verb	Noun
söyleyerek	söyle	Verb	Verb
hatırladı	hatırla	Verb	Verb
bulunmuştu	bulun	Verb	Verb
açıklanmış	açıkla	Verb	Verb
güleceklerini	gül	Verb	Noun
hissetti	hisset	Verb	Verb
hazırlanmış	hazırla	Verb	Verb
katılmak	kat	Verb	Noun
göründüğünde	görün	Verb	Noun
eğilmiş	eğ	Verb	Verb
bekleyen	bekle	Verb	Adj
yapılmaya	yap	Verb	Noun
bulunur	bulun	Verb	Verb
geçirilseler	geç	Verb	Verb
görünürler	görün	Verb	Noun
konuşurken	konuş	Verb	Verb
bakarak	bak	Verb	Verb
evlenmek	evlen	Verb	Noun
nişanlandı	nişanla	Verb	Verb
silkindi	silkin	Verb	Verb
çattı	çat	Verb	Verb
yapmak	yap	Verb	Noun
kaybediyor	kaybet	Verb	Verb
yapabileceği	yap	Verb	Adj
kıyılan	kıy	Verb	Adj
diyerek	de	Verb	Verb
evlendiğini	evlen	Verb	Noun
söyledim	söyle	Verb	Verb
saklıyorum	sakla	Verb	Verb
düşüneceğim	düşün	Verb	Verb
düşün	düşün	Verb	Verb
bulunan	bulun	Verb	Adj
davranış	davran	Verb	Noun
olacak	ol	Verb	Adj
evlenmesini	evlen	Verb	Noun
sağlamak	sağla	Verb	Noun
istiyorsan	iste	Verb	Verb
söylemen	söyle	Verb	Noun
evlenecektir	evlen	Verb	Verb
yapıyorsa	yap	Verb	Verb
gelir	gel	Verb	Verb
bozacak	boz	Verb	Adj
edecek	et	Verb	Adj
bağlanmış	bağla	Verb	Adj
yudumlayarak	yudumla	Verb	Verb
değerlendirmelerde	değer	Noun	Noun
çizdiğin	çiz	Verb	Noun
görünüşlerini	görün	Verb	Noun
değerlendirmekteki	değer	Noun	Adj
geliştirmişti	geliş	Verb	Verb
görünüş	görün	Verb	Noun
göreceğiz	gör	Verb	Verb
üzülürdüm	üz	Verb	Verb
yürüyüp	yürü	Verb	Verb
ısırarak	ısır	Verb	Verb
onaylıyor	onayla	Verb	Verb
sordu	sor	Verb	Verb
onaylayabilmen	onayla	Verb	Noun
sermek	ser	Verb	Noun
dediklerine	de	Verb	Noun
aldırış	al	Verb	Noun
yaptıklarına	yap	Verb	Noun
büyülemişse	büyüle	Verb	Verb
olursa	ol	Verb	Verb
olsun	ol	Verb	Verb
geliyor	gel	Verb	Verb
oynayan	oyna	Verb	Adj
vuruldu	vur	Verb	Verb
evlenme	evlen	Verb	Noun
evlenmiş	evlen	Verb	Verb
bilirsin	bil	Verb	Verb
kılmasıdır	kıl	Verb	Verb
yitirirler	yit	Verb	Verb
getirir	getir	Verb	Verb
eklerler	ekle	Verb	Verb
yaşamak	yaşa	Verb	Noun
kalırlar	kal	Verb	Verb
olurlar	ol	Verb	Verb
sanıyorum	san	Verb	Verb
sürebilecekleri	sür	Verb	Noun
yapacak	yap	Verb	Adj
geçecek	geç	Verb	Verb
etkileyici	etkile	Verb	Noun
bulmaya	bul	Verb	Noun
başlayacak	başla	Verb	Adj
söylediklerinin	söyle	Verb	Noun
biliyorsun	bile	Verb	Verb
olacaksa	ol	Verb	Verb
üzülen	üz	Verb	Adj
güldü	gül	Verb	Verb
düşünmekten	düşün	Verb	Noun
hoşlanmamızın	hoşlan	Verb	Noun
korkmamızdır	kork	Verb	Verb
oldukları	ol	Verb	Noun
güvendiğimiz	güven	Verb	Noun
olduğumuzu	ol	Verb	Noun
zannederiz	zannet	Verb	Verb
sağlayacaktır	sağla	Verb	Verb
çekebilmek	çek	Verb	Noun
överiz	öv	Verb	Verb
buluruz	bul	Verb	Verb
geçenlerdir	geç	Verb	Verb
buluyorum	bula	Verb	Verb
gelince	gel	Verb	Verb
gelişmesi	geliş	Verb	Noun
kısıtlanmış	kısıtla	Verb	Adj
çürür	çürü	Verb	Verb
bozmak	boz	Verb	Noun
vermen	ver	Verb	Noun
edeceğim	et	Verb	Verb
büyüleyici	büyüle	Verb	Adj
olmanın	ol	Verb	Noun
taşır	taşı	Verb	Verb
söyleyebileceklerimden	söyle	Verb	Noun
söyleyecektir	söyle	Verb	Verb
çıkarıp	çık	Verb	Verb
tokalaşırken	toka	Noun	Verb
kutlamalısınız	kutla	Verb	Verb
oldu	ol	Verb	Verb
aradığım	ara	Verb	Adj
pembeleşmiş	pembe	Noun	Verb
görünüyordu	görün	Verb	Verb
olmanı	ol	Verb	Noun
nişanlandığından	nişanla	Verb	Noun
söyledin	söyle	Verb	Verb
gelmeni	gel	Verb	Noun
karıştı	karış	Verb	Verb
koymuştu	koy	Verb	Verb
gelin	gel	Verb	Verb
oturup	otur	Verb	Verb
görelim	gör	Verb	Verb
olup	ol	Verb	Verb
bittiğini	bit	Verb	Noun
anlatırsın	anla	Verb	Verb
otururlarken	otur	Verb	Verb
bitenin	bit	Verb	Noun
ayrıldıktan	ayır	Verb	Noun
giyindim	giy	Verb	Verb
tanıttığın	tanı	Verb	Noun
yedim	ye	Verb	Verb
gittim	git	Verb	Verb
oynuyordu	oyna	Verb	Verb
görmeliydiniz	gör	Verb	Verb
giymişti	giy	Verb	Verb
süslenmiş	süsle	Verb	Verb
taşıyordu	taş	Verb	Verb
çevreleyen	çevrele	Verb	Adj
toplanmıştı	topla	Verb	Verb
göreceksiniz	gör	Verb	Verb
doğmuş	doğ	Verb	Verb
titreyerek	titre	Verb	Verb
izledim	izle	Verb	Verb
olduğumu	ol	Verb	Noun
unuttum	unut	Verb	Verb
ilerliyordum	ilerle	Verb	Verb
erdikten	er	Verb	Noun
gidip	git	Verb	Verb
konuştum	konuş	Verb	Verb
otururken	otur	Verb	Verb
bakış	bak	Verb	Noun
peydahlandı	peydahla	Verb	Verb
yaklaştı	yaklaş	Verb	Verb
öptük	öp	Verb	Verb
hissettiğimi	hisset	Verb	Noun
geliyordu	gel	Verb	Verb
titredi	titre	Verb	Verb
ürperdi	ürper	Verb	Verb
kapanıp	kapa	Verb	Verb
ellerimi	elle	Verb	Noun
gerektiğini	gerek	Verb	Noun
hissediyorum	hisset	Verb	Verb
söyleyecekler	söyle	Verb	Verb
sinirlenecek	sinir	Noun	Verb
olacağım	ol	Verb	Verb
istediğim	iste	Verb	Noun
yapabilirim	yap	Verb	Verb
kurtarabilir	kurtar	Verb	Verb
bulabilirim	bul	Verb	Verb
söyleyen	söyle	Verb	Adj
fısıldadılar	fısılda	Verb	Verb
sarıyor	sar	Verb	Verb
öpüyorum	öp	Verb	Verb
yaptın	yap	Verb	Verb
görüyor	gör	Verb	Verb
bıraktım	bırak	Verb	Verb
bulacağım	bul	Verb	Verb
yudumladı	yudumla	Verb	Verb
unuttun	unut	Verb	Verb
sunup	sun	Verb	Verb
sevdiğimi	sev	Verb	Noun
olmaya	ol	Verb	Noun
kıyasladığımda	kıyasla	Verb	Noun
kalıyor	kal	Verb	Verb
mırıldandı	mırıldan	Verb	Verb
söylemeyi	söyle	Verb	Noun
unuturuz	unut	Verb	Verb
hatırlatırlar	hatırla	Verb	Verb
sinirlendiriyorsun	sinir	Noun	Verb
sordum	sor	Verb	Verb
sorabilme	sor	Verb	Noun
kızmam	kız	Verb	Noun
gördüğünde	gör	Verb	Noun
üzebilecek	üz	Verb	Adj
düşüneceksin	düşün	Verb	Verb
sevdiği	sev	Verb	Adj
eder	et	Verb	Verb
seviyorum	sev	Verb	Verb
yerleştirmek	yerleş	Verb	Noun
bakmak	bak	Verb	Noun
istiyorum	iste	Verb	Verb
geçiyorsun	geç	Verb	Verb
yapıyor	yap	Verb	Verb
olduğumda	ol	Verb	Noun
öğrettiğin	öğret	Verb	Noun
hayıflanıyorum	hayıf	Noun	Verb
tanıdığın	tanı	Verb	Noun
olmaktan	ol	Verb	Noun
uzaklaştım	uzak	Adj	Verb
değiştim	değiş	Verb	Verb
dokunuşu	doku	Verb	Noun
zehirleyici	zehirle	Verb	Noun
unutturdu	unut	Verb	Verb
alırken	al	Verb	Verb
konmaya	kon	Verb	Noun
korkarım	kork	Verb	Verb
olduğumuzda	ol	Verb	Noun
olduğumuz	ol	Verb	Noun
olmayız	ol	Verb	Verb
derken	de	Verb	Verb
kastediyorsun	kastet	Verb	Verb
yaslanıp	yasla	Verb	Verb
duran	dur	Verb	Adj
süsen	süs	Verb	Adj
olmasıdır	ol	Verb	Verb
dokunarak	dokun	Verb	Verb
zorlar	zorla	Verb	Verb
istiyorsa	iste	Verb	Verb
böbürlenerek	böbürlen	Verb	Verb
koyabilir	koy	Verb	Verb
etmeyi	et	Verb	Noun
gerektiriyor	gerek	Verb	Verb
ediyorum	et	Verb	Verb
yaşarsa	yaşa	Verb	Verb
yüklenmiş	yükle	Verb	Verb
almaya	al	Verb	Noun
ödemeye	öde	Verb	Noun
çekerek	çek	Verb	Verb
düştüğünün	düş	Verb	Noun
varmakla	var	Verb	Noun
silkti	silk	Verb	Verb
geçti	geç	Verb	Verb
kullanabilir	kullan	Verb	Verb
demek	de	Verb	Noun
olunmaktan	ol	Verb	Noun
oynayarak	oyna	Verb	Verb
duyulmak	duy	Verb	Noun
davrandığı	davran	Verb	Adj
davranırlar	davran	Verb	Verb
taparlar	tap	Verb	Noun
yapmamız	yap	Verb	Noun
ederler	ederle	Verb	Verb
istedikleri	iste	Verb	Noun
vermiştir	ver	Verb	Verb
yaratıyorlar	yara	Verb	Verb
istemek	iste	Verb	Noun
etmelisin	et	Verb	Verb
verirler	ver	Verb	Verb
isterler	iste	Verb	Noun
dediği	de	Verb	Adj
getirip	getir	Verb	Verb
yaratma	yarat	Verb	Noun
tamamlamamıza	tamamla	Verb	Noun
hoşlanıyorum	hoşlan	Verb	Verb
seveceksin	sev	Verb	Verb
alır	al	Verb	Verb
getir	getir	Verb	Verb
boşver	boşver	Verb	Verb
almalısın	al	Verb	Verb
bırakır	bırak	Verb	Verb
isteyebilir	iste	Verb	Verb
olacaksın	ol	Verb	Verb
işlemeye	işle	Verb	Noun
koyduğu	koy	Verb	Adj
yakarken	yak	Verb	Verb
konuşuyorsun	konuş	Verb	Verb
gidelim	git	Verb	Verb
çıktığında	çık	Verb	Noun
gösterecek	göster	Verb	Adj
bakışla	bak	Verb	Noun
heyecanlandırabilir	heyecan	Noun	Verb
bayılırım	bayıl	Verb	Verb
geleceksin	gel	Verb	Verb
et	et	Verb	Verb
giyip	giy	Verb	Verb
yudumladılar	yudumla	Verb	Verb
olabilecek	ol	Verb	Adj
görünmesine	görün	Verb	Noun
ayrıldı	ayır	Verb	Verb
yanıp	yan	Verb	Verb
sönen	sön	Verb	Adj
kapladı	kapla	Verb	Verb
hissediyordu	hisset	Verb	Verb
girmişti	gir	Verb	Verb
koyulaştı	koyu	Adj	Verb
bulanıklaştı	bulanık	Adj	Verb
vardığında	var	Verb	Noun
yaşlanmış	yaş	Noun	Verb
karşılayan	karşıla	Verb	Adj
varmıştı	var	Verb	Verb
sallayıp	salla	Verb	Verb
konuşarak	konuş	Verb	Verb
götürdü	götür	Verb	Verb
görmeye	gör	Verb	Noun
geldiği	gel	Verb	Noun
karşılaşmış	karşılaş	Verb	Verb
girmiş	gir	Verb	Verb
hoşlanmıştı	hoşlan	Verb	Verb
belirterek	belir	Verb	Verb
sallıyor	salla	Verb	Verb
mahvolan	mahvol	Verb	Adj
keşfeden	keşfet	Verb	Adj
karşılaşmaktan	karşılaş	Verb	Noun
duyduğunu	duy	Verb	Noun
ediyordu	et	Verb	Verb
seyrederek	seyret	Verb	Verb
oyalamaktaydı	oyala	Verb	Verb
benziyordu	benze	Verb	Verb
asmışlardı	as	Verb	Verb
konuşup	konuş	Verb	Verb
oturan	otur	Verb	Adj
yedikleri	ye	Verb	Noun
paylaştılar	paylaş	Verb	Verb
atan	at	Verb	Adj
fırlatılan	fırla	Verb	Adj
bulmak	bul	Verb	Noun
bulduğum	bul	Verb	Noun
unutacaksınız	unut	Verb	Verb
gördüğünüz	gör	Verb	Noun
değişirler	değiş	Verb	Verb
izlerler	izle	Verb	Verb
hissettiriyorsa	hisset	Verb	Verb
yapar	yap	Verb	Verb
gülerler	gül	Verb	Noun
tinselleştirir	tinsel	Noun	Verb
olduklarını	ol	Verb	Noun
hisseder	hisset	Verb	Verb
geçirirken	geç	Verb	Verb
alma	al	Verb	Noun
istediğini	iste	Verb	Noun
anladım	anla	Verb	Verb
inanıyorum	inan	Verb	Verb
duyduğun	duy	Verb	Adj
olmalı	ol	Verb	Adj
anlattığın	anlat	Verb	Adj
yaratabilen	yara	Verb	Adj
kazandırmak	kazan	Verb	Noun
yaşamış	yaşa	Verb	Adj
olanlara	ol	Verb	Noun
katabilirse	kat	Verb	Verb
sürdürenlerin	sür	Verb	Noun
yaratabilirse	yara	Verb	Verb
kurtarıp	kurtar	Verb	Verb
dökebilmeyi	dök	Verb	Noun
öğretebilirse	öğret	Verb	Verb
demektir	de	Verb	Verb
onaylıyorum	onayla	Verb	Verb
yaratmış	yarat	Verb	Verb
olacaktın	ol	Verb	Verb
anlayacağını	anla	Verb	Noun
mahvediyor	mahvet	Verb	Verb
sürüyor	sür	Verb	Verb
kalkacak	kalk	Verb	Verb
vereceğim	ver	Verb	Verb
adayacağım	ada	Verb	Verb
gördüğü	gör	Verb	Adj
düşündü	düşün	Verb	Verb
andırıyordu	an	Verb	Verb
atarken	at	Verb	Verb
beliren	belir	Verb	Adj
düşmüştü	düş	Verb	Verb
attığında	at	Verb	Noun
titriyordu	titre	Verb	Verb
fırlayıp	fırla	Verb	Verb
alkışlamaya	alkışla	Verb	Noun
başladı	başla	Verb	Verb
bakıyor	bak	Verb	Verb
mırıldanıyordu	mırıldan	Verb	Verb
geçiyordu	geç	Verb	Verb
girdi	gir	Verb	Verb
giriş	gir	Verb	Noun
gelmiş	gel	Verb	Verb
salındı	sal	Verb	Verb
durdu	dur	Verb	Verb
yapılmıştı	yap	Verb	Verb
sabitlediğinde	sabitle	Verb	Noun
söylemek	söyle	Verb	Noun
ediyorsun	et	Verb	Verb
şereflenir	şeref	Noun	Verb
değdiğinden	değ	Verb	Noun
öpüşür	öp	Verb	Adj
yapmacık	yap	Verb	Noun
konuştu	konuş	Verb	Verb
olmasına	ol	Verb	Noun
ayarlamakta	ayarla	Verb	Noun
çıkışlarını	çık	Verb	Noun
edip	et	Verb	Verb
yarattı	yarat	Verb	Verb
izlerken	izle	Verb	Verb
giderek	git	Verb	Verb
solgunlaştı	solgun	Adj	Verb
sormaya	sor	Verb	Noun
görünmüştü	görün	Verb	Verb
uğramışlardı	uğra	Verb	Verb
değerlendirebilecekleri	değer	Noun	Noun
olacağını	ol	Verb	Noun
düşündüklerinden	düşün	Verb	Noun
beklediler	bekle	Verb	Verb
yapmacıklık	yap	Verb	Noun
dayanılır	daya	Verb	Verb
kötüleşti	kötü	Adj	Verb
denecek	de	Verb	Verb
vurguluyordu	vurgula	Verb	Verb
yaraşır	yaraş	Verb	Verb
okudu	oku	Verb	Verb
okuduğunu	oku	Verb	Noun
düşündürüyordu	düşün	Verb	Verb
abandığı	aban	Verb	Adj
anlaşmamızdan	anlaş	Verb	Noun
biten	bit	Verb	Adj
saçıyor	saç	Verb	Verb
diyemeden	de	Verb	Verb
yazın	yaz	Verb	Verb
geldiğimizde	gel	Verb	Noun
izleyicilerin	izle	Verb	Noun
dağıldı	dağıl	Verb	Verb
çıkarmaya	çık	Verb	Noun
başladılar	başla	Verb	Verb
vurarak	vur	Verb	Verb
küfretmeye	küfret	Verb	Noun
kalabilen	kal	Verb	Adj
erdiğinde	er	Verb	Noun
duyuldu	duy	Verb	Verb
giydi	giy	Verb	Verb
izleyeceğim	izle	Verb	Verb
ettiğim	et	Verb	Adj
diliyorum	dile	Verb	Verb
geliriz	gel	Verb	Verb
göründü	görün	Verb	Verb
değişmiş	değiş	Verb	Verb
izlediğim	izle	Verb	Adj
kaptırmıştı	kap	Verb	Verb
faydalanarak	fayda	Noun	Verb
evlendirmesi	evlen	Verb	Noun
sayılacaktı	say	Verb	Verb
çekiciydi	çek	Verb	Verb
sonuçlanırsa	sonuç	Noun	Verb
bildiği	bil	Verb	Noun
geçtim	geç	Verb	Verb
andırır	an	Verb	Verb
inanırdı	inan	Verb	Verb
canlandırıyordu	can	Noun	Verb
düşünmek	düşün	Verb	Noun
veriyordu	ver	Verb	Verb
oturuyordu	otur	Verb	Verb
istediği	iste	Verb	Noun
hazırlamıştı	hazırla	Verb	Verb
çizilmişti	çiz	Verb	Verb
atılmak	at	Verb	Noun
sabırsızlanıyordu	sabır	Noun	Verb
gecikmeleri	gecik	Verb	Noun
düşündükçe	düşün	Verb	Verb
kemiriyordu	kemir	Verb	Verb
gecikmeye	gecik	Verb	Noun
gelmişken	gel	Verb	Verb
denemişti	dene	Verb	Verb
çalkalandığını	çalkala	Verb	Noun
biliyordu	bile	Verb	Verb
kesin	kes	Verb	Verb
gelişinden	gel	Verb	Noun
dolaşmaya	dolaş	Verb	Noun
başlamıştı	başla	Verb	Verb
sardı	sar	Verb	Verb
vereceği	ver	Verb	Adj
konuşulmaya	konuş	Verb	Noun
başlandı	başla	Verb	Verb
kararlaştırılmıştı	karar	Noun	Verb
çıkmıştı	çık	Verb	Verb
tanırlar	tanı	Verb	Verb
batan	bat	Verb	Adj
çıktığı	çık	Verb	Noun
inandıklarından	inan	Verb	Noun
yayıldıkça	yay	Verb	Verb
yayıldı	yay	Verb	Verb
kökleşti	kök	Adj	Verb
konuşmanın	konuş	Verb	Noun
çakışmasıydı	çakış	Verb	Verb
süren	sür	Verb	Adj
incelemelerine	incele	Verb	Noun
dayanır	dayan	Verb	Verb
saklaması	sakla	Verb	Noun
bilir	bil	Verb	Verb
bilirler	bil	Verb	Noun
doğuştan	doğ	Verb	Noun
olması	ol	Verb	Noun
rastladıkça	rastla	Verb	Verb
etmekten	et	Verb	Noun
umursadığı	umursa	Verb	Adj
söyleyelim	söyle	Verb	Verb
ayrılsa	ayır	Verb	Verb
arayanlar	ara	Verb	Noun
basacaktı	bas	Verb	Verb
yaşıyormuş	yaşa	Verb	Verb
olmadan	ol	Verb	Verb
davranıyordu	davran	Verb	Verb
anlatılan	anla	Verb	Adj
beğenmiş	beğen	Verb	Verb
girecek	gir	Verb	Verb
kalınca	kal	Verb	Verb
bilebilirdi	bil	Verb	Verb
biçilmiş	biç	Verb	Verb
çıkmaya	çık	Verb	Noun
düşürülüp	düş	Verb	Verb
kandırıldığını	kan	Verb	Noun
soyulduğunu	soy	Verb	Noun
bağırıyorlardı	bağır	Verb	Verb
yırtıcı	yırt	Verb	Noun
kurtarmak	kurtar	Verb	Noun
kalır	kal	Verb	Verb
evlenebilirlerdi	evlen	Verb	Verb
bağırıp	bağır	Verb	Verb
çağırmaları	çağır	Verb	Noun
olmakla	ol	Verb	Noun
çıkarmak	çık	Verb	Noun
geçirmek	geç	Verb	Noun
isteyenlerle	iste	Verb	Noun
savaşmak	savaş	Verb	Noun
yakalayıp	yakala	Verb	Verb
götürse	götür	Verb	Verb
reddedilmesi	reddet	Verb	Noun
güvenebilirdi	güven	Verb	Verb
dalarlardı	dal	Verb	Verb
kaybetmenin	kaybet	Verb	Noun
gelişmeye	geliş	Verb	Noun
bahsetmeyi	bahset	Verb	Noun
uçarcasına	uç	Verb	Verb
gidiyor	git	Verb	Verb
sokmak	sok	Verb	Noun
gerekirse	gerek	Verb	Verb
dövüşmeye	döv	Verb	Noun
hazırlanıyordu	hazırla	Verb	Verb
gerçekleştireceğini	gerçek	Noun	Noun
rastlayacağını	rastla	Verb	Noun
batsa	bat	Verb	Verb
inanıyordu	inan	Verb	Verb
keserek	kes	Verb	Verb
uğratıp	uğra	Verb	Verb
getirdiğini	getir	Verb	Noun
soranlar	sor	Verb	Noun
olacaktır	ol	Verb	Verb
sayılacağını	say	Verb	Noun
söylemeye	söyle	Verb	Noun
gelmek	gel	Verb	Noun
yaklaşan	yaklaş	Verb	Adj
ürken	ürk	Verb	Adj
asmadan	as	Verb	Noun
bindirdi	bin	Verb	Verb
almak	al	Verb	Noun
giden	git	Verb	Adj
uyardı	uyar	Verb	Verb
unuttuğu	unut	Verb	Adj
durmadan	dur	Verb	Noun
karıştırdığı	karış	Verb	Adj
gidiyordu	git	Verb	Verb
içmişti	iç	Verb	Verb
yemekte	ye	Verb	Noun
yuvarladı	yuvarla	Verb	Verb
cıvıttı	cıvı	Verb	Verb
dolduruyordu	dol	Verb	Verb
neşelendirmeye	neşe	Noun	Noun
çalışıyordu	çalış	Verb	Verb
somurtuyorlardı	somur	Verb	Verb
bürünmüştü	bürü	Verb	Verb
yiyordu	ye	Verb	Verb
duymaya	duy	Verb	Noun
olacaktı	ol	Verb	Verb
kızarmış	kız	Verb	Verb
korkutmaya	kork	Verb	Noun
yetmişti	yet	Verb	Verb
korktuğuna	kork	Verb	Noun
uğruyordu	uğra	Verb	Verb
tutması	tut	Verb	Noun
gerekirken	gerek	Verb	Verb
oturuyor	otur	Verb	Verb
oluyordu	ol	Verb	Verb
kalkarken	kalk	Verb	Verb
biter	bit	Verb	Verb
gelerek	gel	Verb	Verb
üzülerek	üz	Verb	Verb
bozularak	boz	Verb	Verb
anlatayım	anlat	Verb	Verb
verin	ver	Verb	Verb
karşılaştım	karşılaş	Verb	Verb
kızdı	kız	Verb	Verb
gel	gel	Verb	Verb
tutturdu	tut	Verb	Verb
kalkar	kalk	Verb	Verb
içer	içer	Verb	Verb
yapayım	yap	Verb	Verb
düşünün	düşün	Verb	Verb
kaybettiği	kaybet	Verb	Noun
kurtarmıştı	kurtar	Verb	Verb
etmişti	et	Verb	Verb
evlenirsek	evlen	Verb	Verb
söylediklerine	söyle	Verb	Noun
tutarsak	tut	Verb	Verb
bırakabilir	bırak	Verb	Verb
düşünüyorsunuz	düşün	Verb	Verb
gizleyebiliyordu	gizle	Verb	Verb
gidin	git	Verb	Verb
etmeniz	et	Verb	Noun
gerekirdi	gerek	Verb	Verb
verdiğinizi	ver	Verb	Noun
göstermelisiniz	göster	Verb	Verb
oturanlarla	otur	Verb	Noun
söylüyordunuz	söyle	Verb	Verb
yanılabilirim	yan	Verb	Verb
söylediğimi	söyle	Verb	Noun
gelmiştir	gel	Verb	Verb
sayılır	say	Verb	Verb
değiştirmeliyim	değiş	Verb	Verb
ayıplayacağını	ayıpla	Verb	Noun
bakın	bakın	Verb	Verb
bahsedin	bahset	Verb	Verb
saydığımı	say	Verb	Noun
duyduğumu	duy	Verb	Noun
söyleyin	söyle	Verb	Verb
getirerek	getir	Verb	Verb
canlandırdınız	can	Noun	Verb
açmaya	aç	Verb	Noun
çekiniyordum	çekin	Verb	Verb
çıkayım	çık	Verb	Verb
anlatın	anla	Verb	Verb
değiştirdim	değiş	Verb	Verb
giderdi	gider	Verb	Verb
tıkanacaktı	tıka	Verb	Verb
ediyor	et	Verb	Verb
çıkıp	çık	Verb	Verb
giyerken	giy	Verb	Verb
kollayan	kolla	Verb	Adj
dikildi	dik	Verb	Verb
yakalayarak	yakala	Verb	Verb
gidiyorum	git	Verb	Verb
gülelim	gül	Verb	Verb
bıraksın	bırak	Verb	Verb
giderseniz	git	Verb	Verb
edin	et	Verb	Verb
sandığınız	san	Verb	Adj
verecekler	ver	Verb	Verb
duydum	duy	Verb	Verb
görün	gör	Verb	Verb
dinleyin	dinle	Verb	Verb
dönen	dön	Verb	Adj
basarak	bas	Verb	Verb
yürüdü	yürü	Verb	Verb
gözetleyerek	gözetle	Verb	Verb
dinlediği	dinle	Verb	Noun
bölmeye	böl	Verb	Noun
sokulup	sok	Verb	Verb
dinledikten	dinle	Verb	Noun
anlarsınız	anla	Verb	Verb
başlar	başla	Verb	Verb
kandıracakları	kan	Verb	Noun
çıktığınız	çık	Verb	Adj
varması	var	Verb	Noun
kandırmaya	kan	Verb	Noun
uğraştı	uğraş	Verb	Verb
bastırıp	bas	Verb	Verb
bitirivermenin	bit	Verb	Noun
bulandı	bula	Verb	Verb
dinledim	dinle	Verb	Verb
batırdıklarını	bat	Verb	Noun
duymalıydınız	duy	Verb	Verb
koydular	koy	Verb	Verb
süslenip	süsle	Verb	Verb
püslenecektim	püsle	Verb	Verb
duyacaksınız	duy	Verb	Verb
dinleyeyim	dinle	Verb	Verb
dayayın	daya	Verb	Verb
geldikten	gel	Verb	Noun
olun	ol	Verb	Verb
gösteriyorum	göster	Verb	Verb
yapıyorsunuz	yap	Verb	Verb
gideceğim	git	Verb	Verb
zorlayarak	zorla	Verb	Verb
yapıştırdı	yapış	Verb	Verb
çarpıyor	çarp	Verb	Verb
atıyordu	ata	Verb	Verb
başlamak	başla	Verb	Noun
isteyen	iste	Verb	Adj
hazırladığı	hazırla	Verb	Noun
süzerek	süz	Verb	Verb
eğlendiniz	eğlen	Verb	Verb
kopacak	kop	Verb	Verb
yemekten	ye	Verb	Noun
geçirmişlerdi	geç	Verb	Verb
gevşemişti	gevşe	Verb	Verb
vurmuştu	vur	Verb	Verb
ağırlaşıp	ağır	Adj	Verb
uyumak	uyu	Verb	Noun
duyacağını	duy	Verb	Noun
anlıyordu	anla	Verb	Verb
geçirdikten	geç	Verb	Noun
bakışlarında	bak	Verb	Noun
sezdi	sez	Verb	Verb
eğ	eğ	Verb	Verb
övülmesine	öv	Verb	Noun
alevlendi	alev	Noun	Verb
övmenize	öv	Verb	Noun
demeli	de	Verb	Verb
gösteriş	göster	Verb	Noun
kaldırın	kaldır	Verb	Verb
bulacaksınız	bul	Verb	Verb
diyorsunuz	de	Verb	Verb
bak	bak	Verb	Verb
anlatmalıyım	anla	Verb	Verb
hatırladın	hatırla	Verb	Verb
gösterdiğiniz	göster	Verb	Adj
bahsediyorum	bahset	Verb	Verb
güldürmek	gül	Verb	Noun
bakar	bak	Verb	Verb
anlatmak	anla	Verb	Noun
ettik	et	Verb	Verb
çıktım	çık	Verb	Verb
hatırlıyorum	hatırla	Verb	Verb
baktım	bak	Verb	Verb
dersiniz	de	Verb	Verb
verir	ver	Verb	Verb
di	de	Verb	Verb
yor	yor	Verb	Verb
yemiş	ye	Verb	Verb
buldunuz	bul	Verb	Verb
versem	ver	Verb	Verb
ölürüm	öl	Verb	Verb
etmeye	et	Verb	Noun
başlayacağım	başla	Verb	Verb
süz	süz	Verb	Verb
yıkasaydı	yıka	Verb	Verb
konuşuyor	konuş	Verb	Verb
artan	art	Verb	Adj
süzüyordu	süz	Verb	Verb
eriyecek	eri	Verb	Verb
mırıldanıp	mırılda	Verb	Verb
duruyordu	dur	Verb	Verb
çalsana	çal	Verb	Verb
ürperten	ürper	Verb	Adj
yürüyüşüyle	yürü	Verb	Noun
bilseniz	bil	Verb	Verb
yutkunarak	yutkun	Verb	Verb
kıyaslanabilecek	kıyasla	Verb	Adj
ölen	öl	Verb	Adj
öl	öl	Verb	Verb
evlendi	evlen	Verb	Verb
verdirdi	ver	Verb	Verb
okumuştu	oku	Verb	Verb
geçinirlerdi	geçin	Verb	Verb
soyup	soy	Verb	Verb
kayboldu	kaybol	Verb	Verb
etmişler	et	Verb	Verb
sever	sev	Verb	Verb
severim	sev	Verb	Verb
tanışmıştım	tanış	Verb	Verb
tanışıyormuş	tanış	Verb	Verb
söyleyeyim	söyle	Verb	Verb
bahseden	bahset	Verb	Adj
geçin	geç	Verb	Verb
dikmiş	dik	Verb	Verb
duymuştum	duy	Verb	Verb
okumaya	oku	Verb	Noun
başlarken	başla	Verb	Verb
söylüyordu	söyle	Verb	Verb
işliyordu	işle	Verb	Verb
çevirirken	çevir	Verb	Verb
yonttuğu	yont	Verb	Adj
inip	in	Verb	Verb
kalkan	kalk	Verb	Adj
büyüledi	büyüle	Verb	Verb
söylediği	söyle	Verb	Adj
tıkanıyordu	tıka	Verb	Verb
canlanmış	can	Noun	Verb
coşmuş	coş	Verb	Verb
çarpıyordu	çarp	Verb	Verb
çökmeye	çök	Verb	Noun
bitince	bit	Verb	Verb
ağlamaklı	ağla	Verb	Adj
öperken	öp	Verb	Verb
hatırladım	hatırla	Verb	Verb
geçmek	geç	Verb	Noun
geldiğini	gel	Verb	Noun
mahvediyorsunuz	mahvet	Verb	Verb
çekilmek	çek	Verb	Noun
kaçmak	kaç	Verb	Noun
düzeltin	düzel	Verb	Verb
bakışlarla	bak	Verb	Noun
diriltin	diril	Verb	Verb
canlandırın	can	Noun	Verb
dönün	dön	Verb	Verb
karışın	karış	Verb	Verb
gösterene	göster	Verb	Noun
sayan	say	Verb	Adj
anlayan	anla	Verb	Adj
seslenin	seslen	Verb	Verb
koşa	koş	Verb	Verb
geleceklerdir	gel	Verb	Verb
bırakarak	bırak	Verb	Verb
koşarım	koş	Verb	Verb
gelirim	gel	Verb	Verb
olurdum	ol	Verb	Verb
isteseydiniz	iste	Verb	Verb
sümküren	sümkür	Verb	Adj
olduğunuza	ol	Verb	Noun
geveledi	gevele	Verb	Verb
yaşıyoruz	yaşa	Verb	Verb
koruyucu	koru	Verb	Noun
reddetti	reddet	Verb	Verb
götüreceğiniz	götür	Verb	Noun
heyecanlanmıştı	heyecan	Noun	Verb
olsa	ol	Verb	Verb
öpmeye	öp	Verb	Noun
çökmek	çök	Verb	Noun
konuşmaya	konuş	Verb	Noun
atıldı	at	Verb	Verb
davranışların	davran	Verb	Noun
okumuştum	oku	Verb	Verb
unutmuştum	unut	Verb	Verb
sayılacağı	say	Verb	Noun
kazanmıştı	kazan	Verb	Verb
olduğunuzu	ol	Verb	Noun
ihtiyarlar	ihtiyarla	Verb	Verb
içmelere	iç	Verb	Noun
söylüyorum	söyle	Verb	Verb
şaşırtıcı	şaşır	Verb	Noun
uyandıracaksınız	uyan	Verb	Verb
gezdiriyorsunuz	gez	Verb	Verb
büyülüyorsunuz	büyüle	Verb	Verb
koşuyor	koş	Verb	Verb
bahsedecek	bahset	Verb	Verb
ediyorsunuz	et	Verb	Verb
gevşiyordu	gevşe	Verb	Verb
söylediğiniz	söyle	Verb	Noun
tekrarlayın	tekrarla	Verb	Verb
hatırlıyor	hatırla	Verb	Verb
yalvarıyordu	yalvar	Verb	Verb
getirdi	getir	Verb	Verb
çöktü	çök	Verb	Verb
titreyen	titre	Verb	Adj
bağırıyordu	bağır	Verb	Verb
bitmiş	bit	Verb	Adj
görürdüm	gör	Verb	Verb
söylerdik	söyle	Verb	Verb
tıkanarak	tıka	Verb	Verb
boğularak	boğ	Verb	Verb
peltekleşmişti	peltek	Adj	Verb
duygulandığı	duygu	Noun	Adj
körükledi	körükle	Verb	Verb
olmayasınız	ol	Verb	Verb
hissetmişti	hisset	Verb	Verb
umduğundan	um	Verb	Noun
canlandı	can	Noun	Verb
durarak	dur	Verb	Verb
vermeyi	ver	Verb	Noun
edebilsem	et	Verb	Verb
baktıkça	bak	Verb	Verb
bakardım	bak	Verb	Verb
istiyorsunuz	iste	Verb	Verb
alırlar	al	Verb	Verb
kucakladı	kucakla	Verb	Verb
hissediyor	hisset	Verb	Verb
seyrediyordu	seyret	Verb	Verb
coşmuştu	coş	Verb	Verb
çevirdi	çevir	Verb	Verb
ayrılacağımızı	ayır	Verb	Noun
baktığının	bak	Verb	Noun
ettiniz	et	Verb	Verb
ayıracaksınız	ayır	Verb	Verb
bırakıyorsun	bırak	Verb	Verb
gelen	gel	Verb	Adj
vermek	ver	Verb	Noun
uzattı	uza	Verb	Verb
gülümsemeye	gülümse	Verb	Noun
zorladı	zorla	Verb	Verb
yaşamaya	yaşa	Verb	Noun
kekeliyordu	kekele	Verb	Verb
tanıdığım	tanı	Verb	Noun
olanıdır	ol	Verb	Verb
biliyor	bile	Verb	Verb
geldiniz	gel	Verb	Verb
veriyorum	ver	Verb	Verb
yalvaran	yalvar	Verb	Adj
koruyacaksınız	koru	Verb	Verb
kılıcınız	kıl	Verb	Noun
parlayacak	parla	Verb	Verb
yeter	yet	Verb	Verb
başlıyorum	başla	Verb	Verb
geveliyordu	gevele	Verb	Verb
göndermek	gönder	Verb	Noun
sereceğim	ser	Verb	Verb
kaçarak	kaç	Verb	Verb
gömülmeye	göm	Verb	Noun
kalkışıyorsunuz	kalkış	Verb	Verb
yaptınız	yap	Verb	Verb
tekrarlayacağım	tekrarla	Verb	Verb
hatırladıkça	hatırla	Verb	Verb
duygulanmış	duygu	Noun	Verb
ye	ye	Verb	Verb
sokacaklardı	sok	Verb	Verb
gitmiştim	git	Verb	Verb
anlattım	anla	Verb	Verb
kalmıştım	kal	Verb	Verb
bulunacağım	bulun	Verb	Verb
bakalım	bak	Verb	Verb
evlenmeniz	evlen	Verb	Noun
uğratacak	uğra	Verb	Verb
anlayacaklar	anla	Verb	Verb
bakabileceksiniz	bak	Verb	Verb
bakacağım	bak	Verb	Verb
kapadı	kapa	Verb	Verb
tüketmeyeyim	tüket	Verb	Verb
eğilerek	eğ	Verb	Verb
yatışmanız	yatış	Verb	Noun
dinlenmeniz	dinle	Verb	Noun
gerekiyor	gerek	Verb	Verb
götüreyim	götür	Verb	Verb
yatırırım	yatır	Verb	Verb
bakıyorsunuz	bak	Verb	Verb
inanır	inan	Verb	Verb
söyleyecektim	söyle	Verb	Verb
yet	yet	Verb	Verb
yollamak	yolla	Verb	Noun
istedi	iste	Verb	Verb
kalsın	kal	Verb	Verb
kapaklanıyordu	kapaklan	Verb	Verb
girin	gir	Verb	Verb
kaldı	kal	Verb	Verb
duyuyordu	duy	Verb	Verb
yanıyordu	yan	Verb	Verb
sıkmış	sık	Verb	Verb
kenetlenmiş	kenetle	Verb	Verb
kıpırdamadan	kıpırda	Verb	Noun
yaşarmıştı	yaşar	Verb	Verb
açıldı	aç	Verb	Verb
duymuştu	duy	Verb	Verb
tıkanan	tıka	Verb	Adj
süzdü	süz	Verb	Verb
tekrarladı	tekrarla	Verb	Verb
parladı	parla	Verb	Verb
yürüyerek	yürü	Verb	Verb
gerileyen	gerile	Verb	Adj
küçümseyen	küçümse	Verb	Adj
dinlediniz	dinle	Verb	Verb
yaptım	yap	Verb	Verb
bakışı	bak	Verb	Noun
eziliyordu	ez	Verb	Verb
suçlayabilirsiniz	suçla	Verb	Verb
suçlamaya	suçla	Verb	Noun
konuşuyorsunuz	konuş	Verb	Verb
soruyorsunuz	sor	Verb	Verb
evlenecekmişsiniz	evlen	Verb	Verb
çiğneyip	çiğne	Verb	Verb
geçerek	geç	Verb	Verb
verdiniz	ver	Verb	Verb
ayırmıştınız	ayır	Verb	Verb
duymuş	duy	Verb	Verb
buruştu	buruş	Verb	Verb
tuttu	tut	Verb	Verb
titremeyle	titre	Verb	Noun
acıdığımdan	acı	Verb	Noun
tanımam	tanı	Verb	Noun
yalvardınız	yalvar	Verb	Verb
anlayınca	anla	Verb	Verb
dediniz	de	Verb	Verb
açalı	aç	Verb	Verb
tekrarlayıp	tekrarla	Verb	Verb
duruyorsunuz	dur	Verb	Verb
oynadığımı	oyna	Verb	Noun
bulunuyorsunuz	bul	Verb	Verb
kararlaştırdığımız	karar	Adj	Adj
görünce	gör	Verb	Verb
saklamaya	sakla	Verb	Noun
vurdum	vur	Verb	Verb
vardınız	var	Verb	Verb
gelişinize	gel	Verb	Noun
darılıp	darıl	Verb	Verb
sordunuz	sor	Verb	Verb
saklamak	sakla	Verb	Noun
paylaşmak	paylaş	Verb	Noun
bilin	bil	Verb	Verb
tuttuğumdan	tut	Verb	Noun
bahsetmeye	bahset	Verb	Noun
düşündüklerimi	düşün	Verb	Noun
olabilir	ol	Verb	Verb
evlenebilirim	evlen	Verb	Verb
diyordum	de	Verb	Verb
versin	ver	Verb	Verb
olmasını	ol	Verb	Noun
dilemekten	dile	Verb	Noun
diyeceğim	de	Verb	Verb
söyledikten	söyle	Verb	Noun
kaybolduğunu	kaybol	Verb	Noun
köpürdü	köpür	Verb	Verb
bağırmaya	bağır	Verb	Noun
olduk	ol	Verb	Verb
gitmeden	git	Verb	Noun
içirip	iç	Verb	Verb
düşürdüğünüzü	düş	Verb	Noun
yayacağım	yay	Verb	Verb
anlatacağım	anla	Verb	Verb
sarsıldı	sars	Verb	Verb
verecek	ver	Verb	Adj
küçümseyerek	küçümse	Verb	Verb
vurup	vur	Verb	Verb
bağırdıklarını	bağır	Verb	Noun
kavradı	kavra	Verb	Verb
gidebilirdi	git	Verb	Verb
olanı	ol	Verb	Noun
biteni	bit	Verb	Noun
yayabilirdi	yay	Verb	Verb
tutmaları	tut	Verb	Noun
yatıştırmak	yatış	Verb	Noun
doğdu	doğ	Verb	Verb
sokularak	sok	Verb	Verb
koyacağınızı	koy	Verb	Noun
sanıyorsunuz	san	Verb	Verb
gördüğüm	gör	Verb	Adj
bulunduğunun	bulun	Verb	Noun
oturduğu	otur	Verb	Adj
göstererek	göster	Verb	Verb
baksanıza	bak	Verb	Verb
çekiyorsunuz	çek	Verb	Verb
vuruldunuz	vurul	Verb	Verb
konuşmanıza	konuş	Verb	Noun
hissettiğim	hisset	Verb	Noun
verdim	ver	Verb	Verb
konuşalım	konuş	Verb	Verb
şaşırarak	şaşır	Verb	Verb
ilişti	iliş	Verb	Verb
körükleyerek	körükle	Verb	Verb
artırmaya	art	Verb	Noun
kurduğunuzu	kur	Verb	Noun
öğrendim	öğren	Verb	Verb
edebildi	et	Verb	Verb
fırladı	fırla	Verb	Verb
hatırlayın	hatırla	Verb	Verb
kınayın	kına	Verb	Verb
dinlemeyi	dinle	Verb	Noun
koyan	koy	Verb	Adj
anlattı	anlat	Verb	Verb
edersiniz	et	Verb	Verb
öğrenirim	öğren	Verb	Verb
inceleyecek	incele	Verb	Verb
olursanız	ol	Verb	Verb
istediğimden	iste	Verb	Noun
çatırdatacak	çatırda	Verb	Verb
döndü	dön	Verb	Verb
dinlerseniz	dinle	Verb	Verb
vereceksiniz	ver	Verb	Verb
istiyordum	iste	Verb	Verb
dinlemekle	dinle	Verb	Noun
küçültmeden	küçül	Verb	Noun
öğrenmiş	öğren	Verb	Verb
olurdunuz	ol	Verb	Verb
olmasındandı	ol	Verb	Verb
konuşuyorum	konuş	Verb	Verb
seviyor	sev	Verb	Verb
vazgeçirip	vazgeç	Verb	Verb
ettirene	et	Verb	Noun
çektiğimi	çek	Verb	Noun
bilirim	bil	Verb	Verb
işitmek	işit	Verb	Noun
oldum	ol	Verb	Verb
konuştunuz	konuş	Verb	Verb
konuşur	konuş	Verb	Verb
görmüş	gör	Verb	Verb
konuşması	konuş	Verb	Noun
kızdırdınız	kız	Verb	Verb
güler	gül	Verb	Verb
gösterirken	göster	Verb	Verb
gittiğim	git	Verb	Adj
batırdınız	bat	Verb	Verb
anladınız	anla	Verb	Verb
öğrendiniz	öğren	Verb	Verb
küçümser	küçümse	Verb	Verb
gülümsemeyle	gülümse	Verb	Noun
büktü	bük	Verb	Verb
kötülüyordum	kötüle	Verb	Verb
uğraştım	uğraş	Verb	Verb
kötülemek	kötüle	Verb	Noun
etmek	et	Verb	Noun
kalışım	kal	Verb	Noun
vazgeçirdiğimin	vazgeç	Verb	Noun
kötüleyeyim	kötüle	Verb	Verb
göstereyim	göster	Verb	Verb
başvurayım	başvur	Verb	Verb
söküp	sök	Verb	Verb
atmak	at	Verb	Noun
kullanmak	kullan	Verb	Noun
kaldım	kal	Verb	Verb
edene	et	Verb	Noun
konuştuklarımızı	konuş	Verb	Noun
dinlemişsiniz	dinle	Verb	Verb
etmişsinizdir	et	Verb	Verb
acıdığım	acı	Verb	Noun
götürdüm	götür	Verb	Verb
ağlamıştı	ağla	Verb	Verb
olmanız	ol	Verb	Noun
daldığı	dal	Verb	Adj
ağlarken	ağla	Verb	Verb
bulduğunu	bul	Verb	Noun
kazıyorsunuz	kaz	Verb	Verb
kötülediniz	kötüle	Verb	Verb
açıklıyorsunuz	açıkla	Verb	Verb
sormuş	sor	Verb	Verb
olsaydınız	ol	Verb	Verb
alırdınız	al	Verb	Verb
yaptığımı	yap	Verb	Noun
evlenirse	evlen	Verb	Verb
konacak	kon	Verb	Verb
ölünce	öl	Verb	Verb
olacağı	ol	Verb	Adj
istese	iste	Verb	Verb
evlenebilir	evlen	Verb	Verb
yapabilir	yap	Verb	Verb
evlenmekle	evlen	Verb	Noun
parçaladığı	parçala	Verb	Adj
seçecek	seç	Verb	Adj
duyarak	duy	Verb	Verb
işlediği	işle	Verb	Noun
affettireceğini	affet	Verb	Noun
seyreden	seyret	Verb	Adj
homurdandı	homurda	Verb	Verb
bahsedeceğim	bahset	Verb	Verb
söyleyeceğim	söyle	Verb	Verb
okuyor	oku	Verb	Verb
buluyorsunuz	bula	Verb	Verb
düşünerek	düşün	Verb	Verb
evlenmeyle	evlen	Verb	Noun
severdim	sev	Verb	Verb
düştüğü	düş	Verb	Noun
sokacak	sok	Verb	Adj
evlenmeye	evlen	Verb	Noun
yapacağı	yap	Verb	Noun
sürerek	sür	Verb	Verb
edebildim	et	Verb	Verb
kapıldı	kap	Verb	Verb
geçmeli	geç	Verb	Verb
kattığımızı	kat	Verb	Noun
diyeyim	de	Verb	Verb
hesaplar	hesapla	Verb	Verb
yapmaktan	yap	Verb	Noun
hesaplardı	hesapla	Verb	Verb
şaşıyorsunuz	şaş	Verb	Verb
sevmeyi	sev	Verb	Noun
koyarak	koy	Verb	Verb
ederiz	et	Verb	Verb
varmadan	var	Verb	Noun
yaparız	yap	Verb	Verb
aldatarak	aldat	Verb	Verb
tekrarlamak	tekrarla	Verb	Noun
ettiğimi	et	Verb	Noun
gözettiğimi	göze	Verb	Noun
sorarsanız	sor	Verb	Verb
kapadım	kapa	Verb	Verb
girişiyorum	giriş	Verb	Verb
suçlayabilir	suçla	Verb	Verb
açıklamayı	açıkla	Verb	Noun
dinliyor	dinle	Verb	Verb
bakıyordu	bak	Verb	Verb
şakıyorsunuz	şakı	Verb	Verb
yapacağım	yap	Verb	Verb
konuldum	kon	Verb	Verb
çıkarım	çık	Verb	Verb
şaşırmıştı	şaşır	Verb	Verb
demekmiş	de	Verb	Verb
kaldırarak	kaldır	Verb	Verb
dalıp	dal	Verb	Verb
kurmanın	kur	Verb	Noun
yaşarken	yaşa	Verb	Verb
yaşıyorum	yaşa	Verb	Verb
sanmanın	san	Verb	Noun
görüyorsunuz	gör	Verb	Verb
açıklamak	açıkla	Verb	Noun
anladığıma	anla	Verb	Noun
görülür	gör	Verb	Verb
tutarak	tut	Verb	Verb
davrandığının	davran	Verb	Noun
vardım	var	Verb	Verb
ettim	et	Verb	Verb
darıltıp	darıl	Verb	Verb
karşıladınız	karşıla	Verb	Verb
ayırıyor	ayır	Verb	Verb
eğiyorum	eğ	Verb	Verb
gerekiyorsa	gerek	Verb	Verb
bağışlıyorum	bağışla	Verb	Verb
olursun	ol	Verb	Verb
söylerken	söyle	Verb	Verb
dayanmış	dayan	Verb	Adj
bakışını	bak	Verb	Noun
dikecektiniz	dik	Verb	Verb
söyledikleriniz	söyle	Verb	Noun
söylesem	söyle	Verb	Verb
kalacaktı	kal	Verb	Verb
göstermek	göster	Verb	Noun
karşılaşıyorsunuz	karşılaş	Verb	Verb
kamaştıran	kamaş	Verb	Adj
yaslanmış	yasla	Verb	Verb
görülebilir	gör	Verb	Verb
seyrediyorsunuz	seyret	Verb	Verb
duyuluyor	duy	Verb	Verb
bakacak	bak	Verb	Adj
düşünecek	düşün	Verb	Adj
alevlenecek	alev	Noun	Verb
çatırdatırcasına	çatırda	Verb	Verb
kıpırdattı	kıpırda	Verb	Verb
uçuştuğu	uçuş	Verb	Adj
gidiyorsunuz	git	Verb	Verb
başlıyor	başla	Verb	Verb
bakmaktan	bak	Verb	Noun
duyuyorsunuz	duy	Verb	Verb
istediğimi	iste	Verb	Noun
anlıyorsunuz	anla	Verb	Verb
edeceklerdir	et	Verb	Verb
verebilirler	ver	Verb	Verb
çıkar	çık	Verb	Verb
çıkarılır	çık	Verb	Verb
ölüyor	öl	Verb	Verb
evlenmeyi	evlen	Verb	Noun
saydıkları	say	Verb	Adj
alıyorsunuz	al	Verb	Verb
giriyorsunuz	gir	Verb	Verb
ulaşıyor	ulaş	Verb	Verb
olacaksınız	ol	Verb	Verb
koyacak	koy	Verb	Verb
alıyorum	al	Verb	Verb
inanmış	inan	Verb	Verb
bakıp	bak	Verb	Verb
gülen	gül	Verb	Adj
diyeni	de	Verb	Noun
inanın	inan	Verb	Verb
heyecanlanarak	heyecan	Noun	Verb
doğrularak	doğrul	Verb	Verb
daldırdı	dal	Verb	Verb
ekledi	ekle	Verb	Verb
inledi	inle	Verb	Verb
sevdiğim	sev	Verb	Adj
mahvettim	mahvet	Verb	Verb
düşünüyor	düşün	Verb	Verb
kurtarın	kurtar	Verb	Verb
ağlamaya	ağla	Verb	Noun
duygulanarak	duygu	Noun	Verb
kaynayan	kayna	Verb	Adj
yaptığınızı	yap	Verb	Noun
anlaması	anla	Verb	Noun
gerekir	gerek	Verb	Verb
çalışacağım	çalış	Verb	Verb
öğrettiğim	öğret	Verb	Noun
söyleyeceksiniz	söyle	Verb	Verb
yapsak	yap	Verb	Verb
sayar	say	Verb	Verb
koyacağız	koy	Verb	Verb
gidiverin	git	Verb	Verb
kavuşturdunuz	kavuş	Verb	Verb
soracağım	sor	Verb	Verb
etmeliyiz	et	Verb	Verb
dilemeliyiz	dile	Verb	Verb
dökerek	dök	Verb	Verb
görünüyor	görün	Verb	Verb
tanıtmak	tanı	Verb	Noun
korkuyorum	kork	Verb	Verb
yapalım	yap	Verb	Verb
etmiş	et	Verb	Verb
kazanmış	kazan	Verb	Adj
savdık	sav	Verb	Verb
parlıyordu	parla	Verb	Verb
bitirin	bit	Verb	Verb
kaçacağım	kaç	Verb	Verb
bulanıyor	bulan	Verb	Verb
duydunuz	duy	Verb	Verb
dikerek	dik	Verb	Verb
dinliyordum	dinle	Verb	Verb
ayıplamaya	ayıpla	Verb	Noun
kalkacaksınız	kalk	Verb	Verb
hırpalayıp	hırpala	Verb	Verb
vermeye	ver	Verb	Noun
ederseniz	et	Verb	Verb
bırakıp	bırak	Verb	Verb
çekileceğim	çek	Verb	Verb
çarparak	çarp	Verb	Verb
daldı	dal	Verb	Verb
silkinerek	silkin	Verb	Verb
söylendi	söyle	Verb	Verb
gecikmede	gecik	Verb	Noun
yayarlarsa	yay	Verb	Verb
yapmışlardır	yap	Verb	Verb
mahvolur	mahvol	Verb	Verb
vazgeçer	vazgeç	Verb	Verb
yapıp	yap	Verb	Verb
götürmeli	götür	Verb	Verb
yapışır	yapış	Verb	Verb
getiririm	getir	Verb	Verb
yarasın	yara	Verb	Verb
kaldırıp	kaldır	Verb	Verb
gideriz	git	Verb	Verb
bastı	bas	Verb	Verb
götürürken	götür	Verb	Verb
ısmarlamıştı	ısmarla	Verb	Verb
giyindi	giy	Verb	Verb
çıkmadan	çık	Verb	Noun
yapacakları	yap	Verb	Noun
konuşmak	konuş	Verb	Noun
uğradı	uğra	Verb	Verb
dinleyecek	dinle	Verb	Verb
yığılmış	yığ	Verb	Verb
gömülerek	göm	Verb	Verb
hıçkıra	hıçkır	Verb	Verb
ağlıyordu	ağla	Verb	Verb
daldırmış	dal	Verb	Verb
yolmaya	yol	Verb	Noun
çalışıyor	çalış	Verb	Verb
üşüme	üşü	Verb	Noun
tutulmuş	tut	Verb	Verb
ürperiyordu	ürper	Verb	Verb
durduktan	dur	Verb	Noun
bozulmuş	boz	Verb	Verb
gidermek	gider	Verb	Noun
koyuldu	koy	Verb	Verb
koşturuyordu	koş	Verb	Verb
bozdu	boz	Verb	Verb
kandırmak	kan	Verb	Noun
söylediklerimin	söyle	Verb	Noun
tekrarladım	tekrarla	Verb	Verb
alındı	al	Verb	Verb
almadan	al	Verb	Noun
halletmek	hallet	Verb	Noun
gelmesi	gel	Verb	Noun
hiddetlendirdi	hiddet	Noun	Verb
koşuyordu	koş	Verb	Verb
kanatlanmış	kanat	Noun	Verb
söylediğimiz	söyle	Verb	Adj
kovalarken	kovala	Verb	Verb
doğmuştu	doğ	Verb	Verb
etmiştik	et	Verb	Verb
okuyucular	oku	Verb	Noun
öğrendiler	öğren	Verb	Verb
götürmekti	götür	Verb	Verb
kaplamaya	kapla	Verb	Noun
ulaştıkları	ulaş	Verb	Adj
bastık	bas	Verb	Verb
beklenebilirdi	bekle	Verb	Verb
korkuyormuş	kork	Verb	Verb
evlendirmenin	evlen	Verb	Noun
hesaplamıştı	hesapla	Verb	Verb
kıyabilirdi	kıy	Verb	Verb
sıkışsa	sıkış	Verb	Verb
yapılabilirdi	yap	Verb	Verb
evlenmeler	evlen	Verb	Noun
göstermeli	göster	Verb	Adj
koymalıydı	koy	Verb	Verb
vererek	ver	Verb	Verb
basmalıydı	bas	Verb	Verb
etmeli	et	Verb	Adj
içirmeliydi	iç	Verb	Verb
kopsa	kop	Verb	Verb
gelirdi	gel	Verb	Verb
çıkabilirdi	çık	Verb	Verb
avutacak	avut	Verb	Adj
bulmuştu	bul	Verb	Verb
sayardı	say	Verb	Verb
atar	at	Verb	Verb
desteklemesi	destekle	Verb	Noun
edecekti	et	Verb	Verb
etmesine	et	Verb	Noun
geleceklerdi	gel	Verb	Verb
duyması	duy	Verb	Noun
tanışmayı	tanış	Verb	Noun
edince	et	Verb	Verb
gelişini	gel	Verb	Noun
duyar	duy	Verb	Verb
koşan	koş	Verb	Adj
gelişi	gel	Verb	Noun
uyandıracak	uyan	Verb	Adj
okşayacaktı	okşa	Verb	Verb
reddedilirdi	reddet	Verb	Verb
uçarak	uç	Verb	Verb
aştıktan	aş	Verb	Noun
durdurdu	dur	Verb	Verb
kararmış	kar	Verb	Verb
kullanıyordu	kullan	Verb	Verb
yanmıştı	yan	Verb	Verb
dalarak	dal	Verb	Verb
kurulandı	kurula	Verb	Verb
içiyor	iç	Verb	Verb
diktin	dik	Verb	Verb
kesmeni	kes	Verb	Noun
girerken	gir	Verb	Verb
selamlaşmaya	selam	Noun	Noun
çıkmış	çık	Verb	Verb
yudumladığını	yudumla	Verb	Noun
umursamadan	umursa	Verb	Noun
çatıyordu	çat	Verb	Verb
fırlamış	fırla	Verb	Adj
uğratmıştı	uğra	Verb	Verb
uzandı	uza	Verb	Verb
gelirse	gel	Verb	Verb
işitiriz	işit	Verb	Verb
dedim	de	Verb	Verb
kıvıracağım	kıvır	Verb	Verb
dediler	de	Verb	Verb
kıvıracak	kıvır	Verb	Verb
kıvırtması	kıvır	Verb	Noun
ettin	et	Verb	Verb
yakışır	yakış	Verb	Verb
soruyorum	sor	Verb	Verb
kokuyor	kok	Verb	Verb
köpürerek	köpür	Verb	Verb
esiyordu	es	Verb	Verb
tırmalayan	tırmala	Verb	Adj
yükseliyordu	yüksel	Verb	Verb
geziyordu	gez	Verb	Verb
koşuşan	koşuş	Verb	Adj
ilerliyorlardı	ilerle	Verb	Verb
yöneten	yönet	Verb	Adj
denetleyen	denetle	Verb	Adj
serilen	ser	Verb	Adj
sersemlemişti	sersemle	Verb	Verb
korkmuştu	kork	Verb	Verb
hissettiyse	hisset	Verb	Verb
döndürmüştü	dön	Verb	Verb
şaşırtıyordu	şaşır	Verb	Verb
korumasına	koru	Verb	Noun
duyuyor	duy	Verb	Verb
kaybetmeye	kaybet	Verb	Noun
korkuyordu	kork	Verb	Verb
çöken	çök	Verb	Adj
bindirip	bin	Verb	Verb
bağladı	bağla	Verb	Verb
katıyor	kat	Verb	Verb
alıyor	al	Verb	Verb
yığıyor	yığ	Verb	Verb
fırlatıyordu	fırla	Verb	Verb
gittiğini	git	Verb	Noun
zannetti	zannet	Verb	Verb
dikilip	dik	Verb	Verb
beklemeye	bekle	Verb	Noun
görününce	görün	Verb	Verb
bakındı	bakın	Verb	Verb
çöreklenen	çörek	Noun	Adj
olduysa	ol	Verb	Verb
kayboluvermişti	kaybol	Verb	Verb
gülümseyen	gülümse	Verb	Adj
uzayıp	uza	Verb	Verb
beklemekteydi	bekle	Verb	Verb
geldiler	gel	Verb	Verb
uzatarak	uza	Verb	Verb
doladı	dola	Verb	Verb
saldıracaktı	sal	Verb	Verb
olacakları	ol	Verb	Noun
ayrılıp	ayır	Verb	Verb
kudurmuş	kudur	Verb	Adj
hırlayan	hırla	Verb	Adj
yakaladı	yakala	Verb	Verb
tutup	tut	Verb	Verb
yatıştırmaya	yatış	Verb	Noun
çalışırken	çalış	Verb	Verb
korkacak	kork	Verb	Adj
diyordu	de	Verb	Verb
edeceğinizi	et	Verb	Noun
sandı	san	Verb	Verb
yumacak	yum	Verb	Adj
öğrenip	öğren	Verb	Verb
alışır	alış	Verb	Verb
sarılabileceğim	sar	Verb	Verb
diyor	de	Verb	Verb
gülüyordu	gül	Verb	Verb
hırlayıp	hırla	Verb	Verb
kabararak	kabar	Verb	Verb
süzmekte	süz	Verb	Noun
öğrenecek	öğren	Verb	Verb
kaybetmeden	kaybet	Verb	Noun
alışmalı	alış	Verb	Verb
yatıştırana	yatış	Verb	Noun
sertleştirdi	sert	Adj	Verb
yat	yat	Verb	Verb
öğretmişti	öğret	Verb	Verb
istemeye	iste	Verb	Noun
eğdi	eğ	Verb	Verb
açtı	aç	Verb	Verb
sarılırken	sar	Verb	Verb
diyorum	de	Verb	Verb
uyarıyordu	uyar	Verb	Verb
kalkmak	kalk	Verb	Noun
saydığı	say	Verb	Adj
tekrarlanmasına	tekrarla	Verb	Noun
kucaklamasından	kucakla	Verb	Noun
yatışıp	yatış	Verb	Verb
yüklenmişti	yükle	Verb	Verb
takıldı	tak	Verb	Verb
götürdüklerinden	götür	Verb	Noun
öğrenmek	öğren	Verb	Noun
koşarak	koş	Verb	Verb
yapılmış	yap	Verb	Verb
ilerlemeye	ilerle	Verb	Noun
uzanıyor	uza	Verb	Verb
oluşturuyordu	oluş	Verb	Verb
uzanıyordu	uza	Verb	Verb
doya	doy	Verb	Verb
seyretmesine	seyret	Verb	Noun
yanan	yan	Verb	Adj
saldırdı	sal	Verb	Verb
girip	gir	Verb	Verb
kesmişti	kes	Verb	Verb
uyarmaya	uyar	Verb	Noun
görmeden	gör	Verb	Noun
kabartıp	kabar	Verb	Verb
yapacaktı	yap	Verb	Verb
çakılıp	çak	Verb	Verb
koştuğundan	koş	Verb	Noun
durdurabildi	dur	Verb	Verb
saldırdığı	sal	Verb	Noun
harcamıştı	harca	Verb	Verb
kaybedip	kaybet	Verb	Verb
oturakaldı	otur	Verb	Verb
korumalı	koru	Verb	Adj
edebilmeliydi	et	Verb	Verb
gelelim	gel	Verb	Verb
koruyan	koru	Verb	Adj
olduğundan	ol	Verb	Noun
duyduğu	duy	Verb	Noun
edildiği	et	Verb	Noun
vazgeçip	vazgeç	Verb	Verb
dizginlemeye	dizginle	Verb	Noun
hissetmesine	hisset	Verb	Noun
hırlamak	hırla	Verb	Noun
davranışta	davran	Verb	Noun
hırpalamak	hırpala	Verb	Noun
gererek	ger	Verb	Verb
sıkıla	sık	Verb	Verb
dönerse	dön	Verb	Verb
dönsün	dön	Verb	Verb
kesiyordu	kes	Verb	Verb
seslendi	seslen	Verb	Verb
koş	koş	Verb	Verb
olmaksızın	ol	Verb	Verb
getireceğe	getir	Verb	Noun
benziyor	benze	Verb	Verb
öğrenmesi	öğren	Verb	Noun
başlarsa	başla	Verb	Verb
dolanmayı	dola	Verb	Noun
denedi	dene	Verb	Verb
kestirmeye	kes	Verb	Noun
saparak	sap	Verb	Verb
dikiliyordu	dik	Verb	Verb
bulup	bul	Verb	Verb
koşup	koş	Verb	Verb
atlatmayı	atla	Verb	Noun
götüren	götür	Verb	Adj
atlatmaya	atla	Verb	Noun
çalıştıysa	çalış	Verb	Verb
bırakmaya	bırak	Verb	Noun
kalmıştı	kal	Verb	Verb
çarpışarak	çarp	Verb	Verb
abanıverdi	aban	Verb	Verb
düşmekle	düş	Verb	Noun
koşmakta	koş	Verb	Noun
attı	at	Verb	Verb
doğrulmak	doğrul	Verb	Noun
eşelerken	eşele	Verb	Verb
incinen	incin	Verb	Adj
düşünüp	düşün	Verb	Verb
kuduruyordu	kudur	Verb	Verb
açılmıştı	aç	Verb	Verb
vermeksizin	ver	Verb	Verb
takılmıştı	tak	Verb	Verb
koşulurmuş	koş	Verb	Verb
öğretecekti	öğret	Verb	Verb
almış	al	Verb	Verb
kovalıyordu	kovala	Verb	Verb
zorlanmadan	zorla	Verb	Noun
dolanıp	dola	Verb	Verb
durmuştu	dur	Verb	Verb
iniyordu	in	Verb	Verb
yaklaştığını	yaklaş	Verb	Noun
atılmaya	at	Verb	Noun
koyacaktı	koy	Verb	Verb
avlanan	avla	Verb	Adj
atarak	at	Verb	Verb
yuvarlandı	yuvarla	Verb	Verb
kırıcı	kır	Verb	Adj
kurtulmak	kurtul	Verb	Noun
dikildiğinde	dik	Verb	Noun
yatmıştı	yat	Verb	Verb
kırış	kır	Verb	Noun
gerilmişti	ger	Verb	Verb
ıskalayınca	ıskala	Verb	Verb
takırdadı	takırda	Verb	Verb
gören	gör	Verb	Adj
telaşlanmış	telaş	Noun	Verb
dürülmüş	dür	Verb	Verb
incinmişti	incin	Verb	Verb
yaptıkları	yap	Verb	Noun
kaybetmiş	kaybet	Verb	Verb
yuvarlanıp	yuvarla	Verb	Verb
alınmıştı	al	Verb	Verb
inen	in	Verb	Adj
saldırmıştı	sal	Verb	Verb
zıplamışken	zıpla	Verb	Verb
saldırınca	sal	Verb	Verb
yuvarlanmıştı	yuvarla	Verb	Verb
yetişti	yetiş	Verb	Verb
kovalayıp	kovala	Verb	Verb
uzaklaştırdı	uzak	Adj	Verb
okşamaları	okşa	Verb	Noun
sakinleşebildi	sakin	Adj	Verb
karşılanır	karşıla	Verb	Verb
kesilip	kes	Verb	Verb
yıkılan	yık	Verb	Adj
gitmişti	git	Verb	Verb
çıkıyordu	çık	Verb	Verb
bekliyorlardı	bekle	Verb	Verb
dolayarak	dola	Verb	Verb
tutmayı	tut	Verb	Noun
öğrenmişti	öğren	Verb	Verb
çıkan	çık	Verb	Adj
dokunacak	doku	Verb	Verb
hırlayarak	hırla	Verb	Verb
sokuluyor	sok	Verb	Verb
okşayarak	okşa	Verb	Verb
yatıştırıyordu	yatış	Verb	Verb
tırmanıp	tırman	Verb	Verb
kıvrıldı	kıvır	Verb	Verb
saran	sar	Verb	Adj
okşuyordu	okşa	Verb	Verb
inliyordu	inle	Verb	Verb
durmasına	dur	Verb	Noun
şaşırmış	şaşır	Verb	Adj
öfkelenmişti	öfke	Noun	Verb
gezdirmekle	gez	Verb	Noun
ettiklerini	et	Verb	Noun
girmek	gir	Verb	Noun
yöneldiler	yönel	Verb	Verb
uzanmakta	uza	Verb	Noun
homurdanınca	homurda	Verb	Verb
kabarttı	kabar	Verb	Verb
alalım	al	Verb	Verb
paylaşsınlar	paylaş	Verb	Verb
dalaşmadan	dalaş	Verb	Noun
kanıtlamak	kanıtla	Verb	Noun
onayladı	onayla	Verb	Verb
zannettiniz	zannet	Verb	Verb
parçalayıverir	parçala	Verb	Verb
girme	gir	Verb	Noun
gere	ger	Verb	Verb
ayırmadan	ayır	Verb	Noun
gelebilecek	gel	Verb	Adj
korunmak	koru	Verb	Noun
kolluyordu	kolla	Verb	Verb
yatmış	yat	Verb	Verb
olabileceği	ol	Verb	Noun
aradı	ara	Verb	Verb
korkulacak	kork	Verb	Adj
yattı	yat	Verb	Verb
bitenleri	bit	Verb	Noun
gözlemeye	gözle	Verb	Noun
hortladığı	hortla	Verb	Adj
fırlayacaktı	fırla	Verb	Verb
korumaya	koru	Verb	Noun
alışabilme	alış	Verb	Noun
yaratılışından	yara	Verb	Noun
sağlıyor	sağla	Verb	Verb
alıştı	alış	Verb	Verb
sokulması	sok	Verb	Noun
görülmüş	gör	Verb	Verb
eğmeleri	eğ	Verb	Noun
davranmakla	davran	Verb	Noun
yetindi	yetin	Verb	Verb
diklendiği	dikle	Verb	Adj
kalsa	kal	Verb	Verb
olabilirlerdi	ol	Verb	Verb
bırakmalarıydı	bırak	Verb	Verb
durmaya	dur	Verb	Noun
yaklaşacak	yaklaş	Verb	Verb
gidinceye	git	Verb	Noun
aldığı	al	Verb	Noun
kalmakta	kal	Verb	Noun
anladı	anla	Verb	Verb
bağlandığı	bağla	Verb	Adj
gösterdiği	göster	Verb	Noun
yumuyordu	yum	Verb	Verb
bırakacağı	bırak	Verb	Adj
yağmaladığı	yağmala	Verb	Adj
dökülen	dök	Verb	Adj
kanlar	kanla	Verb	Adj
unutulacak	unut	Verb	Verb
yerleşmişti	yerleş	Verb	Verb
dürtüyor	dürt	Verb	Verb
kışkırtıyordu	kışkırt	Verb	Verb
sayıp	say	Verb	Verb
saldırmasına	sal	Verb	Noun
faydalanıyor	fayda	Noun	Verb
dayanan	dayan	Verb	Adj
çalışacaktı	çalış	Verb	Verb
üzmek	üz	Verb	Noun
bozucu	boz	Verb	Noun
tutuyordu	tut	Verb	Verb
geçince	geç	Verb	Verb
korunan	koru	Verb	Adj
savuşuyordu	savuş	Verb	Verb
azıttığı	azıt	Verb	Adj
bakışlarındaki	bak	Verb	Adj
çevirip	çevir	Verb	Verb
dolanmasına	dola	Verb	Noun
kaptırdığı	kap	Verb	Noun
dayanmak	daya	Verb	Noun
uzaklaşıyordu	uzak	Adj	Verb
uzaklaşmalarda	uzak	Adj	Noun
alçaltmadan	alçal	Verb	Verb
koruyarak	koru	Verb	Verb
ayrılmaya	ayır	Verb	Noun
getirmişti	getir	Verb	Verb
görecek	gör	Verb	Verb
kalkıyor	kalk	Verb	Verb
kıyaslandığında	kıyasla	Verb	Noun
kalıyordu	kal	Verb	Verb
tanıması	tanı	Verb	Noun
paylaşıyorlarsa	paylaş	Verb	Verb
anlatılsa	anla	Verb	Verb
anlayacaktı	anla	Verb	Verb
anlamıştı	anla	Verb	Verb
yetinmeliydi	yetin	Verb	Verb
davranışlarını	davran	Verb	Noun
konuşmalarını	konuş	Verb	Noun
izleye	izle	Verb	Verb
edinebilmişti	edin	Verb	Verb
tartmaya	tart	Verb	Noun
seviyorsa	sev	Verb	Verb
veriyorsa	ver	Verb	Verb
sevdiklerini	sev	Verb	Noun
koruyordu	koru	Verb	Verb
yaşadıkları	yaşa	Verb	Adj
yaklaştıklarında	yaklaş	Verb	Noun
