pırıl	pırıl+Dup
zangır	zangır+Dup
tefek	tefek+Dup
ciyak	ciyak+Dup
yamru	yamru+Dup
didik	didik+Dup
horul	horul+Dup
ışıl	ışıl+Dup
gürül	gürül+Dup
tıklım	tıklım+Dup
topar	topar+Dup
püfür	püfür+Dup
gümbür	gümbür+Dup
sabuk	sabuk+Dup
cıvıl	cıvıl+Dup
dobra	dobra+Dup
çıtır	çıtır+Dup
meyal	meyal+Dup
fırıl	fırıl+Dup
kıtır	kıtır+Dup
cubur	cubur+Dup
yamalak	yamalak+Dup
