da	da+Conj
ile	ile+Conj
ve	ve+Conj
değil	değil+Conj
oysa	oysa+Conj
ki	ki+Conj
ne	ne+Conj
çünkü	çünkü+Conj
de	de+Conj
fakat	fakat+Conj
eğer	eğer+Conj
ya	ya+Conj
yahut	yahut+Conj
ancak	ancak+Conj
halbuki	halbuki+Conj
ama	ama+Conj
zira	zira+Conj
hatta	hatta+Conj
yani	yani+Conj
veya	veya+Conj
dahi	dahi+Conj
veyahut	veyahut+Conj
ister	ister+Conj
meğer	meğer+Conj
gerekse	gerekse+Conj
örneğin	örneğin+Conj
şayet	şayet+Conj
meğerse	meğerse+Conj
