geri	geri+Adverb
çıkarken	çıkar+Noun+A3sg+Pnon+Nom^DB+Verb+Zero^DB+Adverb+While
birlikte	birlikte+Adverb
rahatlarken	rahatla+Verb+Pos+Aor^DB+Adverb+While
azalarak	azal+Verb+Pos^DB+Adverb+ByDoingSo
ilk	ilk+Adverb
olarak	ol+Verb+Pos^DB+Adverb+ByDoingSo
aksine	aksine+Adverb
olurken	ol+Verb+Pos+Aor^DB+Adverb+While
başta	başta+Adverb
bile	bile+Adverb
pek	pek+Adverb
daha	daha+Adverb
verince	ver+Verb+Pos^DB+Adverb+When
büyürken	büyü+Verb+Pos+Aor^DB+Adverb+While
yalnızca	yalnızca+Adverb
en	en+Adverb
fazla	fazla+Adverb
sonra	sonra+Adverb
mutlaka	mutlaka+Adverb
sığınılarak	sığın+Verb^DB+Verb+Pass+Pos^DB+Adverb+ByDoingSo
öyle	öyle+Adverb
nasıl	nasıl+Adverb
şimdi	şimdi+Adverb
eskiden	eskiden+Adverb
artık	artık+Adverb
asla	asla+Adverb
evet	evet+Adverb
ebediyen	ebediyen+Adverb
gülerek	gül+Verb+Pos^DB+Adverb+ByDoingSo
sadece	sadece+Adverb
önce	önce+Adverb
yokken	yok+Adj^DB+Verb+Zero^DB+Adverb+While
biraz	biraz+Adverb
sanki	sanki+Adverb
dururken	dur+Verb+Pos+Aor^DB+Adverb+While
oynarken	oyna+Verb+Pos+Aor^DB+Adverb+While
öpüp	öp+Verb+Pos^DB+Adverb+AfterDoingSo
inerken	in+Verb+Pos+Aor^DB+Adverb+While
hiç	hiç+Adverb
vermeden	ver+Verb+Pos^DB+Adverb+WithoutHavingDoneSo
uçuşup	uçuş+Verb+Pos^DB+Adverb+AfterDoingSo
durmaksızın	dur+Verb+Pos^DB+Adverb+WithoutHavingDoneSo
yiyip	ye+Verb+Pos^DB+Adverb+AfterDoingSo
çekiştirip	çekiş+Verb^DB+Verb+Caus+Pos^DB+Adverb+AfterDoingSo
kalkarak	kalk+Verb+Pos^DB+Adverb+ByDoingSo
dönerek	dön+Verb+Pos^DB+Adverb+ByDoingSo
sonunda	sonunda+Adverb
gelip	gel+Verb+Pos^DB+Adverb+AfterDoingSo
açık	açık+Adverb
peyderpey	peyderpey+Adverb
ederek	et+Verb+Pos^DB+Adverb+ByDoingSo
sıkarak	sık+Verb+Pos^DB+Adverb+ByDoingSo
eğilip	eğ+Verb^DB+Verb+Pass+Pos^DB+Adverb+AfterDoingSo
gerçekten	gerçekten+Adverb
sallarken	salla+Verb+Pos+Aor^DB+Adverb+While
yeniden	yeniden+Adverb
yalnız	yalnız+Adverb
söyleyerek	söyle+Verb+Pos^DB+Adverb+ByDoingSo
sonradan	sonradan+Adverb
hep	hep+Adverb
pekala	pekala+Adverb
konuşurken	konuş+Verb+Pos+Aor^DB+Adverb+While
bakarak	bak+Verb+Pos^DB+Adverb+ByDoingSo
diyerek	de+Verb+Pos^DB+Adverb+ByDoingSo
hala	hala+Adverb
yok	yok+Adverb
büsbütün	büsbütün+Adverb
daima	daima+Adverb
bayağı	bayağı+Adverb
yudumlayarak	yudumla+Verb+Pos^DB+Adverb+ByDoingSo
yürüyüp	yürü+Verb+Pos^DB+Adverb+AfterDoingSo
ısırarak	ısır+Verb+Pos^DB+Adverb+ByDoingSo
birdenbire	birdenbire+Adverb
aslında	aslında+Adverb
muhtemelen	muhtemelen+Adverb
gelince	gel+Verb+Pos^DB+Adverb+When
elbette	elbette+Adverb
işte	işte+Adverb
çıkarıp	çık+Verb^DB+Verb+Caus+Pos^DB+Adverb+AfterDoingSo
tokalaşırken	toka+Noun+A3sg+Pnon+Nom^DB+Verb+Become+Pos+Aor^DB+Adverb+While
böyle	böyle+Adverb
geç	geç+Adverb
oturup	otur+Verb+Pos^DB+Adverb+AfterDoingSo
olup	ol+Verb+Pos^DB+Adverb+AfterDoingSo
otururlarken	otur+Verb+Pos+Aor+A3pl^DB+Adverb+While
hani	hani+Adverb
gayet	gayet+Adverb
titreyerek	titre+Verb+Pos^DB+Adverb+ByDoingSo
önceleri	önceleri+Adverb
gidip	git+Verb+Pos^DB+Adverb+AfterDoingSo
otururken	otur+Verb+Pos+Aor^DB+Adverb+While
önceden	önceden+Adverb
kapanıp	kapa+Verb^DB+Verb+Pass+Pos^DB+Adverb+AfterDoingSo
şimdilik	şimdilik+Adverb
tamamen	tamamen+Adverb
sunup	sun+Verb+Pos^DB+Adverb+AfterDoingSo
zaten	zaten+Adverb
mütemadiyen	mütemadiyen+Adverb
alırken	al+Verb+Pos+Aor^DB+Adverb+While
derken	de+Verb+Pos+Aor^DB+Adverb+While
yaslanıp	yasla+Verb^DB+Verb+Pass+Pos^DB+Adverb+AfterDoingSo
tekrar	tekrar+Adverb
bizzat	bizzat+Adverb
dokunarak	dokun+Verb+Pos^DB+Adverb+ByDoingSo
böbürlenerek	böbürlen+Verb+Pos^DB+Adverb+ByDoingSo
çekerek	çek+Verb+Pos^DB+Adverb+ByDoingSo
oynayarak	oyna+Verb+Pos^DB+Adverb+ByDoingSo
evvela	evvela+Adverb
getirip	getir+Verb+Pos^DB+Adverb+AfterDoingSo
niçin	niçin+Adverb
ayrıca	ayrıca+Adverb
yakarken	yak+Verb+Pos+Aor^DB+Adverb+While
giyip	giy+Verb+Pos^DB+Adverb+AfterDoingSo
yanıp	yan+Verb+Pos^DB+Adverb+AfterDoingSo
sallayıp	salla+Verb+Pos^DB+Adverb+AfterDoingSo
konuşarak	konuş+Verb+Pos^DB+Adverb+ByDoingSo
belirterek	belir+Verb^DB+Verb+Caus+Pos^DB+Adverb+ByDoingSo
seyrederek	seyret+Verb+Pos^DB+Adverb+ByDoingSo
konuşup	konuş+Verb+Pos^DB+Adverb+AfterDoingSo
sahnedeyken	sahne+Noun+A3sg+Pnon+Loc^DB+Verb+Zero^DB+Adverb+While
tıpkı	tıpkı+Adverb
geçirirken	geç+Verb^DB+Verb+Caus+Pos+Aor^DB+Adverb+While
kurtarıp	kurtar+Verb+Pos^DB+Adverb+AfterDoingSo
atarken	at+Verb+Pos+Aor^DB+Adverb+While
fırlayıp	fırla+Verb+Pos^DB+Adverb+AfterDoingSo
adeta	adeta+Adverb
baştanbaşa	baştanbaşa+Adverb
edip	et+Verb+Pos^DB+Adverb+AfterDoingSo
izlerken	izle+Verb+Pos+Aor^DB+Adverb+While
giderek	git+Verb+Pos^DB+Adverb+ByDoingSo
çabucak	çabucak+Adverb
diyemeden	de+Verb+Pos^DB+Adverb+WithoutBeingAbleToHaveDoneSo
vurarak	vur+Verb+Pos^DB+Adverb+ByDoingSo
faydalanarak	fayda+Noun+A3sg+Pnon+Nom^DB+Verb+Acquire+Pos^DB+Adverb+ByDoingSo
henüz	henüz+Adverb
düşündükçe	düşün+Verb+Pos^DB+Adverb+AsLongAs
gelmişken	gel+Verb+Pos+Narr^DB+Adverb+While
bilhassa	bilhassa+Adverb
belki	belki+Adverb
tam	tam+Adverb
yayıldıkça	yay+Verb^DB+Verb+Pass+Pos^DB+Adverb+AsLongAs
alabildiğine	alabildiğine+Adverb
bazen	bazen+Adverb
rastladıkça	rastla+Verb+Pos^DB+Adverb+AsLongAs
kısmen	kısmen+Adverb
tersine	tersine+Adverb
olmadan	ol+Verb+Pos^DB+Adverb+WithoutHavingDoneSo
kalınca	kal+Verb+Pos^DB+Adverb+When
hem	hem+Adverb
düşürülüp	düş+Verb^DB+Verb+Caus^DB+Verb+Pass+Pos^DB+Adverb+AfterDoingSo
bağırıp	bağır+Verb+Pos^DB+Adverb+AfterDoingSo
şimdiden	şimdiden+Adverb
yakalayıp	yakala+Verb+Pos^DB+Adverb+AfterDoingSo
hemen	hemen+Adverb
uçarcasına	uç+Verb+Pos+Aor+A3sg^DB+Adverb+AsIf
keserek	kes+Verb+Pos^DB+Adverb+ByDoingSo
uğratıp	uğra+Verb^DB+Verb+Caus+Pos^DB+Adverb+AfterDoingSo
oldukça	oldukça+Adverb
açıkça	açık+Adj^DB+Adverb+Ly
çabuk	çabuk+Adverb
gerekirken	gerek+Verb+Pos+Aor^DB+Adverb+While
haliyle	haliyle+Adverb
kalkarken	kalk+Verb+Pos+Aor^DB+Adverb+While
gelerek	gel+Verb+Pos^DB+Adverb+ByDoingSo
şüphesiz	şüphesiz+Adverb
üzülerek	üz+Verb^DB+Verb+Pass+Pos^DB+Adverb+ByDoingSo
bozularak	boz+Verb^DB+Verb+Pass+Pos^DB+Adverb+ByDoingSo
getirerek	getir+Verb+Pos^DB+Adverb+ByDoingSo
lütfen	lütfen+Adverb
çoktandır	çoktandır+Adverb
neredeyse	neredeyse+Adverb
çıkıp	çık+Verb+Pos^DB+Adverb+AfterDoingSo
giyerken	giy+Verb+Pos+Aor^DB+Adverb+While
yakalayarak	yakala+Verb+Pos^DB+Adverb+ByDoingSo
basarak	bas+Verb+Pos^DB+Adverb+ByDoingSo
gözetleyerek	gözetle+Verb+Pos^DB+Adverb+ByDoingSo
sokulup	sok+Verb^DB+Verb+Pass+Pos^DB+Adverb+AfterDoingSo
bastırıp	bas+Verb^DB+Verb+Caus+Pos^DB+Adverb+AfterDoingSo
süslenip	süsle+Verb^DB+Verb+Reflex+Pos^DB+Adverb+AfterDoingSo
zorlayarak	zorla+Verb+Pos^DB+Adverb+ByDoingSo
süzerek	süz+Verb+Pos^DB+Adverb+ByDoingSo
iyice	iyi+Adj^DB+Adverb+Ly
ağırlaşıp	ağır+Adj^DB+Verb+Become+Pos^DB+Adverb+AfterDoingSo
sırf	sırf+Adverb
bari	bari+Adverb
gene	gene+Adverb
mırıldanıp	mırılda+Verb^DB+Verb+Pass+Pos^DB+Adverb+AfterDoingSo
giderken	gider+Noun+A3sg+Pnon+Nom^DB+Verb+Zero^DB+Adverb+While
yutkunarak	yutkun+Verb+Pos^DB+Adverb+ByDoingSo
soyup	soy+Verb+Pos^DB+Adverb+AfterDoingSo
galiba	galiba+Adverb
başlarken	başla+Verb+Pos+Aor^DB+Adverb+While
çevirirken	çevir+Verb+Pos+Aor^DB+Adverb+While
inip	in+Verb+Pos^DB+Adverb+AfterDoingSo
epey	epey+Adverb
bitince	bit+Verb+Pos^DB+Adverb+When
öperken	öp+Verb+Pos+Aor^DB+Adverb+While
varken	var+Adj^DB+Verb+Zero^DB+Adverb+While
bırakarak	bırak+Verb+Pos^DB+Adverb+ByDoingSo
hayli	hayli+Adverb
gitgide	gitgide+Adverb
demin	demin+Adverb
tıkanarak	tıka+Verb^DB+Verb+Pass+Pos^DB+Adverb+ByDoingSo
boğularak	boğ+Verb^DB+Verb+Pass+Pos^DB+Adverb+ByDoingSo
durarak	dur+Verb+Pos^DB+Adverb+ByDoingSo
baktıkça	bak+Verb+Pos^DB+Adverb+AsLongAs
ta	ta+Adverb
kaçarak	kaç+Verb+Pos^DB+Adverb+ByDoingSo
hatırladıkça	hatırla+Verb+Pos^DB+Adverb+AsLongAs
eğilerek	eğ+Verb^DB+Verb+Pass+Pos^DB+Adverb+ByDoingSo
yürüyerek	yürü+Verb+Pos^DB+Adverb+ByDoingSo
gittikçe	gittikçe+Adverb
küstahça	küstah+Adj^DB+Adverb+Ly
çiğneyip	çiğne+Verb+Pos^DB+Adverb+AfterDoingSo
geçerek	geç+Verb+Pos^DB+Adverb+ByDoingSo
anlayınca	anla+Verb+Pos^DB+Adverb+When
açalı	aç+Verb+Pos^DB+Adverb+SinceDoingSo
tekrarlayıp	tekrarla+Verb+Pos^DB+Adverb+AfterDoingSo
görünce	gör+Verb+Pos^DB+Adverb+When
herhalde	herhalde+Adverb
darılıp	darıl+Verb+Pos^DB+Adverb+AfterDoingSo
içirip	iç+Verb^DB+Verb+Caus+Pos^DB+Adverb+AfterDoingSo
küçümseyerek	küçümse+Verb+Pos^DB+Adverb+ByDoingSo
vurup	vur+Verb+Pos^DB+Adverb+AfterDoingSo
sokularak	sok+Verb^DB+Verb+Pass+Pos^DB+Adverb+ByDoingSo
göstererek	göster+Verb+Pos^DB+Adverb+ByDoingSo
şaşırarak	şaşır+Verb+Pos^DB+Adverb+ByDoingSo
körükleyerek	körükle+Verb+Pos^DB+Adverb+ByDoingSo
vazgeçirip	vazgeç+Verb^DB+Verb+Caus+Pos^DB+Adverb+AfterDoingSo
gösterirken	göster+Verb+Pos+Aor^DB+Adverb+While
söküp	sök+Verb+Pos^DB+Adverb+AfterDoingSo
ağlarken	ağla+Verb+Pos+Aor^DB+Adverb+While
ilkin	ilkin+Adverb
ölünce	öl+Verb+Pos^DB+Adverb+When
duyarak	duy+Verb+Pos^DB+Adverb+ByDoingSo
düşünerek	düşün+Verb+Pos^DB+Adverb+ByDoingSo
sürerek	sür+Verb+Pos^DB+Adverb+ByDoingSo
koyarak	koy+Verb+Pos^DB+Adverb+ByDoingSo
aldatarak	aldat+Verb+Pos^DB+Adverb+ByDoingSo
kaldırarak	kaldır+Verb+Pos^DB+Adverb+ByDoingSo
dalıp	dal+Verb+Pos^DB+Adverb+AfterDoingSo
yaşarken	yaşa+Verb+Pos+Aor^DB+Adverb+While
tutarak	tut+Verb+Pos^DB+Adverb+ByDoingSo
darıltıp	darıl+Verb^DB+Verb+Caus+Pos^DB+Adverb+AfterDoingSo
söylerken	söyle+Verb+Pos+Aor^DB+Adverb+While
hayır	hayır+Adverb
çatırdatırcasına	çatırda+Verb^DB+Verb+Caus+Pos+Aor+A3sg^DB+Adverb+AsIf
özellikle	özellikle+Adverb
böyleyken	böyle+Adj^DB+Verb+Zero^DB+Adverb+While
bakıp	bak+Verb+Pos^DB+Adverb+AfterDoingSo
tamamıyla	tamamıyla+Adverb
heyecanlanarak	heyecan+Noun+A3sg+Pnon+Nom^DB+Verb+Acquire+Pos^DB+Adverb+ByDoingSo
adice	adi+Adj^DB+Adverb+Ly
doğrularak	doğrul+Verb+Pos^DB+Adverb+ByDoingSo
keşke	keşke+Adverb
duygulanarak	duygu+Noun+A3sg+Pnon+Nom^DB+Verb+Acquire+Pos^DB+Adverb+ByDoingSo
mesela	mesela+Adverb
dökerek	dök+Verb+Pos^DB+Adverb+ByDoingSo
dikerek	dik+Verb+Pos^DB+Adverb+ByDoingSo
hırpalayıp	hırpala+Verb+Pos^DB+Adverb+AfterDoingSo
bırakıp	bırak+Verb+Pos^DB+Adverb+AfterDoingSo
çarparak	çarp+Verb+Pos^DB+Adverb+ByDoingSo
silkinerek	silkin+Verb+Pos^DB+Adverb+ByDoingSo
bırakmayıp	bırak+Verb+Neg^DB+Adverb+AfterDoingSo
yapıp	yap+Verb+Pos^DB+Adverb+AfterDoingSo
kaldırıp	kaldır+Verb+Pos^DB+Adverb+AfterDoingSo
götürürken	götür+Verb+Pos+Aor^DB+Adverb+While
gömülerek	göm+Verb^DB+Verb+Pass+Pos^DB+Adverb+ByDoingSo
kovalarken	kovala+Verb+Pos+Aor^DB+Adverb+While
vererek	ver+Verb+Pos^DB+Adverb+ByDoingSo
hele	hele+Adverb
edince	et+Verb+Pos^DB+Adverb+When
uçarak	uç+Verb+Pos^DB+Adverb+ByDoingSo
dalarak	dal+Verb+Pos^DB+Adverb+ByDoingSo
girerken	gir+Verb+Pos+Aor^DB+Adverb+While
üzerindeyken	üzer+Noun+A3sg+P3sg+Loc^DB+Verb+Zero^DB+Adverb+While
köpürerek	köpür+Verb+Pos^DB+Adverb+ByDoingSo
küçükken	küçük+Adj^DB+Verb+Zero^DB+Adverb+While
sürekli	sürekli+Adverb
bindirip	bin+Verb^DB+Verb+Caus+Pos^DB+Adverb+AfterDoingSo
dikilip	dik+Verb^DB+Verb+Pass+Pos^DB+Adverb+AfterDoingSo
görününce	görün+Verb+Pos^DB+Adverb+When
uzayıp	uza+Verb+Pos^DB+Adverb+AfterDoingSo
uzatarak	uza+Verb^DB+Verb+Caus+Pos^DB+Adverb+ByDoingSo
ayrılıp	ayır+Verb^DB+Verb+Pass+Pos^DB+Adverb+AfterDoingSo
sıkıca	sıkı+Adj^DB+Adverb+Ly
tutup	tut+Verb+Pos^DB+Adverb+AfterDoingSo
çalışırken	çalış+Verb+Pos+Aor^DB+Adverb+While
öğrenip	öğren+Verb+Pos^DB+Adverb+AfterDoingSo
hırlayıp	hırla+Verb+Pos^DB+Adverb+AfterDoingSo
kabararak	kabar+Verb+Pos^DB+Adverb+ByDoingSo
sarılırken	sar+Verb^DB+Verb+Pass+Pos+Aor^DB+Adverb+While
yatışıp	yatış+Verb+Pos^DB+Adverb+AfterDoingSo
çarçabuk	çarçabuk+Adverb
koşarak	koş+Verb+Pos^DB+Adverb+ByDoingSo
girip	gir+Verb+Pos^DB+Adverb+AfterDoingSo
kabartıp	kabar+Verb^DB+Verb+Caus+Pos^DB+Adverb+AfterDoingSo
çakılıp	çak+Verb^DB+Verb+Pass+Pos^DB+Adverb+AfterDoingSo
alamayarak	al+Verb^DB+Verb+Able+Neg^DB+Adverb+ByDoingSo
kaybedip	kaybet+Verb+Pos^DB+Adverb+AfterDoingSo
vazgeçip	vazgeç+Verb+Pos^DB+Adverb+AfterDoingSo
gererek	ger+Verb+Pos^DB+Adverb+ByDoingSo
olmaksızın	ol+Verb+Pos^DB+Adverb+WithoutHavingDoneSo
erken	erken+Adverb
saparak	sap+Verb+Pos^DB+Adverb+ByDoingSo
bulup	bul+Verb+Pos^DB+Adverb+AfterDoingSo
koşup	koş+Verb+Pos^DB+Adverb+AfterDoingSo
boşuna	boşuna+Adverb
çarpışarak	çarp+Verb^DB+Verb+Recip+Pos^DB+Adverb+ByDoingSo
eşelerken	eşele+Verb+Pos+Aor^DB+Adverb+While
düşünüp	düşün+Verb+Pos^DB+Adverb+AfterDoingSo
vermeksizin	ver+Verb+Pos^DB+Adverb+WithoutHavingDoneSo
dolanıp	dola+Verb^DB+Verb+Pass+Pos^DB+Adverb+AfterDoingSo
atarak	at+Verb+Pos^DB+Adverb+ByDoingSo
ıskalayınca	ıskala+Verb+Pos^DB+Adverb+When
öylece	öyle+Adj^DB+Adverb+Ly
böylelikle	böylelikle+Adverb
yuvarlanıp	yuvarla+Verb^DB+Verb+Reflex+Pos^DB+Adverb+AfterDoingSo
zıplamışken	zıpla+Verb+Pos+Narr^DB+Adverb+While
saldırınca	sal+Verb^DB+Verb+Caus+Pos^DB+Adverb+When
tutarken	tutar+Noun+A3sg+Pnon+Nom^DB+Verb+Zero^DB+Adverb+While
kovalayıp	kovala+Verb+Pos^DB+Adverb+AfterDoingSo
kesilip	kes+Verb^DB+Verb+Pass+Pos^DB+Adverb+AfterDoingSo
dolayarak	dola+Verb+Pos^DB+Adverb+ByDoingSo
hırlayarak	hırla+Verb+Pos^DB+Adverb+ByDoingSo
okşayarak	okşa+Verb+Pos^DB+Adverb+ByDoingSo
tırmanıp	tırman+Verb+Pos^DB+Adverb+AfterDoingSo
homurdanınca	homurda+Verb^DB+Verb+Pass+Pos^DB+Adverb+When
ülkesindeyken	ülke+Noun+A3sg+P3sg+Loc^DB+Verb+Zero^DB+Adverb+While
sayıp	say+Verb+Pos^DB+Adverb+AfterDoingSo
geçince	geç+Verb+Pos^DB+Adverb+When
çevirip	çevir+Verb+Pos^DB+Adverb+AfterDoingSo
alçaltmadan	alçal+Verb^DB+Verb+Caus+Pos^DB+Adverb+WithoutHavingDoneSo
koruyarak	koru+Verb+Pos^DB+Adverb+ByDoingSo
yine	yine+Adverb
geçerken	geçer+Adj^DB+Verb+Zero^DB+Adverb+While
denli	denli+Adverb
homurdanarak	homurda+Verb^DB+Verb+Pass+Pos^DB+Adverb+ByDoingSo
okşarlarken	okşa+Verb+Pos+Aor+A3pl^DB+Adverb+While
kalkıp	kalk+Verb+Pos^DB+Adverb+AfterDoingSo
okurken	okur+Noun+A3sg+Pnon+Nom^DB+Verb+Zero^DB+Adverb+While
uzanıp	uza+Verb^DB+Verb+Pass+Pos^DB+Adverb+AfterDoingSo
okşayıp	okşa+Verb+Pos^DB+Adverb+AfterDoingSo
okşarken	okşa+Verb+Pos+Aor^DB+Adverb+While
geçtikçe	geç+Verb+Pos^DB+Adverb+AsLongAs
avlayıp	avla+Verb+Pos^DB+Adverb+AfterDoingSo
erkenden	erkenden+Adverb
yalanıp	yala+Verb^DB+Verb+Pass+Pos^DB+Adverb+AfterDoingSo
çıkarmadan	çık+Verb^DB+Verb+Caus+Pos^DB+Adverb+WithoutHavingDoneSo
çabalarken	çabala+Verb+Pos+Aor^DB+Adverb+While
yetişip	yetiş+Verb+Pos^DB+Adverb+AfterDoingSo
geçmeden	geç+Verb+Pos^DB+Adverb+WithoutHavingDoneSo
sürterken	sürt+Verb+Pos+Aor^DB+Adverb+While
görüp	gör+Verb+Pos^DB+Adverb+AfterDoingSo
düşünürken	düşünür+Noun+A3sg+Pnon+Nom^DB+Verb+Zero^DB+Adverb+While
taşıyarak	taşı+Verb+Pos^DB+Adverb+ByDoingSo
eleyerek	ele+Verb+Pos^DB+Adverb+ByDoingSo
böylesine	böylesine+Adverb
sorup	sor+Verb+Pos^DB+Adverb+AfterDoingSo
gezinirken	gezin+Verb+Pos+Aor^DB+Adverb+While
çağırıp	çağır+Verb+Pos^DB+Adverb+AfterDoingSo
çekip	çek+Verb+Pos^DB+Adverb+AfterDoingSo
öylesine	öylesine+Adverb
takılıp	takıl+Verb+Pos^DB+Adverb+AfterDoingSo
silkinip	silkin+Verb+Pos^DB+Adverb+AfterDoingSo
uçup	uç+Verb+Pos^DB+Adverb+AfterDoingSo
bitip	bit+Verb+Pos^DB+Adverb+AfterDoingSo
solup	sol+Verb+Pos^DB+Adverb+AfterDoingSo
yükselip	yüksel+Verb+Pos^DB+Adverb+AfterDoingSo
apansız	apansız+Adverb
açıp	aç+Verb+Pos^DB+Adverb+AfterDoingSo
dağılıp	dağıl+Verb+Pos^DB+Adverb+AfterDoingSo
genellikle	genellikle+Adverb
mırıldanarak	mırılda+Verb^DB+Verb+Pass+Pos^DB+Adverb+ByDoingSo
genişçe	geniş+Adj^DB+Adverb+Ly
yürürken	yürü+Verb+Pos+Aor^DB+Adverb+While
acaba	acaba+Adverb
ansızın	ansızın+Adverb
düpedüz	düpedüz+Adverb
genelde	genelde+Adverb
tutunarak	tutun+Verb+Pos^DB+Adverb+ByDoingSo
sürünerek	sürün+Verb+Pos^DB+Adverb+ByDoingSo
anlayamadan	anla+Verb+Pos^DB+Adverb+WithoutBeingAbleToHaveDoneSo
kabullenerek	kabullen+Verb+Pos^DB+Adverb+ByDoingSo
epeyce	epeyce+Adverb
kaybolup	kaybol+Verb+Pos^DB+Adverb+AfterDoingSo
uzatıp	uza+Verb^DB+Verb+Caus+Pos^DB+Adverb+AfterDoingSo
olunca	ol+Verb+Pos^DB+Adverb+When
böylece	böylece+Adverb
söyleyip	söyle+Verb+Pos^DB+Adverb+AfterDoingSo
isterken	iste+Verb+Pos+Aor^DB+Adverb+While
tümüyle	tümüyle+Adverb
yaklaşıp	yaklaş+Verb+Pos^DB+Adverb+AfterDoingSo
yetip	yet+Verb+Pos^DB+Adverb+AfterDoingSo
kenarındayken	kenar+Noun+A3sg+P3sg+Loc^DB+Verb+Zero^DB+Adverb+While
eğerek	eğ+Verb+Pos^DB+Adverb+ByDoingSo
aşınca	aş+Verb+Pos^DB+Adverb+When
peşinen	peşinen+Adverb
gülümseyerek	gülümse+Verb+Pos^DB+Adverb+ByDoingSo
tamamiyle	tamamiyle+Adverb
sevinerek	sevin+Verb+Pos^DB+Adverb+ByDoingSo
sürüp	sür+Verb+Pos^DB+Adverb+AfterDoingSo
verirken	ver+Verb+Pos+Aor^DB+Adverb+While
birleşip	birleş+Verb+Pos^DB+Adverb+AfterDoingSo
dolaşıp	dolaş+Verb+Pos^DB+Adverb+AfterDoingSo
nihayet	nihayet+Adverb
boşverip	boşver+Verb+Pos^DB+Adverb+AfterDoingSo
ederken	eder+Noun+A3sg+Pnon+Nom^DB+Verb+Zero^DB+Adverb+While
şaşıp	şaş+Verb+Pos^DB+Adverb+AfterDoingSo
kullanarak	kullan+Verb+Pos^DB+Adverb+ByDoingSo
yaparak	yap+Verb+Pos^DB+Adverb+ByDoingSo
gördükçe	gör+Verb+Pos^DB+Adverb+AsLongAs
ezilip	ez+Verb^DB+Verb+Pass+Pos^DB+Adverb+AfterDoingSo
kırıp	kır+Verb+Pos^DB+Adverb+AfterDoingSo
itip	it+Verb+Pos^DB+Adverb+AfterDoingSo
hınzırcasına	hınzır+Noun+A3sg+Pnon+Nom^DB+Verb+Zero^DB+Adverb+AsIf
isteyip	iste+Verb+Pos^DB+Adverb+AfterDoingSo
bırakalı	bırak+Verb+Pos^DB+Adverb+SinceDoingSo
sabahleyin	sabahleyin+Adverb
akşamleyin	akşamleyin+Adverb
alıp	al+Verb+Pos^DB+Adverb+AfterDoingSo
yerken	yer+Noun+A3sg+Pnon+Nom^DB+Verb+Zero^DB+Adverb+While
iken	iken+Adverb
kabaca	kabaca+Adverb
ezip	ez+Verb+Pos^DB+Adverb+AfterDoingSo
götürüp	götür+Verb+Pos^DB+Adverb+AfterDoingSo
kaçıp	kaç+Verb+Pos^DB+Adverb+AfterDoingSo
yayılıp	yay+Verb^DB+Verb+Pass+Pos^DB+Adverb+AfterDoingSo
hissedince	hisset+Verb+Pos^DB+Adverb+When
tanıyınca	tanı+Verb+Pos^DB+Adverb+When
bilerek	bil+Verb+Pos^DB+Adverb+ByDoingSo
oynatıp	oynat+Verb+Pos^DB+Adverb+AfterDoingSo
havalandırarak	hava+Noun+A3sg+Pnon+Nom^DB+Verb+Acquire^DB+Verb+Caus+Pos^DB+Adverb+ByDoingSo
evirip	evir+Verb+Pos^DB+Adverb+AfterDoingSo
yığarak	yığ+Verb+Pos^DB+Adverb+ByDoingSo
yanarken	yan+Verb+Pos+Aor^DB+Adverb+While
durup	dur+Verb+Pos^DB+Adverb+AfterDoingSo
asılıp	as+Verb^DB+Verb+Pass+Pos^DB+Adverb+AfterDoingSo
kurup	kur+Verb+Pos^DB+Adverb+AfterDoingSo
daldırıp	dal+Verb^DB+Verb+Caus+Pos^DB+Adverb+AfterDoingSo
gülünce	gül+Verb+Pos^DB+Adverb+When
üzüp	üz+Verb+Pos^DB+Adverb+AfterDoingSo
muhakkak	muhakkak+Adverb
basıp	bas+Verb+Pos^DB+Adverb+AfterDoingSo
gündüzleri	gündüzleri+Adverb
ilikleyince	ilikle+Verb+Pos^DB+Adverb+When
deyip	de+Verb+Pos^DB+Adverb+AfterDoingSo
dönüp	dön+Verb+Pos^DB+Adverb+AfterDoingSo
bakarken	bak+Verb+Pos+Aor^DB+Adverb+While
çocukken	çocuk+Noun+A3sg+Pnon+Nom^DB+Verb+Zero^DB+Adverb+While
içerken	iç+Verb+Pos+Aor^DB+Adverb+While
bahsederken	bahset+Verb+Pos+Aor^DB+Adverb+While
karıştırıp	karış+Verb^DB+Verb+Caus+Pos^DB+Adverb+AfterDoingSo
direkt	direkt+Adverb
karıştırırken	karış+Verb^DB+Verb+Caus+Pos+Aor^DB+Adverb+While
katlayıp	katla+Verb+Pos^DB+Adverb+AfterDoingSo
cesaretlenip	cesaret+Noun+A3sg+Pnon+Nom^DB+Verb+Acquire+Pos^DB+Adverb+AfterDoingSo
atıp	at+Verb+Pos^DB+Adverb+AfterDoingSo
geçip	geç+Verb+Pos^DB+Adverb+AfterDoingSo
beklerken	bekle+Verb+Pos+Aor^DB+Adverb+While
yükselterek	yüksel+Verb^DB+Verb+Caus+Pos^DB+Adverb+ByDoingSo
aldırmadan	aldır+Verb+Pos^DB+Adverb+WithoutHavingDoneSo
uyanıp	uyan+Verb+Pos^DB+Adverb+AfterDoingSo
yaklaştırarak	yaklaş+Verb^DB+Verb+Caus+Pos^DB+Adverb+ByDoingSo
çatıp	çat+Verb+Pos^DB+Adverb+AfterDoingSo
sallayarak	salla+Verb+Pos^DB+Adverb+ByDoingSo
ayırıp	ayır+Verb+Pos^DB+Adverb+AfterDoingSo
hatırlayıp	hatırla+Verb+Pos^DB+Adverb+AfterDoingSo
sarsarak	sars+Verb+Pos^DB+Adverb+ByDoingSo
sarsıp	sars+Verb+Pos^DB+Adverb+AfterDoingSo
terslenince	tersle+Verb^DB+Verb+Pass+Pos^DB+Adverb+When
titreyip	titre+Verb+Pos^DB+Adverb+AfterDoingSo
gelirken	gelir+Noun+A3sg+Pnon+Nom^DB+Verb+Zero^DB+Adverb+While
çalışarak	çalış+Verb+Pos^DB+Adverb+ByDoingSo
geceleyin	geceleyin+Adverb
üzülünce	üz+Verb^DB+Verb+Pass+Pos^DB+Adverb+When
bahsedilince	bahset+Verb^DB+Verb+Pass+Pos^DB+Adverb+When
bayılıp	bayıl+Verb+Pos^DB+Adverb+AfterDoingSo
gönderip	gönder+Verb+Pos^DB+Adverb+AfterDoingSo
nice	nice+Adverb
tamamlanıp	tamamla+Verb^DB+Verb+Pass+Pos^DB+Adverb+AfterDoingSo
yatarken	yat+Verb+Pos+Aor^DB+Adverb+While
aniden	aniden+Adverb
izleyip	izle+Verb+Pos^DB+Adverb+AfterDoingSo
denerken	dene+Verb+Pos+Aor^DB+Adverb+While
geçirip	geç+Verb^DB+Verb+Caus+Pos^DB+Adverb+AfterDoingSo
tutmuşken	tut+Verb+Pos+Narr^DB+Adverb+While
olamayıp	ol+Verb^DB+Verb+Able+Neg^DB+Adverb+AfterDoingSo
eğip	eğ+Verb+Pos^DB+Adverb+AfterDoingSo
zıplayarak	zıpla+Verb+Pos^DB+Adverb+ByDoingSo
yaparken	yap+Verb+Pos+Aor^DB+Adverb+While
koyup	koy+Verb+Pos^DB+Adverb+AfterDoingSo
diklenince	dikle+Verb^DB+Verb+Pass+Pos^DB+Adverb+When
düşüp	düş+Verb+Pos^DB+Adverb+AfterDoingSo
silip	sil+Verb+Pos^DB+Adverb+AfterDoingSo
inandırarak	inan+Verb^DB+Verb+Caus+Pos^DB+Adverb+ByDoingSo
giyinirken	giy+Verb^DB+Verb+Reflex+Pos+Aor^DB+Adverb+While
yıkayarak	yıka+Verb+Pos^DB+Adverb+ByDoingSo
savunurken	savun+Verb+Pos+Aor^DB+Adverb+While
tasarlarken	tasarla+Verb+Pos+Aor^DB+Adverb+While
kızıp	kız+Verb+Pos^DB+Adverb+AfterDoingSo
çullanıp	çullan+Verb+Pos^DB+Adverb+AfterDoingSo
itilerek	it+Verb^DB+Verb+Pass+Pos^DB+Adverb+ByDoingSo
birazdan	birazdan+Adverb
alıştıkça	alış+Verb+Pos^DB+Adverb+AsLongAs
yalnızken	yalnız+Adj^DB+Verb+Zero^DB+Adverb+While
döverken	döv+Verb+Pos+Aor^DB+Adverb+While
gezdirirken	gez+Verb^DB+Verb+Caus+Pos+Aor^DB+Adverb+While
gezerken	gez+Verb+Pos+Aor^DB+Adverb+While
verip	ver+Verb+Pos^DB+Adverb+AfterDoingSo
niye	niye+Adverb
gerçi	gerçi+Adverb
içip	iç+Verb+Pos^DB+Adverb+AfterDoingSo
çıkarak	çık+Verb+Pos^DB+Adverb+ByDoingSo
dolaşırken	dolaş+Verb+Pos+Aor^DB+Adverb+While
edilerek	et+Verb^DB+Verb+Pass+Pos^DB+Adverb+ByDoingSo
edilirken	et+Verb^DB+Verb+Pass+Pos+Aor^DB+Adverb+While
bırakmaksızın	bırak+Verb+Pos^DB+Adverb+WithoutHavingDoneSo
bakınırken	bakın+Verb+Pos+Aor^DB+Adverb+While
dönerken	döner+Noun+A3sg+Pnon+Nom^DB+Verb+Zero^DB+Adverb+While
kalmayarak	kal+Verb+Neg^DB+Adverb+ByDoingSo
girerek	gir+Verb+Pos^DB+Adverb+ByDoingSo
derinlemesine	derinlemesine+Adverb
ardınca	ardınca+Adverb
dinleyerek	dinle+Verb+Pos^DB+Adverb+ByDoingSo
aşarken	aş+Verb+Pos+Aor^DB+Adverb+While
dolup	dol+Verb+Pos^DB+Adverb+AfterDoingSo
durdurup	dur+Verb^DB+Verb+Caus+Pos^DB+Adverb+AfterDoingSo
üstünkörü	üstünkörü+Adverb
dolayısıyla	dolayısıyla+Adverb
yaşındayken	yaş+Noun+A3sg+P3sg+Loc^DB+Verb+Zero^DB+Adverb+While
ayrılarak	ayır+Verb^DB+Verb+Pass+Pos^DB+Adverb+ByDoingSo
ardından	ardından+Adverb
başlayarak	başla+Verb+Pos^DB+Adverb+ByDoingSo
yaptırarak	yap+Verb^DB+Verb+Caus+Pos^DB+Adverb+ByDoingSo
sergileyerek	sergile+Verb+Pos^DB+Adverb+ByDoingSo
kısaca	kısa+Adj^DB+Adverb+Ly
alışmadıkça	alış+Verb+Neg^DB+Adverb+AsLongAs
karşılaşınca	karşılaş+Verb+Pos^DB+Adverb+When
hissederek	hisset+Verb+Pos^DB+Adverb+ByDoingSo
batıp	bat+Verb+Pos^DB+Adverb+AfterDoingSo
serperek	serp+Verb+Pos^DB+Adverb+ByDoingSo
çekiştirerek	çekiş+Verb^DB+Verb+Caus+Pos^DB+Adverb+ByDoingSo
nadiren	nadiren+Adverb
bularak	bul+Verb+Pos^DB+Adverb+ByDoingSo
acımaksızın	acı+Verb+Pos^DB+Adverb+WithoutHavingDoneSo
anlatarak	anla+Verb^DB+Verb+Caus+Pos^DB+Adverb+ByDoingSo
içerek	iç+Verb+Pos^DB+Adverb+ByDoingSo
tutulmuşcasına	tut+Verb^DB+Verb+Pass+Pos^DB+Adj+NarrPart^DB+Verb+Zero^DB+Adverb+AsIf
ayrılmayarak	ayır+Verb^DB+Verb+Pass+Neg^DB+Adverb+ByDoingSo
kudurarak	kudur+Verb+Pos^DB+Adverb+ByDoingSo
coşturup	coş+Verb^DB+Verb+Caus+Pos^DB+Adverb+AfterDoingSo
döğerek	döğ+Verb+Pos^DB+Adverb+ByDoingSo
söverek	söv+Verb+Pos^DB+Adverb+ByDoingSo
akıp	ak+Verb+Pos^DB+Adverb+AfterDoingSo
yokolup	yokol+Verb+Pos^DB+Adverb+AfterDoingSo
aşarak	aş+Verb+Pos^DB+Adverb+ByDoingSo
karışamayarak	karış+Verb^DB+Verb+Able+Neg^DB+Adverb+ByDoingSo
sağlamca	sağlam+Adj^DB+Adverb+Ly
çağırırken	çağır+Verb+Pos+Aor^DB+Adverb+While
alarak	al+Verb+Pos^DB+Adverb+ByDoingSo
ilerleyerek	ilerle+Verb+Pos^DB+Adverb+ByDoingSo
konuşmadan	konuş+Verb+Pos^DB+Adverb+WithoutHavingDoneSo
tırmalayarak	tırmala+Verb+Pos^DB+Adverb+ByDoingSo
oturunca	otur+Verb+Pos^DB+Adverb+When
dayayarak	daya+Verb+Pos^DB+Adverb+ByDoingSo
düzeltirken	düzel+Verb^DB+Verb+Caus+Pos+Aor^DB+Adverb+While
uzanarak	uza+Verb^DB+Verb+Pass+Pos^DB+Adverb+ByDoingSo
birazcık	birazcık+Adverb
ağlayarak	ağla+Verb+Pos^DB+Adverb+ByDoingSo
korkutarak	kork+Verb^DB+Verb+Caus+Pos^DB+Adverb+ByDoingSo
çıkarırken	çık+Verb^DB+Verb+Caus+Pos+Aor^DB+Adverb+While
sallanarak	salla+Verb^DB+Verb+Pass+Pos^DB+Adverb+ByDoingSo
kucaklayarak	kucakla+Verb+Pos^DB+Adverb+ByDoingSo
iterek	it+Verb+Pos^DB+Adverb+ByDoingSo
oynatarak	oyna+Verb^DB+Verb+Caus+Pos^DB+Adverb+ByDoingSo
kapayarak	kapa+Verb+Pos^DB+Adverb+ByDoingSo
kırılıp	kır+Verb^DB+Verb+Pass+Pos^DB+Adverb+AfterDoingSo
kımıldamadan	kımılda+Verb+Pos^DB+Adverb+WithoutHavingDoneSo
çökerek	çök+Verb+Pos^DB+Adverb+ByDoingSo
aynen	aynen+Adverb
uyanınca	uyan+Verb+Pos^DB+Adverb+When
serkeşçe	serkeş+Adj^DB+Adverb+Ly
görerek	gör+Verb+Pos^DB+Adverb+ByDoingSo
yaşayıp	yaşa+Verb+Pos^DB+Adverb+AfterDoingSo
haftalarca	haftalarca+Adverb
aylarca	aylarca+Adverb
indirerek	in+Verb^DB+Verb+Caus+Pos^DB+Adverb+ByDoingSo
asarak	as+Verb+Pos^DB+Adverb+ByDoingSo
yıkayıp	yıka+Verb+Pos^DB+Adverb+AfterDoingSo
bakmayarak	bak+Verb+Neg^DB+Adverb+ByDoingSo
bulamayarak	bul+Verb^DB+Verb+Able+Neg^DB+Adverb+ByDoingSo
bocalayarak	bocala+Verb+Pos^DB+Adverb+ByDoingSo
geberip	geber+Verb+Pos^DB+Adverb+AfterDoingSo
değdirircesine	değ+Verb^DB+Verb+Caus+Pos+Aor+A3sg^DB+Adverb+AsIf
bulamayınca	bula+Verb+Neg^DB+Adverb+When
uzadıya	uzadıya+Adverb
titrerken	titre+Verb+Pos+Aor^DB+Adverb+While
anlayarak	anla+Verb+Pos^DB+Adverb+ByDoingSo
çatarak	çat+Verb+Pos^DB+Adverb+ByDoingSo
işittikçe	işit+Verb+Pos^DB+Adverb+AsLongAs
hıçkırarak	hıçkır+Verb+Pos^DB+Adverb+ByDoingSo
çıkınca	çık+Verb+Pos^DB+Adverb+When
korkup	kork+Verb+Pos^DB+Adverb+AfterDoingSo
yakalarken	yakala+Verb+Pos+Aor^DB+Adverb+While
yalayarak	yala+Verb+Pos^DB+Adverb+ByDoingSo
çekinerek	çekin+Verb+Pos^DB+Adverb+ByDoingSo
dikip	dik+Verb+Pos^DB+Adverb+AfterDoingSo
çıkarılıp	çık+Verb^DB+Verb+Caus^DB+Verb+Pass+Pos^DB+Adverb+AfterDoingSo
sarıp	sar+Verb+Pos^DB+Adverb+AfterDoingSo
sendeleyerek	sendele+Verb+Pos^DB+Adverb+ByDoingSo
sararak	sar+Verb+Pos^DB+Adverb+ByDoingSo
kavrayarak	kavra+Verb+Pos^DB+Adverb+ByDoingSo
topallayarak	topalla+Verb+Pos^DB+Adverb+ByDoingSo
usulca	usulca+Adverb
ilerlerken	ilerle+Verb+Pos+Aor^DB+Adverb+While
dümendeyken	dümen+Noun+A3sg+Pnon+Loc^DB+Verb+Zero^DB+Adverb+While
yaklaştıkça	yaklaş+Verb+Pos^DB+Adverb+AsLongAs
illa	illa+Adverb
büküp	bük+Verb+Pos^DB+Adverb+AfterDoingSo
korkutup	kork+Verb^DB+Verb+Caus+Pos^DB+Adverb+AfterDoingSo
sızlanarak	sızla+Verb^DB+Verb+Pass+Pos^DB+Adverb+ByDoingSo
yeterince	yeterince+Adverb
yöneltirken	yönel+Verb^DB+Verb+Caus+Pos+Aor^DB+Adverb+While
arkadaşça	arkadaşça+Adverb
öksürüp	öksür+Verb+Pos^DB+Adverb+AfterDoingSo
atlayıp	atla+Verb+Pos^DB+Adverb+AfterDoingSo
çiğnerken	çiğne+Verb+Pos+Aor^DB+Adverb+While
içince	iç+Verb+Pos^DB+Adverb+When
parlayınca	parla+Verb+Pos^DB+Adverb+When
gönderilmeden	gönder+Verb^DB+Verb+Pass+Pos^DB+Adverb+WithoutHavingDoneSo
ısınırken	ısın+Verb+Pos+Aor^DB+Adverb+While
dönmüşken	dön+Verb+Pos+Narr^DB+Adverb+While
açarak	aç+Verb+Pos^DB+Adverb+ByDoingSo
besbelli	besbelli+Adverb
gösterip	göster+Verb+Pos^DB+Adverb+AfterDoingSo
sürüklenirken	sürükle+Verb^DB+Verb+Pass+Pos+Aor^DB+Adverb+While
umarak	um+Verb+Pos^DB+Adverb+ByDoingSo
ağlayıp	ağla+Verb+Pos^DB+Adverb+AfterDoingSo
açarken	açar+Adj^DB+Verb+Zero^DB+Adverb+While
boşaltırken	boşal+Verb^DB+Verb+Caus+Pos+Aor^DB+Adverb+While
öldürmeden	öl+Verb^DB+Verb+Caus+Pos^DB+Adverb+WithoutHavingDoneSo
şapırdatarak	şapırda+Verb^DB+Verb+Caus+Pos^DB+Adverb+ByDoingSo
durdurarak	dur+Verb^DB+Verb+Caus+Pos^DB+Adverb+ByDoingSo
üstelik	üstelik+Adverb
kaçınamayınca	kaçın+Verb^DB+Verb+Able+Neg^DB+Adverb+When
çokça	çokça+Adverb
sormadan	sor+Verb+Pos^DB+Adverb+WithoutHavingDoneSo
alınca	al+Verb+Pos^DB+Adverb+When
güvenerek	güven+Verb+Pos^DB+Adverb+ByDoingSo
geçirmeden	geç+Verb^DB+Verb+Caus+Pos^DB+Adverb+WithoutHavingDoneSo
tamamlarken	tamamla+Verb+Pos+Aor^DB+Adverb+While
aydır	ay+Noun+A3sg+Pnon+Nom^DB+Adverb+Since
davranıp	davran+Verb+Pos^DB+Adverb+AfterDoingSo
gezip	gez+Verb+Pos^DB+Adverb+AfterDoingSo
sıçrayarak	sıçra+Verb+Pos^DB+Adverb+ByDoingSo
takınarak	takın+Verb+Pos^DB+Adverb+ByDoingSo
atfederek	atfet+Verb+Pos^DB+Adverb+ByDoingSo
beraberce	beraberce+Adverb
rastlayınca	rastla+Verb+Pos^DB+Adverb+When
ovuşturarak	ovuştur+Verb+Pos^DB+Adverb+ByDoingSo
binip	bin+Verb+Pos^DB+Adverb+AfterDoingSo
başbaşa	başbaşa+Adverb
dolaşarak	dolaş+Verb+Pos^DB+Adverb+ByDoingSo
okuyunca	oku+Verb+Pos^DB+Adverb+When
seyrettikçe	seyret+Verb+Pos^DB+Adverb+AsLongAs
yutarak	yut+Verb+Pos^DB+Adverb+ByDoingSo
bürünüp	bürü+Verb^DB+Verb+Pass+Pos^DB+Adverb+AfterDoingSo
bilakis	bilakis+Adverb
besletip	besle+Verb^DB+Verb+Caus+Pos^DB+Adverb+AfterDoingSo
yollanırken	yolla+Verb^DB+Verb+Pass+Pos+Aor^DB+Adverb+While
süpürüp	süpür+Verb+Pos^DB+Adverb+AfterDoingSo
savurup	savur+Verb+Pos^DB+Adverb+AfterDoingSo
kavuşturup	kavuş+Verb^DB+Verb+Caus+Pos^DB+Adverb+AfterDoingSo
istemeyerek	iste+Verb+Neg^DB+Adverb+ByDoingSo
düzelterek	düzel+Verb^DB+Verb+Caus+Pos^DB+Adverb+ByDoingSo
doldurup	dol+Verb^DB+Verb+Caus+Pos^DB+Adverb+AfterDoingSo
aşıp	aş+Verb+Pos^DB+Adverb+AfterDoingSo
yakıp	yak+Verb+Pos^DB+Adverb+AfterDoingSo
aralayıp	arala+Verb+Pos^DB+Adverb+AfterDoingSo
zenginleştikçe	zengin+Adj^DB+Verb+Become+Pos^DB+Adverb+AsLongAs
büyüyünce	büyü+Verb+Pos^DB+Adverb+When
düşününce	düşün+Verb+Pos^DB+Adverb+When
anlatırken	anla+Verb^DB+Verb+Caus+Pos+Aor^DB+Adverb+While
savrulup	savur+Verb^DB+Verb+Pass+Pos^DB+Adverb+AfterDoingSo
meşgulken	meşgul+Adj^DB+Verb+Zero^DB+Adverb+While
bekleterek	bekle+Verb^DB+Verb+Caus+Pos^DB+Adverb+ByDoingSo
durunca	dur+Verb+Pos^DB+Adverb+When
aydınlatınca	aydınlat+Verb+Pos^DB+Adverb+When
bulunca	bul+Verb+Pos^DB+Adverb+When
çırpıp	çırp+Verb+Pos^DB+Adverb+AfterDoingSo
peki	peki+Adverb
döndürürken	dön+Verb^DB+Verb+Caus+Pos+Aor^DB+Adverb+While
sokup	sok+Verb+Pos^DB+Adverb+AfterDoingSo
dinlerken	dinle+Verb+Pos+Aor^DB+Adverb+While
harcarken	harca+Verb+Pos+Aor^DB+Adverb+While
şaklatarak	şakla+Verb^DB+Verb+Caus+Pos^DB+Adverb+ByDoingSo
tanınmayıp	tanı+Verb^DB+Verb+Pass+Neg^DB+Adverb+AfterDoingSo
asılarak	as+Verb^DB+Verb+Pass+Pos^DB+Adverb+ByDoingSo
çıkararak	çık+Verb^DB+Verb+Caus+Pos^DB+Adverb+ByDoingSo
başınayken	baş+Noun+A3sg+P3sg+Dat^DB+Verb+Zero^DB+Adverb+While
dışarıdayken	dışarı+Noun+A3sg+Pnon+Loc^DB+Verb+Zero^DB+Adverb+While
kaşıklayıp	kaşıkla+Verb+Pos^DB+Adverb+AfterDoingSo
yutarken	yut+Verb+Pos+Aor^DB+Adverb+While
kıskanıp	kıskan+Verb+Pos^DB+Adverb+AfterDoingSo
kaldırırken	kaldır+Verb+Pos+Aor^DB+Adverb+While
silerek	sil+Verb+Pos^DB+Adverb+ByDoingSo
giyinip	giy+Verb^DB+Verb+Reflex+Pos^DB+Adverb+AfterDoingSo
geçercesine	geç+Verb+Pos+Aor+A3sg^DB+Adverb+AsIf
bağırarak	bağır+Verb+Pos^DB+Adverb+ByDoingSo
kısacası	kısacası+Adverb
yoklayıp	yokla+Verb+Pos^DB+Adverb+AfterDoingSo
arayarak	ara+Verb+Pos^DB+Adverb+ByDoingSo
isteyerek	iste+Verb+Pos^DB+Adverb+ByDoingSo
bilmeden	bil+Verb+Pos^DB+Adverb+WithoutHavingDoneSo
buruşturup	buruş+Verb^DB+Verb+Caus+Pos^DB+Adverb+AfterDoingSo
kazıyarak	kazı+Verb+Pos^DB+Adverb+ByDoingSo
giyinerek	giy+Verb^DB+Verb+Reflex+Pos^DB+Adverb+ByDoingSo
işteyken	iş+Noun+A3sg+Pnon+Loc^DB+Verb+Zero^DB+Adverb+While
görüşmeyeli	görüş+Verb+Neg^DB+Adverb+SinceDoingSo
batarken	batar+Noun+A3sg+Pnon+Nom^DB+Verb+Zero^DB+Adverb+While
çevirerek	çevir+Verb+Pos^DB+Adverb+ByDoingSo
avutup	avut+Verb+Pos^DB+Adverb+AfterDoingSo
yetiştirip	yetiş+Verb^DB+Verb+Caus+Pos^DB+Adverb+AfterDoingSo
gencecikken	gencecik+Adj^DB+Verb+Zero^DB+Adverb+While
doğarken	doğ+Verb+Pos+Aor^DB+Adverb+While
soyarken	soy+Verb+Pos+Aor^DB+Adverb+While
veremeden	ver+Verb+Pos^DB+Adverb+WithoutBeingAbleToHaveDoneSo
tartışarak	tartış+Verb+Pos^DB+Adverb+ByDoingSo
olgunlaşıp	olgun+Adj^DB+Verb+Become+Pos^DB+Adverb+AfterDoingSo
uzaklaşırken	uzak+Adj^DB+Verb+Become+Pos+Aor^DB+Adverb+While
buharlaşıp	buhar+Noun+A3sg+Pnon+Nom^DB+Verb+Become+Pos^DB+Adverb+AfterDoingSo
bitirince	bit+Verb^DB+Verb+Caus+Pos^DB+Adverb+When
eskitip	eski+Verb^DB+Verb+Caus+Pos^DB+Adverb+AfterDoingSo
deyince	de+Verb+Pos^DB+Adverb+When
kırıtarak	kırıt+Verb+Pos^DB+Adverb+ByDoingSo
büyüdükçe	büyü+Verb+Pos^DB+Adverb+AsLongAs
çoğaldıkça	çoğal+Verb+Pos^DB+Adverb+AsLongAs
anlatamayınca	anla+Verb^DB+Verb+Caus^DB+Verb+Able+Neg^DB+Adverb+When
duyunca	duy+Verb+Pos^DB+Adverb+When
uğrayıp	uğra+Verb+Pos^DB+Adverb+AfterDoingSo
hazırlanırken	hazırla+Verb^DB+Verb+Pass+Pos+Aor^DB+Adverb+While
dayayıp	daya+Verb+Pos^DB+Adverb+AfterDoingSo
çağırınca	çağır+Verb+Pos^DB+Adverb+When
girince	gir+Verb+Pos^DB+Adverb+When
yumuşatarak	yumuşa+Verb^DB+Verb+Caus+Pos^DB+Adverb+ByDoingSo
söylemeyip	söyle+Verb+Neg^DB+Adverb+AfterDoingSo
hazırlarken	hazırla+Verb+Pos+Aor^DB+Adverb+While
açılınca	aç+Verb^DB+Verb+Pass+Pos^DB+Adverb+When
hazırlayıp	hazırla+Verb+Pos^DB+Adverb+AfterDoingSo
öğrenince	öğren+Verb+Pos^DB+Adverb+When
gidince	git+Verb+Pos^DB+Adverb+When
tamamlayıp	tamamla+Verb+Pos^DB+Adverb+AfterDoingSo
halen	halen+Adverb
bozup	boz+Verb+Pos^DB+Adverb+AfterDoingSo
saçarak	saç+Verb+Pos^DB+Adverb+ByDoingSo
sallanıp	salla+Verb^DB+Verb+Pass+Pos^DB+Adverb+AfterDoingSo
nasılsa	nasılsa+Adverb
kesip	kes+Verb+Pos^DB+Adverb+AfterDoingSo
yatıp	yat+Verb+Pos^DB+Adverb+AfterDoingSo
varamadan	var+Verb+Pos^DB+Adverb+WithoutBeingAbleToHaveDoneSo
uyurken	uyu+Verb+Pos+Aor^DB+Adverb+While
edilmeksizin	et+Verb^DB+Verb+Pass+Pos^DB+Adverb+WithoutHavingDoneSo
kabartınca	kabar+Verb^DB+Verb+Caus+Pos^DB+Adverb+When
kendiliğinden	kendiliğinden+Adverb
boşanmışçasına	boşa+Verb^DB+Verb+Pass+Pos+Narr+A3sg^DB+Adverb+AsIf
oynayıp	oyna+Verb+Pos^DB+Adverb+AfterDoingSo
toplayıp	topla+Verb+Pos^DB+Adverb+AfterDoingSo
kolayca	kolay+Adj^DB+Adverb+Ly
bekliyormuşçasına	bekle+Verb+Pos+Prog1+Narr+A3sg^DB+Adverb+AsIf
kıpırdanmaksızın	kıpırda+Verb^DB+Verb+Pass+Pos^DB+Adverb+WithoutHavingDoneSo
yalpalayarak	yalpala+Verb+Pos^DB+Adverb+ByDoingSo
bütünüyle	bütünüyle+Adverb
düşerken	düş+Verb+Pos+Aor^DB+Adverb+While
kapılarak	kap+Verb^DB+Verb+Pass+Pos^DB+Adverb+ByDoingSo
ezkaza	ezkaza+Adverb
unutuverip	unut+Verb+Pos^DB+Verb+Hastily^DB+Adverb+AfterDoingSo
derhal	derhal+Adverb
geçmişçesine	geç+Verb+Pos+Narr+A3sg^DB+Adverb+AsIf
bildirip	bil+Verb^DB+Verb+Caus+Pos^DB+Adverb+AfterDoingSo
varınca	var+Verb+Pos^DB+Adverb+When
ilerledikçe	ilerle+Verb+Pos^DB+Adverb+AsLongAs
açılırken	aç+Verb^DB+Verb+Pass+Pos+Aor^DB+Adverb+While
sürüklenircesine	sürükle+Verb^DB+Verb+Pass+Pos+Aor+A3sg^DB+Adverb+AsIf
kenetleyip	kenetle+Verb+Pos^DB+Adverb+AfterDoingSo
verememişçesine	ver+Verb^DB+Verb+Able+Neg+Narr+A3sg^DB+Adverb+AsIf
kapatıp	kapa+Verb^DB+Verb+Caus+Pos^DB+Adverb+AfterDoingSo
saatlerce	saatlerce+Adverb
çekerken	çeker+Noun+A3sg+Pnon+Nom^DB+Verb+Zero^DB+Adverb+While
düşünmeksizin	düşün+Verb+Pos^DB+Adverb+WithoutHavingDoneSo
yalpalarken	yalpala+Verb+Pos+Aor^DB+Adverb+While
oluşturarak	oluş+Verb^DB+Verb+Caus+Pos^DB+Adverb+ByDoingSo
istiyormuşçasına	iste+Verb+Pos+Prog1+Narr+A3sg^DB+Adverb+AsIf
yalvarıp	yalvar+Verb+Pos^DB+Adverb+AfterDoingSo
çekilirken	çek+Verb^DB+Verb+Pass+Pos+Aor^DB+Adverb+While
gerçekte	gerçekte+Adverb
başarmışken	başar+Verb+Pos+Narr^DB+Adverb+While
sıkışıp	sıkış+Verb+Pos^DB+Adverb+AfterDoingSo
itilip	it+Verb^DB+Verb+Pass+Pos^DB+Adverb+AfterDoingSo
yoklayarak	yokla+Verb+Pos^DB+Adverb+ByDoingSo
sızlayıp	sızla+Verb+Pos^DB+Adverb+AfterDoingSo
uzaktayken	uzak+Adj^DB+Noun+Zero+A3sg+Pnon+Loc^DB+Verb+Zero^DB+Adverb+While
bekleyip	bekle+Verb+Pos^DB+Adverb+AfterDoingSo
kilitliyken	kilit+Noun+A3sg+Pnon+Nom^DB+Adj+With^DB+Verb+Zero^DB+Adverb+While
açılmışken	aç+Verb^DB+Verb+Pass+Pos+Narr^DB+Adverb+While
yapışıp	yapış+Verb+Pos^DB+Adverb+AfterDoingSo
yıldır	yıl+Noun+A3sg+Pnon+Nom^DB+Adverb+Since
engelleyemeyerek	engelle+Verb^DB+Verb+Able+Neg^DB+Adverb+ByDoingSo
davranarak	davran+Verb+Pos^DB+Adverb+ByDoingSo
aydınlanmamışken	aydınlan+Verb+Neg+Narr^DB+Adverb+While
tutamayıp	tut+Verb^DB+Verb+Able+Neg^DB+Adverb+AfterDoingSo
olmuşcasına	ol+Verb+Pos^DB+Adj+NarrPart^DB+Verb+Zero^DB+Adverb+AsIf
odadayken	oda+Noun+A3sg+Pnon+Loc^DB+Verb+Zero^DB+Adverb+While
istercesine	iste+Verb+Pos+Aor+A3sg^DB+Adverb+AsIf
ürküp	ürk+Verb+Pos^DB+Adverb+AfterDoingSo
gerinip	gerin+Verb+Pos^DB+Adverb+AfterDoingSo
uyurlarken	uyu+Verb+Pos+Aor+A3pl^DB+Adverb+While
kestirirlerken	kes+Verb^DB+Verb+Caus+Pos+Aor+A3pl^DB+Adverb+While
odasındayken	oda+Noun+A3sg+P3sg+Loc^DB+Verb+Zero^DB+Adverb+While
bilip	bil+Verb+Pos^DB+Adverb+AfterDoingSo
çöküp	çök+Verb+Pos^DB+Adverb+AfterDoingSo
vermeyince	ver+Verb+Neg^DB+Adverb+When
kapatırken	kapa+Verb^DB+Verb+Caus+Pos+Aor^DB+Adverb+While
elbet	elbet+Adverb
resmen	resmen+Adverb
sevince	sev+Verb+Pos^DB+Adverb+When
fazladan	fazladan+Adverb
kırpmadan	kırp+Verb+Pos^DB+Adverb+WithoutHavingDoneSo
hışırdatıp	hışırda+Verb^DB+Verb+Caus+Pos^DB+Adverb+AfterDoingSo
harcayarak	harca+Verb+Pos^DB+Adverb+ByDoingSo
söylenip	söyle+Verb^DB+Verb+Pass+Pos^DB+Adverb+AfterDoingSo
uzadıkça	uza+Verb+Pos^DB+Adverb+AsLongAs
kapatmaksızın	kapa+Verb^DB+Verb+Caus+Pos^DB+Adverb+WithoutHavingDoneSo
boğuluyormuşcasına	boğ+Verb^DB+Verb+Pass+Pos+Prog1+Narr+A3sg^DB+Adverb+AsIf
çekilip	çek+Verb^DB+Verb+Pass+Pos^DB+Adverb+AfterDoingSo
toplarken	topla+Verb+Pos+Aor^DB+Adverb+While
uydurup	uy+Verb^DB+Verb+Caus+Pos^DB+Adverb+AfterDoingSo
tavandayken	tavan+Adj^DB+Noun+Zero+A3sg+Pnon+Loc^DB+Verb+Zero^DB+Adverb+While
almaksızın	al+Verb+Pos^DB+Adverb+WithoutHavingDoneSo
hoşlanıp	hoşlan+Verb+Pos^DB+Adverb+AfterDoingSo
olmadıkça	ol+Verb+Neg^DB+Adverb+AsLongAs
buluşup	buluş+Verb+Pos^DB+Adverb+AfterDoingSo
ışıldayarak	ışılda+Verb+Pos^DB+Adverb+ByDoingSo
geldikçe	gel+Verb+Pos^DB+Adverb+AsLongAs
bürünerek	bürün+Verb+Pos^DB+Adverb+ByDoingSo
donmuşken	don+Verb+Pos+Narr^DB+Adverb+While
dayanamayıp	dayan+Verb^DB+Verb+Able+Neg^DB+Adverb+AfterDoingSo
kopup	kop+Verb+Pos^DB+Adverb+AfterDoingSo
üzereyken	üzere+Postp+PCNom^DB+Verb+Zero^DB+Adverb+While
inanıp	inan+Verb+Pos^DB+Adverb+AfterDoingSo
yazıp	yaz+Verb+Pos^DB+Adverb+AfterDoingSo
sırtlayıp	sırtla+Verb+Pos^DB+Adverb+AfterDoingSo
dinleyip	dinle+Verb+Pos^DB+Adverb+AfterDoingSo
parlayıp	parla+Verb+Pos^DB+Adverb+AfterDoingSo
dokuzken	dokuz+Num+Card^DB+Noun+Zero+A3sg+Pnon+Nom^DB+Verb+Zero^DB+Adverb+While
tükenip	tüken+Verb+Pos^DB+Adverb+AfterDoingSo
vahşice	vahşi+Adj^DB+Adverb+Ly
görüşüp	görüş+Verb+Pos^DB+Adverb+AfterDoingSo
narince	narin+Adj^DB+Adverb+Ly
saygısızca	saygı+Noun+A3sg+Pnon+Nom^DB+Adj+Without^DB+Adverb+Ly
kızararak	kızar+Verb+Pos^DB+Adverb+ByDoingSo
haldeyken	hal+Noun+A3sg+Pnon+Loc^DB+Verb+Zero^DB+Adverb+While
yaştayken	yaş+Noun+A3sg+Pnon+Loc^DB+Verb+Zero^DB+Adverb+While
dönünce	dön+Verb+Pos^DB+Adverb+When
işletirken	işle+Verb^DB+Verb+Caus+Pos+Aor^DB+Adverb+While
görünüp	görün+Verb+Pos^DB+Adverb+AfterDoingSo
sömürerek	sömür+Verb+Pos^DB+Adverb+ByDoingSo
defalarca	defalarca+Adverb
getirilince	getir+Verb^DB+Verb+Pass+Pos^DB+Adverb+When
olgunlaşınca	olgun+Adj^DB+Verb+Become+Pos^DB+Adverb+When
kandırıp	kan+Verb^DB+Verb+Caus+Pos^DB+Adverb+AfterDoingSo
uyarak	uy+Verb+Pos^DB+Adverb+ByDoingSo
yaklaşarak	yaklaş+Verb+Pos^DB+Adverb+ByDoingSo
bitkinleştirip	bitkin+Adj^DB+Verb+Become^DB+Verb+Caus+Pos^DB+Adverb+AfterDoingSo
morarıp	morar+Verb+Pos^DB+Adverb+AfterDoingSo
uçarken	uçar+Adj^DB+Verb+Zero^DB+Adverb+While
anımsayınca	anımsa+Verb+Pos^DB+Adverb+When
birgün	birgün+Adverb
bakınca	bak+Verb+Pos^DB+Adverb+When
ettirip	et+Verb^DB+Verb+Caus+Pos^DB+Adverb+AfterDoingSo
hastalanarak	hastalan+Verb+Pos^DB+Adverb+ByDoingSo
azarlayıp	azarla+Verb+Pos^DB+Adverb+AfterDoingSo
büyüyüp	büyü+Verb+Pos^DB+Adverb+AfterDoingSo
pişirip	piş+Verb^DB+Verb+Caus+Pos^DB+Adverb+AfterDoingSo
kaçırınca	kaç+Verb^DB+Verb+Caus+Pos^DB+Adverb+When
kızarak	kız+Verb+Pos^DB+Adverb+ByDoingSo
tutuşturarak	tutuş+Verb^DB+Verb+Caus+Pos^DB+Adverb+ByDoingSo
habersizce	haber+Noun+A3sg+Pnon+Nom^DB+Adj+Without^DB+Adverb+Ly
çalışıp	çalış+Verb+Pos^DB+Adverb+AfterDoingSo
ihtiyarlayıp	ihtiyarla+Verb+Pos^DB+Adverb+AfterDoingSo
fırlatıp	fırla+Verb^DB+Verb+Caus+Pos^DB+Adverb+AfterDoingSo
fırçalanıp	fırçala+Verb^DB+Verb+Pass+Pos^DB+Adverb+AfterDoingSo
çıkartıp	çık+Verb^DB+Verb+Caus^DB+Verb+Caus+Pos^DB+Adverb+AfterDoingSo
varsayarak	varsay+Verb+Pos^DB+Adverb+ByDoingSo
vermedikçe	ver+Verb+Neg^DB+Adverb+AsLongAs
okuyup	oku+Verb+Pos^DB+Adverb+AfterDoingSo
farkedip	farket+Verb+Pos^DB+Adverb+AfterDoingSo
yırtıp	yırt+Verb+Pos^DB+Adverb+AfterDoingSo
selamlayarak	selamla+Verb+Pos^DB+Adverb+ByDoingSo
ilaçlarken	ilaçla+Verb+Pos+Aor^DB+Adverb+While
hatırlayarak	hatırla+Verb+Pos^DB+Adverb+ByDoingSo
elele	elele+Adverb
kararlaştırıp	karar+Noun+A3sg+Pnon+Nom^DB+Verb+Become^DB+Verb+Caus+Pos^DB+Adverb+AfterDoingSo
hatırlatarak	hatırla+Verb^DB+Verb+Caus+Pos^DB+Adverb+ByDoingSo
aldanarak	aldan+Verb+Pos^DB+Adverb+ByDoingSo
uyandırıp	uyan+Verb^DB+Verb+Caus+Pos^DB+Adverb+AfterDoingSo
emredince	emret+Verb+Pos^DB+Adverb+When
uyularak	uy+Verb^DB+Verb+Pass+Pos^DB+Adverb+ByDoingSo
aitken	ait+Postp+PCDat^DB+Verb+Zero^DB+Adverb+While
değiştirirken	değiş+Verb^DB+Verb+Caus+Pos+Aor^DB+Adverb+While
silinirken	sil+Verb^DB+Verb+Pass+Pos+Aor^DB+Adverb+While
ayarlamadan	ayarla+Verb+Pos^DB+Adverb+WithoutHavingDoneSo
bağlıyken	bağ+Noun+A3sg+Pnon+Nom^DB+Adj+With^DB+Verb+Zero^DB+Adverb+While
çalıştırılıp	çalış+Verb^DB+Verb+Caus^DB+Verb+Pass+Pos^DB+Adverb+AfterDoingSo
etkinleştirilerek	etkin+Adj^DB+Verb+Become^DB+Verb+Caus^DB+Verb+Pass+Pos^DB+Adverb+ByDoingSo
eklerken	ekle+Verb+Pos+Aor^DB+Adverb+While
belirleyip	belirle+Verb+Pos^DB+Adverb+AfterDoingSo
görüntülerken	görüntüle+Verb+Pos+Aor^DB+Adverb+While
atanıp	ata+Verb^DB+Verb+Pass+Pos^DB+Adverb+AfterDoingSo
bakmaksızın	bak+Verb+Pos^DB+Adverb+WithoutHavingDoneSo
değiştirerek	değiş+Verb^DB+Verb+Caus+Pos^DB+Adverb+ByDoingSo
hesaplayıp	hesapla+Verb+Pos^DB+Adverb+AfterDoingSo
tıklayarak	tıkla+Verb+Pos^DB+Adverb+ByDoingSo
ekleyerek	ekle+Verb+Pos^DB+Adverb+ByDoingSo
kullanılarak	kullan+Verb^DB+Verb+Pass+Pos^DB+Adverb+ByDoingSo
tıklatıp	tıkla+Verb^DB+Verb+Caus+Pos^DB+Adverb+AfterDoingSo
tıklatarak	tıkla+Verb^DB+Verb+Caus+Pos^DB+Adverb+ByDoingSo
kaydırıp	kay+Verb^DB+Verb+Caus+Pos^DB+Adverb+AfterDoingSo
seçip	seç+Verb+Pos^DB+Adverb+AfterDoingSo
tanımlayarak	tanımla+Verb+Pos^DB+Adverb+ByDoingSo
etkinleştirmeden	etkin+Adj^DB+Verb+Become^DB+Verb+Caus+Pos^DB+Adverb+WithoutHavingDoneSo
girişmeden	giriş+Verb+Pos^DB+Adverb+WithoutHavingDoneSo
biçimlendirmedikçe	biçim+Noun+A3sg+Pnon+Nom^DB+Verb+Acquire^DB+Verb+Caus+Neg^DB+Adverb+AsLongAs
kullanırken	kullan+Verb+Pos+Aor^DB+Adverb+While
dönüştürürken	dönüş+Verb^DB+Verb+Caus+Pos+Aor^DB+Adverb+While
girmeden	gir+Verb+Pos^DB+Adverb+WithoutHavingDoneSo
başlatırken	başla+Verb^DB+Verb+Caus+Pos+Aor^DB+Adverb+While
verilip	ver+Verb^DB+Verb+Pass+Pos^DB+Adverb+AfterDoingSo
engellenip	engelle+Verb^DB+Verb+Pass+Pos^DB+Adverb+AfterDoingSo
alınarak	alın+Verb+Pos^DB+Adverb+ByDoingSo
yükseldikçe	yüksel+Verb+Pos^DB+Adverb+AsLongAs
uygularken	uygula+Verb+Pos+Aor^DB+Adverb+While
dayanarak	dayan+Verb+Pos^DB+Adverb+ByDoingSo
görüntülenip	görüntüle+Verb^DB+Verb+Pass+Pos^DB+Adverb+AfterDoingSo
kaydedilirken	kaydet+Verb^DB+Verb+Pass+Pos+Aor^DB+Adverb+While
atayarak	ata+Verb+Pos^DB+Adverb+ByDoingSo
içerip	içer+Verb+Pos^DB+Adverb+AfterDoingSo
bakılmaksızın	bak+Verb^DB+Verb+Pass+Pos^DB+Adverb+WithoutHavingDoneSo
değiştirip	değiş+Verb^DB+Verb+Caus+Pos^DB+Adverb+AfterDoingSo
bırakılıp	bırak+Verb^DB+Verb+Pass+Pos^DB+Adverb+AfterDoingSo
silmeden	sil+Verb+Pos^DB+Adverb+WithoutHavingDoneSo
gerektikçe	gerek+Verb+Pos^DB+Adverb+AsLongAs
ayarlayarak	ayarla+Verb+Pos^DB+Adverb+ByDoingSo
paylaşırken	paylaş+Verb+Pos+Aor^DB+Adverb+While
geçirerek	geç+Verb^DB+Verb+Caus+Pos^DB+Adverb+ByDoingSo
sürükleyerek	sürükle+Verb+Pos^DB+Adverb+ByDoingSo
salt	salt+Adverb
eklenirken	ekle+Verb^DB+Verb+Pass+Pos+Aor^DB+Adverb+While
düzenlenirken	düzenle+Verb^DB+Verb+Pass+Pos+Aor^DB+Adverb+While
gönderilirken	gönder+Verb^DB+Verb+Pass+Pos+Aor^DB+Adverb+While
düzenlerken	düzenle+Verb+Pos+Aor^DB+Adverb+While
silinip	sil+Verb^DB+Verb+Pass+Pos^DB+Adverb+AfterDoingSo
kopyalayarak	kopyala+Verb+Pos^DB+Adverb+ByDoingSo
uygulanarak	uygula+Verb^DB+Verb+Pass+Pos^DB+Adverb+ByDoingSo
seçerek	seç+Verb+Pos^DB+Adverb+ByDoingSo
yükseltip	yüksel+Verb^DB+Verb+Caus+Pos^DB+Adverb+AfterDoingSo
temizleyip	temizle+Verb+Pos^DB+Adverb+AfterDoingSo
kullanmayarak	kullan+Verb+Neg^DB+Adverb+ByDoingSo
yazarak	yaz+Verb+Pos^DB+Adverb+ByDoingSo
yazdırırken	yaz+Verb^DB+Verb+Caus+Pos+Aor^DB+Adverb+While
zımbalayıp	zımbala+Verb+Pos^DB+Adverb+AfterDoingSo
uygulayarak	uygula+Verb+Pos^DB+Adverb+ByDoingSo
gerçekleştirirken	gerçek+Noun+A3sg+Pnon+Nom^DB+Verb+Become^DB+Verb+Caus+Pos+Aor^DB+Adverb+While
durumdayken	durum+Noun+A3sg+Pnon+Loc^DB+Verb+Zero^DB+Adverb+While
çizerken	çizer+Noun+A3sg+Pnon+Nom^DB+Verb+Zero^DB+Adverb+While
gerekip	gerek+Verb+Pos^DB+Adverb+AfterDoingSo
açılmadan	aç+Verb^DB+Verb+Pass+Pos^DB+Adverb+WithoutHavingDoneSo
katılarak	kat+Verb^DB+Verb+Pass+Pos^DB+Adverb+ByDoingSo
yenileyerek	yenile+Verb+Pos^DB+Adverb+ByDoingSo
gruplandırarak	grup+Noun+A3sg+Pnon+Nom^DB+Verb+Acquire^DB+Verb+Caus+Pos^DB+Adverb+ByDoingSo
oluşturup	oluş+Verb^DB+Verb+Caus+Pos^DB+Adverb+AfterDoingSo
taşıyıp	taşı+Verb+Pos^DB+Adverb+AfterDoingSo
seçilmedikçe	seç+Verb^DB+Verb+Pass+Neg^DB+Adverb+AsLongAs
yanıtlamadan	yanıtla+Verb+Pos^DB+Adverb+WithoutHavingDoneSo
kopyalayıp	kopyala+Verb+Pos^DB+Adverb+AfterDoingSo
olunarak	ol+Verb^DB+Verb+Pass+Pos^DB+Adverb+ByDoingSo
döndürerek	dön+Verb^DB+Verb+Caus+Pos^DB+Adverb+ByDoingSo
başvurarak	başvur+Verb+Pos^DB+Adverb+ByDoingSo
yapılandırırken	yapı+Noun+A3sg+Pnon+Nom^DB+Verb+Acquire^DB+Verb+Caus+Pos+Aor^DB+Adverb+While
desteklenip	destekle+Verb^DB+Verb+Pass+Pos^DB+Adverb+AfterDoingSo
gerektirip	gerek+Verb^DB+Verb+Caus+Pos^DB+Adverb+AfterDoingSo
yayınlanıp	yayınla+Verb^DB+Verb+Pass+Pos^DB+Adverb+AfterDoingSo
bulunmayıp	bul+Verb^DB+Verb+Pass+Neg^DB+Adverb+AfterDoingSo
giderirken	gider+Verb+Pos+Aor^DB+Adverb+While
işleyip	işle+Verb+Pos^DB+Adverb+AfterDoingSo
ayarlanıp	ayarla+Verb^DB+Verb+Pass+Pos^DB+Adverb+AfterDoingSo
daraltıp	daral+Verb^DB+Verb+Caus+Pos^DB+Adverb+AfterDoingSo
kullanmadan	kullan+Verb+Pos^DB+Adverb+WithoutHavingDoneSo
algılayıp	algıla+Verb+Pos^DB+Adverb+AfterDoingSo
uyararak	uyar+Verb+Pos^DB+Adverb+ByDoingSo
açıkken	açık+Adj^DB+Verb+Zero^DB+Adverb+While
yapılıp	yap+Verb^DB+Verb+Pass+Pos^DB+Adverb+AfterDoingSo
belirleyerek	belirle+Verb+Pos^DB+Adverb+ByDoingSo
kapatmadan	kapa+Verb^DB+Verb+Caus+Pos^DB+Adverb+WithoutHavingDoneSo
çıkarılarak	çık+Verb^DB+Verb+Caus^DB+Verb+Pass+Pos^DB+Adverb+ByDoingSo
düzenleyerek	düzenle+Verb+Pos^DB+Adverb+ByDoingSo
oluşturulurken	oluş+Verb^DB+Verb+Caus^DB+Verb+Pass+Pos+Aor^DB+Adverb+While
oluştururken	oluş+Verb^DB+Verb+Caus+Pos+Aor^DB+Adverb+While
saklayarak	sakla+Verb+Pos^DB+Adverb+ByDoingSo
yüklemeden	yükle+Verb+Pos^DB+Adverb+WithoutHavingDoneSo
denetleyerek	denetle+Verb+Pos^DB+Adverb+ByDoingSo
izleyerek	izle+Verb+Pos^DB+Adverb+ByDoingSo
ekleyip	ekle+Verb+Pos^DB+Adverb+AfterDoingSo
şifrelenip	şifrele+Verb^DB+Verb+Pass+Pos^DB+Adverb+AfterDoingSo
listelenip	listele+Verb^DB+Verb+Pass+Pos^DB+Adverb+AfterDoingSo
kaydedip	kaydet+Verb+Pos^DB+Adverb+AfterDoingSo
kaydederken	kaydet+Verb+Pos+Aor^DB+Adverb+While
artırırken	art+Verb^DB+Verb+Caus+Pos+Aor^DB+Adverb+While
karşılaştırarak	karşılaş+Verb^DB+Verb+Caus+Pos^DB+Adverb+ByDoingSo
yönlendirilerek	yön+Noun+A3sg+Pnon+Nom^DB+Verb+Acquire^DB+Verb+Caus^DB+Verb+Pass+Pos^DB+Adverb+ByDoingSo
durdurmadan	dur+Verb^DB+Verb+Caus+Pos^DB+Adverb+WithoutHavingDoneSo
bitmeden	bit+Verb+Pos^DB+Adverb+WithoutHavingDoneSo
değiştirilmeden	değiş+Verb^DB+Verb+Caus^DB+Verb+Pass+Pos^DB+Adverb+WithoutHavingDoneSo
doğrulanıp	doğrula+Verb^DB+Verb+Pass+Pos^DB+Adverb+AfterDoingSo
bağlanırken	bağla+Verb^DB+Verb+Pass+Pos+Aor^DB+Adverb+While
gönderilip	gönder+Verb^DB+Verb+Pass+Pos^DB+Adverb+AfterDoingSo
görüntülenirken	görüntüle+Verb^DB+Verb+Pass+Pos+Aor^DB+Adverb+While
yüklenip	yükle+Verb^DB+Verb+Pass+Pos^DB+Adverb+AfterDoingSo
artıp	art+Verb+Pos^DB+Adverb+AfterDoingSo
işlerken	işle+Verb+Pos+Aor^DB+Adverb+While
yuvarlanarak	yuvarla+Verb^DB+Verb+Pass+Pos^DB+Adverb+ByDoingSo
inceleyerek	incele+Verb+Pos^DB+Adverb+ByDoingSo
incelerken	incele+Verb+Pos+Aor^DB+Adverb+While
adlandırıp	ad+Noun+A3sg+Pnon+Nom^DB+Verb+Acquire^DB+Verb+Caus+Pos^DB+Adverb+AfterDoingSo
gösterilip	göster+Verb^DB+Verb+Pass+Pos^DB+Adverb+AfterDoingSo
duydukça	duy+Verb+Pos^DB+Adverb+AsLongAs
arttıkça	art+Verb+Pos^DB+Adverb+AsLongAs
sayarak	say+Verb+Pos^DB+Adverb+ByDoingSo
sonuçlandırarak	sonuç+Noun+A3sg+Pnon+Nom^DB+Verb+Acquire^DB+Verb+Caus+Pos^DB+Adverb+ByDoingSo
etkinleştirilip	etkin+Adj^DB+Verb+Become^DB+Verb+Caus^DB+Verb+Pass+Pos^DB+Adverb+AfterDoingSo
bulunup	bulun+Verb+Pos^DB+Adverb+AfterDoingSo
erişirken	eriş+Verb+Pos+Aor^DB+Adverb+While
edilip	et+Verb^DB+Verb+Pass+Pos^DB+Adverb+AfterDoingSo
sınırlayarak	sınırla+Verb+Pos^DB+Adverb+ByDoingSo
doldurarak	dol+Verb^DB+Verb+Caus+Pos^DB+Adverb+ByDoingSo
parlatarak	parla+Verb^DB+Verb+Caus+Pos^DB+Adverb+ByDoingSo
yürütürken	yürü+Verb^DB+Verb+Caus+Pos+Aor^DB+Adverb+While
çalıştırarak	çalış+Verb^DB+Verb+Caus+Pos^DB+Adverb+ByDoingSo
eklemedikçe	ekle+Verb+Neg^DB+Adverb+AsLongAs
kaldırmadıkça	kal+Verb^DB+Verb+Caus+Neg^DB+Adverb+AsLongAs
üstündeyken	üstün+Adj^DB+Noun+Zero+A3sg+Pnon+Loc^DB+Verb+Zero^DB+Adverb+While
sağlarken	sağla+Verb+Pos+Aor^DB+Adverb+While
güncelleştirilip	güncel+Adj^DB+Verb+Become^DB+Verb+Caus^DB+Verb+Pass+Pos^DB+Adverb+AfterDoingSo
yapıştırılırken	yapış+Verb^DB+Verb+Caus^DB+Verb+Pass+Pos+Aor^DB+Adverb+While
başlanarak	başla+Verb^DB+Verb+Pass+Pos^DB+Adverb+ByDoingSo
seçmeksizin	seç+Verb+Pos^DB+Adverb+WithoutHavingDoneSo
biçimlendirilip	biçim+Noun+A3sg+Pnon+Nom^DB+Verb+Acquire^DB+Verb+Caus^DB+Verb+Pass+Pos^DB+Adverb+AfterDoingSo
edinerek	edin+Verb+Pos^DB+Adverb+ByDoingSo
ayırarak	ayır+Verb+Pos^DB+Adverb+ByDoingSo
çözülüp	çöz+Verb^DB+Verb+Pass+Pos^DB+Adverb+AfterDoingSo
etkinleştirilmedikçe	etkin+Adj^DB+Verb+Become^DB+Verb+Caus^DB+Verb+Pass+Neg^DB+Adverb+AsLongAs
belirlerken	belirle+Verb+Pos+Aor^DB+Adverb+While
kullanmadıkça	kullan+Verb+Neg^DB+Adverb+AsLongAs
yükleyip	yükle+Verb+Pos^DB+Adverb+AfterDoingSo
deneyip	dene+Verb+Pos^DB+Adverb+AfterDoingSo
oluşturuldukça	oluş+Verb^DB+Verb+Caus^DB+Verb+Pass+Pos^DB+Adverb+AsLongAs
bağlanarak	bağla+Verb^DB+Verb+Pass+Pos^DB+Adverb+ByDoingSo
destekleyip	destekle+Verb+Pos^DB+Adverb+AfterDoingSo
biçimlendirip	biçim+Noun+A3sg+Pnon+Nom^DB+Verb+Acquire^DB+Verb+Caus+Pos^DB+Adverb+AfterDoingSo
kaydederek	kaydet+Verb+Pos^DB+Adverb+ByDoingSo
modundayken	mod+Noun+A3sg+P3sg+Loc^DB+Verb+Zero^DB+Adverb+While
götürerek	götür+Verb+Pos^DB+Adverb+ByDoingSo
yazarken	yazar+Noun+A3sg+Pnon+Nom^DB+Verb+Zero^DB+Adverb+While
kapatarak	kapa+Verb^DB+Verb+Caus+Pos^DB+Adverb+ByDoingSo
alanındayken	al+Verb+Pos^DB+Adj+PresPart^DB+Noun+Zero+A3sg+P3sg+Loc^DB+Verb+Zero^DB+Adverb+While
sürükleyip	sürükle+Verb+Pos^DB+Adverb+AfterDoingSo
başlayıp	başla+Verb+Pos^DB+Adverb+AfterDoingSo
sıralayarak	sırala+Verb+Pos^DB+Adverb+ByDoingSo
alınırken	alın+Verb+Pos+Aor^DB+Adverb+While
çalıp	çal+Verb+Pos^DB+Adverb+AfterDoingSo
sıkıştırırken	sıkış+Verb^DB+Verb+Caus+Pos+Aor^DB+Adverb+While
sıkıştırıp	sıkış+Verb^DB+Verb+Caus+Pos^DB+Adverb+AfterDoingSo
yayımlandıkça	yayımla+Verb^DB+Verb+Pass+Pos^DB+Adverb+AsLongAs
bağlandıkça	bağla+Verb^DB+Verb+Pass+Pos^DB+Adverb+AsLongAs
kopyalarken	kopyala+Verb+Pos+Aor^DB+Adverb+While
seçerken	seç+Verb+Pos+Aor^DB+Adverb+While
sürdürerek	sür+Verb^DB+Verb+Caus+Pos^DB+Adverb+ByDoingSo
küçülterek	küçül+Verb^DB+Verb+Caus+Pos^DB+Adverb+ByDoingSo
ayarlanarak	ayarla+Verb^DB+Verb+Pass+Pos^DB+Adverb+ByDoingSo
görüntüleyerek	görüntüle+Verb+Pos^DB+Adverb+ByDoingSo
taşırken	taşı+Verb+Pos+Aor^DB+Adverb+While
işaretleyip	işaretle+Verb+Pos^DB+Adverb+AfterDoingSo
gidilerek	git+Verb^DB+Verb+Pass+Pos^DB+Adverb+ByDoingSo
değiştirilip	değiş+Verb^DB+Verb+Caus^DB+Verb+Pass+Pos^DB+Adverb+AfterDoingSo
değerlendirilirken	değer+Noun+A3sg+Pnon+Nom^DB+Verb+Acquire^DB+Verb+Caus^DB+Verb+Pass+Pos+Aor^DB+Adverb+While
nispeten	nispeten+Adverb
yedeklerken	yedekle+Verb+Pos+Aor^DB+Adverb+While
çözümleyerek	çözümle+Verb+Pos^DB+Adverb+ByDoingSo
vurgulayarak	vurgula+Verb+Pos^DB+Adverb+ByDoingSo
kalınlaştırarak	kalın+Adj^DB+Verb+Become^DB+Verb+Caus+Pos^DB+Adverb+ByDoingSo
artırarak	art+Verb^DB+Verb+Caus+Pos^DB+Adverb+ByDoingSo
ilişkilendirerek	ilişki+Noun+A3sg+Pnon+Nom^DB+Verb+Acquire^DB+Verb+Caus+Pos^DB+Adverb+ByDoingSo
belirtmedikçe	belir+Verb^DB+Verb+Caus+Neg^DB+Adverb+AsLongAs
düzenlenerek	düzenle+Verb^DB+Verb+Pass+Pos^DB+Adverb+ByDoingSo
hesaplanırken	hesapla+Verb^DB+Verb+Pass+Pos+Aor^DB+Adverb+While
azaltıp	azal+Verb^DB+Verb+Caus+Pos^DB+Adverb+AfterDoingSo
zorlanarak	zorla+Verb^DB+Verb+Pass+Pos^DB+Adverb+ByDoingSo
kullanılıp	kullan+Verb^DB+Verb+Pass+Pos^DB+Adverb+AfterDoingSo
depolayarak	depola+Verb+Pos^DB+Adverb+ByDoingSo
oluşturulup	oluş+Verb^DB+Verb+Caus^DB+Verb+Pass+Pos^DB+Adverb+AfterDoingSo
kurarak	kur+Verb+Pos^DB+Adverb+ByDoingSo
görüntüleyip	görüntüle+Verb+Pos^DB+Adverb+AfterDoingSo
ulaşıp	ulaş+Verb+Pos^DB+Adverb+AfterDoingSo
alınıp	alın+Verb+Pos^DB+Adverb+AfterDoingSo
biriktikçe	birik+Verb+Pos^DB+Adverb+AsLongAs
genişleterek	genişle+Verb^DB+Verb+Caus+Pos^DB+Adverb+ByDoingSo
daraltarak	daral+Verb^DB+Verb+Caus+Pos^DB+Adverb+ByDoingSo
kurarken	kur+Verb+Pos+Aor^DB+Adverb+While
temizlendikçe	temizle+Verb^DB+Verb+Pass+Pos^DB+Adverb+AsLongAs
eklenmedikçe	ekle+Verb^DB+Verb+Pass+Neg^DB+Adverb+AsLongAs
gruplandırılarak	grup+Noun+A3sg+Pnon+Nom^DB+Verb+Acquire^DB+Verb+Caus^DB+Verb+Pass+Pos^DB+Adverb+ByDoingSo
kesilmeden	kes+Verb^DB+Verb+Pass+Pos^DB+Adverb+WithoutHavingDoneSo
kaydedilip	kaydet+Verb^DB+Verb+Pass+Pos^DB+Adverb+AfterDoingSo
kullanıp	kullan+Verb+Pos^DB+Adverb+AfterDoingSo
kaydolarak	kaydol+Verb+Pos^DB+Adverb+ByDoingSo
gerçekleştirip	gerçek+Noun+A3sg+Pnon+Nom^DB+Verb+Become^DB+Verb+Caus+Pos^DB+Adverb+AfterDoingSo
koruyup	koru+Verb+Pos^DB+Adverb+AfterDoingSo
çıkışarak	çıkış+Verb+Pos^DB+Adverb+ByDoingSo
bembeyazken	bembeyaz+Adj^DB+Verb+Zero^DB+Adverb+While
kadarken	kadar+Noun+A3sg+Pnon+Nom^DB+Verb+Zero^DB+Adverb+While
gidecekken	git+Verb+Pos+Fut^DB+Adverb+While
sömürüp	sömür+Verb+Pos^DB+Adverb+AfterDoingSo
bulununca	bul+Verb^DB+Verb+Pass+Pos^DB+Adverb+When
tıraşlayıp	tıraşla+Verb+Pos^DB+Adverb+AfterDoingSo
birleşince	birleş+Verb+Pos^DB+Adverb+When
düşerek	düş+Verb+Pos^DB+Adverb+ByDoingSo
kayarak	kay+Verb+Pos^DB+Adverb+ByDoingSo
göndererek	gönder+Verb+Pos^DB+Adverb+ByDoingSo
alamayınca	al+Verb^DB+Verb+Able+Neg^DB+Adverb+When
donarak	don+Verb+Pos^DB+Adverb+ByDoingSo
donup	don+Verb+Pos^DB+Adverb+AfterDoingSo
etkilenerek	etkile+Verb^DB+Verb+Pass+Pos^DB+Adverb+ByDoingSo
takarak	tak+Verb+Pos^DB+Adverb+ByDoingSo
yakalanıp	yakala+Verb^DB+Verb+Pass+Pos^DB+Adverb+AfterDoingSo
tesadüfen	tesadüfen+Adverb
diyip	de+Verb+Pos^DB+Adverb+AfterDoingSo
kazandıkça	kazan+Verb+Pos^DB+Adverb+AsLongAs
verilmezken	ver+Verb^DB+Verb+Pass+Neg+Aor^DB+Adverb+While
azalırken	azal+Verb+Pos+Aor^DB+Adverb+While
kalmadıkça	kal+Verb+Neg^DB+Adverb+AsLongAs
uyarılarak	uyar+Verb^DB+Verb+Pass+Pos^DB+Adverb+ByDoingSo
düzenlenince	düzenle+Verb^DB+Verb+Pass+Pos^DB+Adverb+When
konuştukça	konuş+Verb+Pos^DB+Adverb+AsLongAs
yığılıp	yığ+Verb^DB+Verb+Pass+Pos^DB+Adverb+AfterDoingSo
düşünülerek	düşün+Verb^DB+Verb+Pass+Pos^DB+Adverb+ByDoingSo
kanunen	kanunen+Adverb
uyuyunca	uyu+Verb+Pos^DB+Adverb+When
kalınabilirken	kal+Verb^DB+Verb+Pass+Pos^DB+Verb+Able+Aor^DB+Adverb+While
değişirken	değiş+Verb+Pos+Aor^DB+Adverb+While
savunarak	savun+Verb+Pos^DB+Adverb+ByDoingSo
parsellenip	parselle+Verb^DB+Verb+Pass+Pos^DB+Adverb+AfterDoingSo
geçenlerde	geçenlerde+Adverb
kiralayarak	kirala+Verb+Pos^DB+Adverb+ByDoingSo
başlayınca	başla+Verb+Pos^DB+Adverb+When
hareketlendirirken	hareket+Noun+A3sg+Pnon+Nom^DB+Verb+Acquire^DB+Verb+Caus+Pos+Aor^DB+Adverb+While
ortaklaşa	ortaklaşa+Adverb
güçlendirip	güç+Noun+A3sg+Pnon+Nom^DB+Verb+Acquire^DB+Verb+Caus+Pos^DB+Adverb+AfterDoingSo
edemeyince	et+Verb^DB+Verb+Able+Neg^DB+Adverb+When
kapatılarak	kapa+Verb^DB+Verb+Caus^DB+Verb+Pass+Pos^DB+Adverb+ByDoingSo
yapmazken	yap+Verb+Neg+Aor^DB+Adverb+While
uğraşırken	uğraş+Verb+Pos+Aor^DB+Adverb+While
aktarınca	aktar+Verb+Pos^DB+Adverb+When
yükleyerek	yükle+Verb+Pos^DB+Adverb+ByDoingSo
duyurunca	duy+Verb^DB+Verb+Caus+Pos^DB+Adverb+When
alelacele	alelacele+Adverb
dökünce	dök+Verb+Pos^DB+Adverb+When
vurularak	vur+Verb^DB+Verb+Pass+Pos^DB+Adverb+ByDoingSo
bildirerek	bil+Verb^DB+Verb+Caus+Pos^DB+Adverb+ByDoingSo
yıllarca	yıllarca+Adverb
usulen	usulen+Adverb
kullanınca	kullan+Verb+Pos^DB+Adverb+When
sorgulanırken	sorgula+Verb^DB+Verb+Pass+Pos+Aor^DB+Adverb+While
esinlenerek	esinle+Verb^DB+Verb+Pass+Pos^DB+Adverb+ByDoingSo
vurgularken	vurgula+Verb+Pos+Aor^DB+Adverb+While
anımsatırken	anımsa+Verb^DB+Verb+Caus+Pos+Aor^DB+Adverb+While
karşılaştırınca	karşılaştır+Verb+Pos^DB+Adverb+When
tanıtıp	tanı+Verb^DB+Verb+Caus+Pos^DB+Adverb+AfterDoingSo
doluyken	dolu+Noun+A3sg+Pnon+Nom^DB+Verb+Zero^DB+Adverb+While
yorarken	yor+Verb+Pos+Aor^DB+Adverb+While
anımsatarak	anımsa+Verb^DB+Verb+Caus+Pos^DB+Adverb+ByDoingSo
yaşayarak	yaşa+Verb+Pos^DB+Adverb+ByDoingSo
öngörüp	öngör+Verb+Pos^DB+Adverb+AfterDoingSo
sağlayarak	sağla+Verb+Pos^DB+Adverb+ByDoingSo
bulunarak	bulun+Verb+Pos^DB+Adverb+ByDoingSo
kazandırarak	kazan+Verb^DB+Verb+Caus+Pos^DB+Adverb+ByDoingSo
gitmeyince	git+Verb+Neg^DB+Adverb+When
dikleşince	dik+Adj^DB+Verb+Become+Pos^DB+Adverb+When
değdikçe	değ+Verb+Pos^DB+Adverb+AsLongAs
arayıp	ara+Verb+Pos^DB+Adverb+AfterDoingSo
getirirken	getir+Verb+Pos+Aor^DB+Adverb+While
bertaraf	bertaraf+Adverb
havadayken	hava+Noun+A3sg+Pnon+Loc^DB+Verb+Zero^DB+Adverb+While
sentezleyerek	sentezle+Verb+Pos^DB+Adverb+ByDoingSo
vedalaşıp	veda+Noun+A3sg+Pnon+Nom^DB+Verb+Become+Pos^DB+Adverb+AfterDoingSo
sıyırarak	sıyır+Verb+Pos^DB+Adverb+ByDoingSo
yenip	ye+Verb^DB+Verb+Pass+Pos^DB+Adverb+AfterDoingSo
sakinleşince	sakin+Adj^DB+Verb+Become+Pos^DB+Adverb+When
sürtüp	sürt+Verb+Pos^DB+Adverb+AfterDoingSo
sarılıp	sar+Verb^DB+Verb+Pass+Pos^DB+Adverb+AfterDoingSo
bağırırken	bağır+Verb+Pos+Aor^DB+Adverb+While
doyasıya	doy+Verb+Pos^DB+Adverb+Adamantly
sayarken	say+Verb+Pos+Aor^DB+Adverb+While
kapayıp	kapa+Verb+Pos^DB+Adverb+AfterDoingSo
pişerken	piş+Verb+Pos+Aor^DB+Adverb+While
bırakmayarak	bırak+Verb+Neg^DB+Adverb+ByDoingSo
yapacakken	yap+Verb+Pos+Fut^DB+Adverb+While
ölçerek	ölç+Verb+Pos^DB+Adverb+ByDoingSo
kararınca	karar+Verb+Pos^DB+Adverb+When
günübirlik	günübirlik+Adverb
yükselerek	yüksel+Verb+Pos^DB+Adverb+ByDoingSo
hálá	hala+Adverb
balondayken	balon+Noun+A3sg+Pnon+Loc^DB+Verb+Zero^DB+Adverb+While
maalesef	maalesef+Adverb
çıkılırken	çık+Verb^DB+Verb+Pass+Pos+Aor^DB+Adverb+While
gidilip	git+Verb^DB+Verb+Pass+Pos^DB+Adverb+AfterDoingSo
yakılarak	yak+Verb^DB+Verb+Pass+Pos^DB+Adverb+ByDoingSo
çıktıkça	çık+Verb+Pos^DB+Adverb+AsLongAs
sapınca	sap+Verb+Pos^DB+Adverb+When
süzülerek	süz+Verb^DB+Verb+Pass+Pos^DB+Adverb+ByDoingSo
aydınlatılıp	aydınlat+Verb^DB+Verb+Pass+Pos^DB+Adverb+AfterDoingSo
doğup	doğ+Verb+Pos^DB+Adverb+AfterDoingSo
tırmanırken	tırman+Verb+Pos+Aor^DB+Adverb+While
gözetilerek	göze+Verb^DB+Verb+Caus^DB+Verb+Pass+Pos^DB+Adverb+ByDoingSo
bıkıp	bık+Verb+Pos^DB+Adverb+AfterDoingSo
düzenleyip	düzenle+Verb+Pos^DB+Adverb+AfterDoingSo
aslen	aslen+Adverb
çürüyüp	çürü+Verb+Pos^DB+Adverb+AfterDoingSo
yapılırken	yap+Verb^DB+Verb+Pass+Pos+Aor^DB+Adverb+While
çirkinleştirip	çirkin+Adj^DB+Verb+Become^DB+Verb+Caus+Pos^DB+Adverb+AfterDoingSo
atılınca	at+Verb^DB+Verb+Pass+Pos^DB+Adverb+When
katiyen	katiyen+Adverb
atlayarak	atla+Verb+Pos^DB+Adverb+ByDoingSo
yudumlayıp	yudumla+Verb+Pos^DB+Adverb+AfterDoingSo
tüttürerek	tüt+Verb^DB+Verb+Caus+Pos^DB+Adverb+ByDoingSo
kalarak	kal+Verb+Pos^DB+Adverb+ByDoingSo
kurulup	kur+Verb^DB+Verb+Pass+Pos^DB+Adverb+AfterDoingSo
yürürcesine	yürü+Verb+Pos+Aor+A3sg^DB+Adverb+AsIf
seyrederken	seyret+Verb+Pos+Aor^DB+Adverb+While
öttürürken	öt+Verb^DB+Verb+Caus+Pos+Aor^DB+Adverb+While
sübyanken	sübyan+Noun+A3sg+Pnon+Nom^DB+Verb+Zero^DB+Adverb+While
çalakalem	çalakalem+Adverb
yüzerek	yüz+Verb+Pos^DB+Adverb+ByDoingSo
sıçrayıp	sıçra+Verb+Pos^DB+Adverb+AfterDoingSo
düzeltip	düzel+Verb^DB+Verb+Caus+Pos^DB+Adverb+AfterDoingSo
yaramazca	yar+Verb^DB+Verb+Able+Neg^DB+Adj+AorPart^DB+Adverb+Ly
sürülüp	sür+Verb^DB+Verb+Pass+Pos^DB+Adverb+AfterDoingSo
mırıldanırken	mırılda+Verb^DB+Verb+Pass+Pos+Aor^DB+Adverb+While
katılıp	kat+Verb^DB+Verb+Pass+Pos^DB+Adverb+AfterDoingSo
çıkartarak	çık+Verb^DB+Verb+Caus^DB+Verb+Caus+Pos^DB+Adverb+ByDoingSo
serilip	ser+Verb^DB+Verb+Pass+Pos^DB+Adverb+AfterDoingSo
koparıp	kop+Verb^DB+Verb+Caus+Pos^DB+Adverb+AfterDoingSo
oturtarak	otur+Verb^DB+Verb+Caus+Pos^DB+Adverb+ByDoingSo
çalarken	çal+Verb+Pos+Aor^DB+Adverb+While
indirince	in+Verb^DB+Verb+Caus+Pos^DB+Adverb+When
kazanıp	kazan+Verb+Pos^DB+Adverb+AfterDoingSo
bulurken	bul+Verb+Pos+Aor^DB+Adverb+While
kazanarak	kazan+Verb+Pos^DB+Adverb+ByDoingSo
yenilerek	ye+Verb^DB+Verb+Pass+Pos^DB+Adverb+ByDoingSo
yenilince	ye+Verb^DB+Verb+Pass+Pos^DB+Adverb+When
toplayarak	topla+Verb+Pos^DB+Adverb+ByDoingSo
severek	sev+Verb+Pos^DB+Adverb+ByDoingSo
yaşlarındayken	yaş+Noun+A3sg+P3pl+Loc^DB+Verb+Zero^DB+Adverb+While
fazlasıyla	fazlasıyla+Adverb
geliştirerek	geliş+Verb^DB+Verb+Caus+Pos^DB+Adverb+ByDoingSo
tanıyıp	tanı+Verb+Pos^DB+Adverb+AfterDoingSo
içindeyken	iç+Noun+A3sg+P3sg+Loc^DB+Verb+Zero^DB+Adverb+While
sevip	sev+Verb+Pos^DB+Adverb+AfterDoingSo
anlaşarak	anlaş+Verb+Pos^DB+Adverb+ByDoingSo
girilirken	gir+Verb^DB+Verb+Pass+Pos+Aor^DB+Adverb+While
çepeçevre	çepeçevre+Adverb
yenerken	yen+Verb+Pos+Aor^DB+Adverb+While
oynandıkça	oyna+Verb^DB+Verb+Pass+Pos^DB+Adverb+AsLongAs
berabere	berabere+Adverb
anlaşınca	anlaş+Verb+Pos^DB+Adverb+When
vallahi	vallahi+Adverb
pazarlayıp	pazarla+Verb+Pos^DB+Adverb+AfterDoingSo
satıp	sat+Verb+Pos^DB+Adverb+AfterDoingSo
akabinde	akabinde+Adverb
yapmayarak	yap+Verb+Neg^DB+Adverb+ByDoingSo
yöneterek	yönet+Verb+Pos^DB+Adverb+ByDoingSo
yayarak	yay+Verb+Pos^DB+Adverb+ByDoingSo
okuyarak	oku+Verb+Pos^DB+Adverb+ByDoingSo
geliştirip	geliş+Verb^DB+Verb+Caus+Pos^DB+Adverb+AfterDoingSo
gösterilerek	göster+Verb^DB+Verb+Pass+Pos^DB+Adverb+ByDoingSo
takriben	takriben+Adverb
ütüleyip	ütüle+Verb+Pos^DB+Adverb+AfterDoingSo
yasaklayıp	yasakla+Verb+Pos^DB+Adverb+AfterDoingSo
sırıtarak	sırıt+Verb+Pos^DB+Adverb+ByDoingSo
rastlayıp	rastla+Verb+Pos^DB+Adverb+AfterDoingSo
tanıtırken	tanı+Verb^DB+Verb+Caus+Pos+Aor^DB+Adverb+While
bastırdıkça	bas+Verb^DB+Verb+Caus+Pos^DB+Adverb+AsLongAs
hakikaten	hakikaten+Adverb
yakarak	yak+Verb+Pos^DB+Adverb+ByDoingSo
inince	in+Verb+Pos^DB+Adverb+When
sanıp	san+Verb+Pos^DB+Adverb+AfterDoingSo
danışarak	danış+Verb+Pos^DB+Adverb+ByDoingSo
getirmeyip	getir+Verb+Neg^DB+Adverb+AfterDoingSo
kötüyken	kötü+Adj^DB+Verb+Zero^DB+Adverb+While
taşınırken	taşı+Verb^DB+Verb+Pass+Pos+Aor^DB+Adverb+While
yenerek	yen+Verb+Pos^DB+Adverb+ByDoingSo
sürdükce	sür+Verb+Pos^DB+Adverb+AsLongAs
anlatıp	anla+Verb^DB+Verb+Caus+Pos^DB+Adverb+AfterDoingSo
yapılarak	yap+Verb^DB+Verb+Pass+Pos^DB+Adverb+ByDoingSo
çakıp	çak+Verb+Pos^DB+Adverb+AfterDoingSo
korurken	koru+Verb+Pos+Aor^DB+Adverb+While
delip	del+Verb+Pos^DB+Adverb+AfterDoingSo
boşlayıp	boşla+Verb+Pos^DB+Adverb+AfterDoingSo
hepten	hepten+Adverb
atılırken	at+Verb^DB+Verb+Pass+Pos+Aor^DB+Adverb+While
ölürken	öl+Verb+Pos+Aor^DB+Adverb+While
getiremeyince	getir+Verb^DB+Verb+Able+Neg^DB+Adverb+When
eklenince	ekle+Verb^DB+Verb+Pass+Pos^DB+Adverb+When
sergilerken	sergile+Verb+Pos+Aor^DB+Adverb+While
seslenip	sesle+Verb^DB+Verb+Pass+Pos^DB+Adverb+AfterDoingSo
bitirip	bit+Verb^DB+Verb+Caus+Pos^DB+Adverb+AfterDoingSo
bulunurken	bulun+Verb+Pos+Aor^DB+Adverb+While
dalgalanarak	dalga+Noun+A3sg+Pnon+Nom^DB+Verb+Acquire+Pos^DB+Adverb+ByDoingSo
tepetaklak	tepetaklak+Adverb
geciktirerek	gecik+Verb^DB+Verb+Caus+Pos^DB+Adverb+ByDoingSo
düştükçe	düş+Verb+Pos^DB+Adverb+AsLongAs
söyleşirken	söyleş+Verb+Pos+Aor^DB+Adverb+While
koklayıp	kokla+Verb+Pos^DB+Adverb+AfterDoingSo
dayanılarak	daya+Verb^DB+Verb+Pass+Pos^DB+Adverb+ByDoingSo
kırılarak	kır+Verb^DB+Verb+Pass+Pos^DB+Adverb+ByDoingSo
söylenirken	söyle+Verb^DB+Verb+Pass+Pos+Aor^DB+Adverb+While
dallandırıp	dal+Noun+A3sg+Pnon+Nom^DB+Verb+Acquire^DB+Verb+Caus+Pos^DB+Adverb+AfterDoingSo
anlaşırken	anlaş+Verb+Pos+Aor^DB+Adverb+While
reddedip	reddet+Verb+Pos^DB+Adverb+AfterDoingSo
olmayınca	ol+Verb+Neg^DB+Adverb+When
algılanıp	algıla+Verb^DB+Verb+Pass+Pos^DB+Adverb+AfterDoingSo
getirilirken	getir+Verb^DB+Verb+Pass+Pos+Aor^DB+Adverb+While
sürdürüp	sür+Verb^DB+Verb+Caus+Pos^DB+Adverb+AfterDoingSo
bulunmazken	bul+Verb^DB+Verb+Pass+Neg+Aor^DB+Adverb+While
avlanarak	avla+Verb^DB+Verb+Pass+Pos^DB+Adverb+ByDoingSo
atılıp	at+Verb^DB+Verb+Pass+Pos^DB+Adverb+AfterDoingSo
ararken	ara+Verb+Pos+Aor^DB+Adverb+While
bayıltılıp	bayıl+Verb^DB+Verb+Caus^DB+Verb+Pass+Pos^DB+Adverb+AfterDoingSo
yatırıp	yatır+Verb+Pos^DB+Adverb+AfterDoingSo
sevinirken	sevin+Verb+Pos+Aor^DB+Adverb+While
yetinmeyip	yetin+Verb+Neg^DB+Adverb+AfterDoingSo
kılarken	kıl+Verb+Pos+Aor^DB+Adverb+While
işleyerek	işle+Verb+Pos^DB+Adverb+ByDoingSo
tozup	toz+Verb+Pos^DB+Adverb+AfterDoingSo
yaklaşırken	yaklaş+Verb+Pos+Aor^DB+Adverb+While
yönlendirerek	yön+Noun+A3sg+Pnon+Nom^DB+Verb+Acquire^DB+Verb+Caus+Pos^DB+Adverb+ByDoingSo
alamayıp	al+Verb^DB+Verb+Able+Neg^DB+Adverb+AfterDoingSo
yoğunlaşınca	yoğun+Adj^DB+Verb+Become+Pos^DB+Adverb+When
tamamlayarak	tamamla+Verb+Pos^DB+Adverb+ByDoingSo
yanıtlarken	yanıtla+Verb+Pos+Aor^DB+Adverb+While
aktarırken	aktar+Verb+Pos+Aor^DB+Adverb+While
kötüleyerek	kötüle+Verb+Pos^DB+Adverb+ByDoingSo
cevaben	cevaben+Adverb
hatırlatıp	hatırla+Verb^DB+Verb+Caus+Pos^DB+Adverb+AfterDoingSo
mecburen	mecburen+Adverb
cidden	cidden+Adverb
görüşülürken	görüş+Verb^DB+Verb+Pass+Pos+Aor^DB+Adverb+While
girilerek	gir+Verb^DB+Verb+Pass+Pos^DB+Adverb+ByDoingSo
yapınca	yap+Verb+Pos^DB+Adverb+When
vazgeçince	vazgeç+Verb+Pos^DB+Adverb+When
kalkınca	kalk+Verb+Pos^DB+Adverb+When
fiilen	fiilen+Adverb
tamamlanarak	tamamla+Verb^DB+Verb+Pass+Pos^DB+Adverb+ByDoingSo
dağıtılarak	dağıt+Verb^DB+Verb+Pass+Pos^DB+Adverb+ByDoingSo
militanlaştırılarak	militan+Noun+A3sg+Pnon+Nom^DB+Verb+Become^DB+Verb+Caus^DB+Verb+Pass+Pos^DB+Adverb+ByDoingSo
hazırlayarak	hazırla+Verb+Pos^DB+Adverb+ByDoingSo
sınanarak	sına+Verb^DB+Verb+Pass+Pos^DB+Adverb+ByDoingSo
çıkılarak	çık+Verb^DB+Verb+Pass+Pos^DB+Adverb+ByDoingSo
aktararak	aktar+Verb+Pos^DB+Adverb+ByDoingSo
denince	de+Verb^DB+Verb+Pass+Pos^DB+Adverb+When
derlenip	derle+Verb^DB+Verb+Pass+Pos^DB+Adverb+AfterDoingSo
belirtirken	belir+Verb^DB+Verb+Caus+Pos+Aor^DB+Adverb+While
koyarken	koyar+Noun+A3sg+Pnon+Nom^DB+Verb+Zero^DB+Adverb+While
güçlendirerek	güç+Noun+A3sg+Pnon+Nom^DB+Verb+Acquire^DB+Verb+Caus+Pos^DB+Adverb+ByDoingSo
vurgulanarak	vurgula+Verb^DB+Verb+Pass+Pos^DB+Adverb+ByDoingSo
toplanıp	topla+Verb^DB+Verb+Pass+Pos^DB+Adverb+AfterDoingSo
çizerek	çiz+Verb+Pos^DB+Adverb+ByDoingSo
naklen	naklen+Adverb
seyredip	seyret+Verb+Pos^DB+Adverb+AfterDoingSo
görmeyince	gör+Verb+Neg^DB+Adverb+When
göstermeyip	göster+Verb+Neg^DB+Adverb+AfterDoingSo
vararak	var+Verb+Pos^DB+Adverb+ByDoingSo
anlayıp	anla+Verb+Pos^DB+Adverb+AfterDoingSo
kısalı	kıs+Verb+Pos^DB+Adverb+SinceDoingSo
bütünleşip	bütün+Adj^DB+Verb+Become+Pos^DB+Adverb+AfterDoingSo
değiştirilerek	değiş+Verb^DB+Verb+Caus^DB+Verb+Pass+Pos^DB+Adverb+ByDoingSo
bakılarak	bak+Verb^DB+Verb+Pass+Pos^DB+Adverb+ByDoingSo
yorumlayarak	yorumla+Verb+Pos^DB+Adverb+ByDoingSo
küsüp	küs+Verb+Pos^DB+Adverb+AfterDoingSo
anlaşılınca	anlaş+Verb^DB+Verb+Pass+Pos^DB+Adverb+When
olmayıp	ol+Verb+Neg^DB+Adverb+AfterDoingSo
burcundayken	burç+Noun+A3sg+P3sg+Loc^DB+Verb+Zero^DB+Adverb+While
affederek	affet+Verb+Pos^DB+Adverb+ByDoingSo
başvurup	başvur+Verb+Pos^DB+Adverb+AfterDoingSo
kıyaslayınca	kıyasla+Verb+Pos^DB+Adverb+When
azarlanıp	azarla+Verb^DB+Verb+Pass+Pos^DB+Adverb+AfterDoingSo
azarlayarak	azarla+Verb+Pos^DB+Adverb+ByDoingSo
sürerken	sür+Verb+Pos+Aor^DB+Adverb+While
tokuştururken	tokuş+Verb^DB+Verb+Caus+Pos+Aor^DB+Adverb+While
denilerek	de+Verb^DB+Verb+Pass+Pos^DB+Adverb+ByDoingSo
uygulanırken	uygula+Verb^DB+Verb+Pass+Pos+Aor^DB+Adverb+While
götürülerek	götür+Verb^DB+Verb+Pass+Pos^DB+Adverb+ByDoingSo
üstlenerek	üstlen+Verb+Pos^DB+Adverb+ByDoingSo
suçlayıp	suçla+Verb+Pos^DB+Adverb+AfterDoingSo
çağırarak	çağır+Verb+Pos^DB+Adverb+ByDoingSo
giydirerek	giy+Verb^DB+Verb+Caus+Pos^DB+Adverb+ByDoingSo
yayınlarken	yayınla+Verb+Pos+Aor^DB+Adverb+While
ödeyemeyince	öde+Verb^DB+Verb+Able+Neg^DB+Adverb+When
yorumlayınca	yorumla+Verb+Pos^DB+Adverb+When
uyarınca	uyar+Verb+Pos^DB+Adverb+When
sancılanınca	sancı+Noun+A3sg+Pnon+Nom^DB+Verb+Acquire+Pos^DB+Adverb+When
indirilerek	in+Verb^DB+Verb+Caus^DB+Verb+Pass+Pos^DB+Adverb+ByDoingSo
öderken	öde+Verb+Pos+Aor^DB+Adverb+While
açıkca	açık+Adj^DB+Adverb+Ly
vurulup	vur+Verb^DB+Verb+Pass+Pos^DB+Adverb+AfterDoingSo
ilelebet	ilelebet+Adverb
toplanırken	topla+Verb^DB+Verb+Pass+Pos+Aor^DB+Adverb+While
beklenirken	bekle+Verb^DB+Verb+Pass+Pos+Aor^DB+Adverb+While
yapılmayıp	yap+Verb^DB+Verb+Pass+Neg^DB+Adverb+AfterDoingSo
ettirilip	et+Verb^DB+Verb+Caus^DB+Verb+Pass+Pos^DB+Adverb+AfterDoingSo
sorarak	sor+Verb+Pos^DB+Adverb+ByDoingSo
sağlanıp	sağla+Verb^DB+Verb+Pass+Pos^DB+Adverb+AfterDoingSo
çıkmayınca	çık+Verb+Neg^DB+Adverb+When
geçilmeden	geç+Verb^DB+Verb+Pass+Pos^DB+Adverb+WithoutHavingDoneSo
hatırlatılınca	hatırla+Verb^DB+Verb+Caus^DB+Verb+Pass+Pos^DB+Adverb+When
değerlendirilince	değer+Noun+A3sg+Pnon+Nom^DB+Verb+Acquire^DB+Verb+Caus^DB+Verb+Pass+Pos^DB+Adverb+When
kaybedeli	kaybet+Verb+Pos^DB+Adverb+SinceDoingSo
acilen	acilen+Adverb
vermezken	ver+Verb+Neg+Aor^DB+Adverb+While
belirtilerek	belir+Verb^DB+Verb+Caus^DB+Verb+Pass+Pos^DB+Adverb+ByDoingSo
bağlatırken	bağla+Verb^DB+Verb+Caus+Pos+Aor^DB+Adverb+While
geçirilerek	geç+Verb^DB+Verb+Caus^DB+Verb+Pass+Pos^DB+Adverb+ByDoingSo
katlanarak	katlan+Verb+Pos^DB+Adverb+ByDoingSo
dikilerek	dik+Verb^DB+Verb+Pass+Pos^DB+Adverb+ByDoingSo
bağlarken	bağla+Verb+Pos+Aor^DB+Adverb+While
tutturularak	tut+Verb^DB+Verb+Caus^DB+Verb+Pass+Pos^DB+Adverb+ByDoingSo
tekrarlayarak	tekrarla+Verb+Pos^DB+Adverb+ByDoingSo
buluşunca	buluş+Verb+Pos^DB+Adverb+When
gizleyerek	gizle+Verb+Pos^DB+Adverb+ByDoingSo
duyururken	duy+Verb^DB+Verb+Caus+Pos+Aor^DB+Adverb+While
uydurarak	uy+Verb^DB+Verb+Caus+Pos^DB+Adverb+ByDoingSo
batarak	bat+Verb+Pos^DB+Adverb+ByDoingSo
aldıkça	al+Verb+Pos^DB+Adverb+AsLongAs
salakça	salak+Adj^DB+Adverb+Ly
özleyip	özle+Verb+Pos^DB+Adverb+AfterDoingSo
dışındayken	dışı+Adj^DB+Noun+Zero+A3sg+P2sg+Loc^DB+Verb+Zero^DB+Adverb+While
beğenerek	beğen+Verb+Pos^DB+Adverb+ByDoingSo
uğraşıp	uğraş+Verb+Pos^DB+Adverb+AfterDoingSo
güzelce	güzel+Adj^DB+Adverb+Ly
kırparken	kırp+Verb+Pos+Aor^DB+Adverb+While
gitmişken	git+Verb+Pos+Narr^DB+Adverb+While
sporken	spor+Noun+A3sg+Pnon+Nom^DB+Verb+Zero^DB+Adverb+While
başladıkça	başla+Verb+Pos^DB+Adverb+AsLongAs
günlerce	günlerce+Adverb
hapisteyken	hapis+Noun+A3sg+Pnon+Loc^DB+Verb+Zero^DB+Adverb+While
çözüp	çöz+Verb+Pos^DB+Adverb+AfterDoingSo
seyredince	seyret+Verb+Pos^DB+Adverb+When
selamlaşarak	selam+Noun+A3sg+Pnon+Nom^DB+Verb+Become+Pos^DB+Adverb+ByDoingSo
yumuşayarak	yumuşa+Verb+Pos^DB+Adverb+ByDoingSo
alamadan	al+Verb+Pos^DB+Adverb+WithoutBeingAbleToHaveDoneSo
söyleterek	söyle+Verb^DB+Verb+Caus+Pos^DB+Adverb+ByDoingSo
fırlatarak	fırla+Verb^DB+Verb+Caus+Pos^DB+Adverb+ByDoingSo
dinleterek	dinle+Verb^DB+Verb+Caus+Pos^DB+Adverb+ByDoingSo
kuşanıp	kuşan+Verb+Pos^DB+Adverb+AfterDoingSo
soğudukça	soğu+Verb+Pos^DB+Adverb+AsLongAs
sıyırıp	sıyır+Verb+Pos^DB+Adverb+AfterDoingSo
çömelirken	çömel+Verb+Pos+Aor^DB+Adverb+While
ölüp	öl+Verb+Pos^DB+Adverb+AfterDoingSo
kollayarak	kolla+Verb+Pos^DB+Adverb+ByDoingSo
karşılayıp	karşıla+Verb+Pos^DB+Adverb+AfterDoingSo
yıkanıp	yıka+Verb^DB+Verb+Reflex+Pos^DB+Adverb+AfterDoingSo
avunarak	avun+Verb+Pos^DB+Adverb+ByDoingSo
doluşarak	dol+Verb^DB+Verb+Recip+Pos^DB+Adverb+ByDoingSo
ayrılırken	ayır+Verb^DB+Verb+Pass+Pos+Aor^DB+Adverb+While
sayıklarken	sayıkla+Verb+Pos+Aor^DB+Adverb+While
düzelmeyince	düzel+Verb+Neg^DB+Adverb+When
öğrencisiyken	öğrenci+Noun+A3sg+P3sg+Nom^DB+Verb+Zero^DB+Adverb+While
satarak	sat+Verb+Pos^DB+Adverb+ByDoingSo
satarken	sat+Verb+Pos+Aor^DB+Adverb+While
yalanlarken	yalanla+Verb+Pos+Aor^DB+Adverb+While
gizlenmeden	gizle+Verb^DB+Verb+Reflex+Pos^DB+Adverb+WithoutHavingDoneSo
meselá	mesela+Adverb
içerisindeyken	içeri+Noun+A3sg+P3sg+Loc^DB+Verb+Zero^DB+Adverb+While
takıp	tak+Verb+Pos^DB+Adverb+AfterDoingSo
dilenerek	dile+Verb^DB+Verb+Pass+Pos^DB+Adverb+ByDoingSo
araştırıp	araştır+Verb+Pos^DB+Adverb+AfterDoingSo
evlenmeden	evlen+Verb+Pos^DB+Adverb+WithoutHavingDoneSo
yalayıp	yala+Verb+Pos^DB+Adverb+AfterDoingSo
eğlenerek	eğlen+Verb+Pos^DB+Adverb+ByDoingSo
bilince	bil+Verb+Pos^DB+Adverb+When
sırıtınca	sırıt+Verb+Pos^DB+Adverb+When
çözerken	çöz+Verb+Pos+Aor^DB+Adverb+While
yazınca	yaz+Verb+Pos^DB+Adverb+When
eleştirirken	eleştir+Verb+Pos+Aor^DB+Adverb+While
gelemeden	gel+Verb+Pos^DB+Adverb+WithoutBeingAbleToHaveDoneSo
getirilip	getir+Verb^DB+Verb+Pass+Pos^DB+Adverb+AfterDoingSo
doğurup	doğ+Verb^DB+Verb+Caus+Pos^DB+Adverb+AfterDoingSo
artarken	art+Verb+Pos+Aor^DB+Adverb+While
alkışlanıp	alkışla+Verb^DB+Verb+Pass+Pos^DB+Adverb+AfterDoingSo
doluşup	dol+Verb^DB+Verb+Recip+Pos^DB+Adverb+AfterDoingSo
unutmadan	unut+Verb+Pos^DB+Adverb+WithoutHavingDoneSo
çalarak	çal+Verb+Pos^DB+Adverb+ByDoingSo
dağılırken	dağıl+Verb+Pos+Aor^DB+Adverb+While
askerdeyken	asker+Noun+A3sg+Pnon+Loc^DB+Verb+Zero^DB+Adverb+While
çakışmadıkça	çakış+Verb+Neg^DB+Adverb+AsLongAs
bileli	bil+Verb+Pos^DB+Adverb+SinceDoingSo
erkene	er+Noun+A3sg+Pnon+Nom^DB+Verb+Zero^DB+Adverb+While
katarak	kat+Verb+Pos^DB+Adverb+ByDoingSo
önerirken	öner+Verb+Pos+Aor^DB+Adverb+While
bağlayıp	bağla+Verb+Pos^DB+Adverb+AfterDoingSo
telaşındayken	telaş+Noun+A3sg+P3sg+Loc^DB+Verb+Zero^DB+Adverb+While
karıştırarak	karış+Verb^DB+Verb+Caus+Pos^DB+Adverb+ByDoingSo
peşindeyken	peşin+Adj^DB+Noun+Zero+A3sg+Pnon+Loc^DB+Verb+Zero^DB+Adverb+While
genişleyip	genişle+Verb+Pos^DB+Adverb+AfterDoingSo
genişletip	genişle+Verb^DB+Verb+Caus+Pos^DB+Adverb+AfterDoingSo
gözlemleyerek	gözlemle+Verb+Pos^DB+Adverb+ByDoingSo
öğretirken	öğret+Verb+Pos+Aor^DB+Adverb+While
eğlendirirken	eğlen+Verb^DB+Verb+Caus+Pos+Aor^DB+Adverb+While
sahipken	sahip+Noun+A3sg+Pnon+Nom^DB+Verb+Zero^DB+Adverb+While
etkilerken	etkile+Verb+Pos+Aor^DB+Adverb+While
kuvvetlendikçe	kuvvet+Noun+A3sg+Pnon+Nom^DB+Verb+Acquire+Pos^DB+Adverb+AsLongAs
kavuştukça	kavuş+Verb+Pos^DB+Adverb+AsLongAs
tesadüfi	tesadüfi+Adverb
kavuşup	kavuş+Verb+Pos^DB+Adverb+AfterDoingSo
ivedilikle	ivedilikle+Adverb
çırpınıp	çırpın+Verb+Pos^DB+Adverb+AfterDoingSo
bölerek	böl+Verb+Pos^DB+Adverb+ByDoingSo
görevlendirilerek	görev+Noun+A3sg+Pnon+Nom^DB+Verb+Acquire^DB+Verb+Caus^DB+Verb+Pass+Pos^DB+Adverb+ByDoingSo
söyleyince	söyle+Verb+Pos^DB+Adverb+When
tanımadan	tanı+Verb+Pos^DB+Adverb+WithoutHavingDoneSo
bulundurarak	bulun+Verb^DB+Verb+Caus+Pos^DB+Adverb+ByDoingSo
atılarak	at+Verb^DB+Verb+Pass+Pos^DB+Adverb+ByDoingSo
kesilirken	kes+Verb^DB+Verb+Pass+Pos+Aor^DB+Adverb+While
naklederken	naklet+Verb+Pos+Aor^DB+Adverb+While
ballandırarak	bal+Noun+A3sg+Pnon+Nom^DB+Verb+Acquire^DB+Verb+Caus+Pos^DB+Adverb+ByDoingSo
boyanıp	boya+Verb^DB+Verb+Reflex+Pos^DB+Adverb+AfterDoingSo
okunurken	oku+Verb^DB+Verb+Pass+Pos+Aor^DB+Adverb+While
dönüştürülerek	dönüş+Verb^DB+Verb+Caus^DB+Verb+Pass+Pos^DB+Adverb+ByDoingSo
oluşunca	oluş+Verb+Pos^DB+Adverb+When
varıp	var+Verb+Pos^DB+Adverb+AfterDoingSo
dokunup	doku+Verb^DB+Verb+Pass+Pos^DB+Adverb+AfterDoingSo
bitirerek	bit+Verb^DB+Verb+Caus+Pos^DB+Adverb+ByDoingSo
alenen	alenen+Adverb
sattırıp	sat+Verb^DB+Verb+Caus+Pos^DB+Adverb+AfterDoingSo
kısıtlayarak	kısıtla+Verb+Pos^DB+Adverb+ByDoingSo
yıkıp	yık+Verb+Pos^DB+Adverb+AfterDoingSo
devrederek	devret+Verb+Pos^DB+Adverb+ByDoingSo
açılıp	aç+Verb^DB+Verb+Pass+Pos^DB+Adverb+AfterDoingSo
sürdürürken	sür+Verb^DB+Verb+Caus+Pos+Aor^DB+Adverb+While
yakalayınca	yakala+Verb+Pos^DB+Adverb+When
kullanmayıp	kullan+Verb+Neg^DB+Adverb+AfterDoingSo
kırarak	kır+Verb+Pos^DB+Adverb+ByDoingSo
ödeyip	öde+Verb+Pos^DB+Adverb+AfterDoingSo
gerileyerek	gerile+Verb+Pos^DB+Adverb+ByDoingSo
kademedeyken	kademe+Noun+A3sg+Pnon+Loc^DB+Verb+Zero^DB+Adverb+While
planlayarak	planla+Verb+Pos^DB+Adverb+ByDoingSo
tümden	tümden+Adverb
münhasıran	münhasıran+Adverb
yaptırıp	yap+Verb^DB+Verb+Caus+Pos^DB+Adverb+AfterDoingSo
bulunmaksızın	bulun+Verb+Pos^DB+Adverb+WithoutHavingDoneSo
kapıp	kap+Verb+Pos^DB+Adverb+AfterDoingSo
tarayarak	tara+Verb+Pos^DB+Adverb+ByDoingSo
kaldırılarak	kaldır+Verb^DB+Verb+Pass+Pos^DB+Adverb+ByDoingSo
satılıp	sat+Verb^DB+Verb+Pass+Pos^DB+Adverb+AfterDoingSo
alacakken	alacak+Noun+A3sg+Pnon+Nom^DB+Verb+Zero^DB+Adverb+While
göremeden	gör+Verb+Pos^DB+Adverb+WithoutBeingAbleToHaveDoneSo
bilinçlendirirken	bilinç+Noun+A3sg+Pnon+Nom^DB+Verb+Acquire^DB+Verb+Caus+Pos+Aor^DB+Adverb+While
gerçekleştirerek	gerçek+Noun+A3sg+Pnon+Nom^DB+Verb+Become^DB+Verb+Caus+Pos^DB+Adverb+ByDoingSo
duyurarak	duy+Verb^DB+Verb+Caus+Pos^DB+Adverb+ByDoingSo
tanıtarak	tanı+Verb^DB+Verb+Caus+Pos^DB+Adverb+ByDoingSo
tanımaksızın	tanı+Verb+Pos^DB+Adverb+WithoutHavingDoneSo
basılarak	bas+Verb^DB+Verb+Pass+Pos^DB+Adverb+ByDoingSo
ilkokuldayken	ilkokul+Noun+A3sg+Pnon+Loc^DB+Verb+Zero^DB+Adverb+While
özenerek	özen+Verb+Pos^DB+Adverb+ByDoingSo
sinirliyken	sinir+Noun+A3sg+Pnon+Nom^DB+Adj+With^DB+Verb+Zero^DB+Adverb+While
zannedip	zannet+Verb+Pos^DB+Adverb+AfterDoingSo
güldürürken	gül+Verb^DB+Verb+Caus+Pos+Aor^DB+Adverb+While
vatandaşken	vatandaş+Noun+A3sg+Pnon+Nom^DB+Verb+Zero^DB+Adverb+While
geçemeden	geç+Verb+Pos^DB+Adverb+WithoutBeingAbleToHaveDoneSo
attırarak	at+Verb^DB+Verb+Caus+Pos^DB+Adverb+ByDoingSo
güldürüp	gül+Verb^DB+Verb+Caus+Pos^DB+Adverb+AfterDoingSo
yaşanırken	yaşa+Verb^DB+Verb+Pass+Pos+Aor^DB+Adverb+While
sergilenince	sergile+Verb^DB+Verb+Pass+Pos^DB+Adverb+When
açtırıp	aç+Verb^DB+Verb+Caus+Pos^DB+Adverb+AfterDoingSo
tüketilirken	tüket+Verb^DB+Verb+Pass+Pos+Aor^DB+Adverb+While
harcanırken	harca+Verb^DB+Verb+Pass+Pos+Aor^DB+Adverb+While
üretilirken	üre+Verb^DB+Verb+Caus^DB+Verb+Pass+Pos+Aor^DB+Adverb+While
toparlanırken	toparla+Verb^DB+Verb+Pass+Pos+Aor^DB+Adverb+While
getirince	getir+Verb+Pos^DB+Adverb+When
yumuşayınca	yumuşa+Verb+Pos^DB+Adverb+When
açıldıkça	aç+Verb^DB+Verb+Pass+Pos^DB+Adverb+AsLongAs
serpilip	serp+Verb^DB+Verb+Pass+Pos^DB+Adverb+AfterDoingSo
koydurup	koy+Verb^DB+Verb+Caus+Pos^DB+Adverb+AfterDoingSo
numaralandırılıp	numara+Noun+A3sg+Pnon+Nom^DB+Verb+Acquire^DB+Verb+Caus^DB+Verb+Pass+Pos^DB+Adverb+AfterDoingSo
yıldızlanarak	yıldızla+Verb^DB+Verb+Pass+Pos^DB+Adverb+ByDoingSo
konularak	kon+Verb^DB+Verb+Pass+Pos^DB+Adverb+ByDoingSo
yararlanılarak	yarar+Noun+A3sg+Pnon+Nom^DB+Verb+Acquire^DB+Verb+Pass+Pos^DB+Adverb+ByDoingSo
karıştırılıp	karış+Verb^DB+Verb+Caus^DB+Verb+Pass+Pos^DB+Adverb+AfterDoingSo
kaydedilerek	kaydet+Verb^DB+Verb+Pass+Pos^DB+Adverb+ByDoingSo
pompalanıp	pompala+Verb^DB+Verb+Pass+Pos^DB+Adverb+AfterDoingSo
hazırlanarak	hazırla+Verb^DB+Verb+Pass+Pos^DB+Adverb+ByDoingSo
zorlayıp	zorla+Verb+Pos^DB+Adverb+AfterDoingSo
uygulayıp	uygula+Verb+Pos^DB+Adverb+AfterDoingSo
konarak	kon+Verb+Pos^DB+Adverb+ByDoingSo
maruzken	maruz+Adj^DB+Verb+Zero^DB+Adverb+While
haşlayıp	haşla+Verb+Pos^DB+Adverb+AfterDoingSo
üreterek	üre+Verb^DB+Verb+Caus+Pos^DB+Adverb+ByDoingSo
yansıtırken	yansı+Verb^DB+Verb+Caus+Pos+Aor^DB+Adverb+While
çevirince	çevir+Verb+Pos^DB+Adverb+When
edecekken	et+Verb+Pos+Fut^DB+Adverb+While
döşenirken	döşe+Verb^DB+Verb+Pass+Pos+Aor^DB+Adverb+While
ailece	ailece+Adverb
pişirilerek	piş+Verb^DB+Verb+Caus^DB+Verb+Pass+Pos^DB+Adverb+ByDoingSo
öngörülürken	öngör+Verb^DB+Verb+Pass+Pos+Aor^DB+Adverb+While
tasarlanıp	tasarla+Verb^DB+Verb+Pass+Pos^DB+Adverb+AfterDoingSo
bütünleşince	bütün+Adj^DB+Verb+Become+Pos^DB+Adverb+When
sıralarken	sırala+Verb+Pos+Aor^DB+Adverb+While
affedip	affet+Verb+Pos^DB+Adverb+AfterDoingSo
cevaplayarak	cevapla+Verb+Pos^DB+Adverb+ByDoingSo
bitirirken	bit+Verb^DB+Verb+Caus+Pos+Aor^DB+Adverb+While
davranırken	davran+Verb+Pos+Aor^DB+Adverb+While
kıyasıya	kıy+Verb+Pos^DB+Adverb+Adamantly
değerlendirirken	değer+Noun+A3sg+Pnon+Nom^DB+Verb+Acquire^DB+Verb+Caus+Pos+Aor^DB+Adverb+While
oturarak	otur+Verb+Pos^DB+Adverb+ByDoingSo
sahiplenip	sahiplen+Verb+Pos^DB+Adverb+AfterDoingSo
külliyen	külliyen+Adverb
terkederek	terket+Verb+Pos^DB+Adverb+ByDoingSo
çalışınca	çalış+Verb+Pos^DB+Adverb+When
maaile	maaile+Adverb
gözlemlerken	gözlemle+Verb+Pos+Aor^DB+Adverb+While
atınca	at+Verb+Pos^DB+Adverb+When
sorunca	sor+Verb+Pos^DB+Adverb+When
yaklaşılırken	yaklaş+Verb^DB+Verb+Pass+Pos+Aor^DB+Adverb+While
ayarlayıp	ayarla+Verb+Pos^DB+Adverb+AfterDoingSo
futbolcuyken	futbolcu+Noun+A3sg+Pnon+Nom^DB+Verb+Zero^DB+Adverb+While
eleyip	ele+Verb+Pos^DB+Adverb+AfterDoingSo
kenetlenerek	kenetle+Verb^DB+Verb+Pass+Pos^DB+Adverb+ByDoingSo
kazandırıp	kazan+Verb^DB+Verb+Caus+Pos^DB+Adverb+AfterDoingSo
birleşerek	birleş+Verb+Pos^DB+Adverb+ByDoingSo
büyüyerek	büyü+Verb+Pos^DB+Adverb+ByDoingSo
biterken	bit+Verb+Pos+Aor^DB+Adverb+While
katılırken	kat+Verb^DB+Verb+Pass+Pos+Aor^DB+Adverb+While
üstlenirken	üstlen+Verb+Pos+Aor^DB+Adverb+While
alınmışken	al+Verb^DB+Verb+Pass+Pos+Narr^DB+Adverb+While
noktalayıp	noktala+Verb+Pos^DB+Adverb+AfterDoingSo
planlamayıp	planla+Verb+Neg^DB+Adverb+AfterDoingSo
haberleşerek	haber+Noun+A3sg+Pnon+Nom^DB+Verb+Become+Pos^DB+Adverb+ByDoingSo
değerlendirip	değer+Noun+A3sg+Pnon+Nom^DB+Verb+Acquire^DB+Verb+Caus+Pos^DB+Adverb+AfterDoingSo
eritip	eri+Verb^DB+Verb+Caus+Pos^DB+Adverb+AfterDoingSo
aktarıp	aktar+Verb+Pos^DB+Adverb+AfterDoingSo
serip	ser+Verb+Pos^DB+Adverb+AfterDoingSo
gezdirip	gez+Verb^DB+Verb+Caus+Pos^DB+Adverb+AfterDoingSo
cok	çok+Adverb
yanındayken	yan+Noun+A3sg+P3sg+Loc^DB+Verb+Zero^DB+Adverb+While
gezerek	gez+Verb+Pos^DB+Adverb+ByDoingSo
öğretilip	öğret+Verb^DB+Verb+Pass+Pos^DB+Adverb+AfterDoingSo
değişmedikçe	değiş+Verb+Neg^DB+Adverb+AsLongAs
temsilen	temsilen+Adverb
araştırılırken	araştır+Verb^DB+Verb+Pass+Pos+Aor^DB+Adverb+While
varmışçasına	var+Verb+Pos+Narr+A3sg^DB+Adverb+AsIf
irdelerken	irdele+Verb+Pos+Aor^DB+Adverb+While
benimsenirken	benimse+Verb^DB+Verb+Pass+Pos+Aor^DB+Adverb+While
belirlenip	belirle+Verb^DB+Verb+Pass+Pos^DB+Adverb+AfterDoingSo
kazanınca	kazan+Verb+Pos^DB+Adverb+When
yönetirken	yönet+Verb+Pos+Aor^DB+Adverb+While
gireli	gir+Verb+Pos^DB+Adverb+SinceDoingSo
üfleyerek	üfle+Verb+Pos^DB+Adverb+ByDoingSo
ödeyemezken	öde+Verb^DB+Verb+Able+Neg+Aor^DB+Adverb+While
yöneltip	yönel+Verb^DB+Verb+Caus+Pos^DB+Adverb+AfterDoingSo
bastıkça	bas+Verb+Pos^DB+Adverb+AsLongAs
kopunca	kop+Verb+Pos^DB+Adverb+When
yaratarak	yarat+Verb+Pos^DB+Adverb+ByDoingSo
aldırmayıp	al+Verb^DB+Verb+Caus+Neg^DB+Adverb+AfterDoingSo
öğrenciyken	öğrenci+Noun+A3sg+Pnon+Nom^DB+Verb+Zero^DB+Adverb+While
gerginleşince	gergin+Adj^DB+Verb+Become+Pos^DB+Adverb+When
sustukça	sus+Verb+Pos^DB+Adverb+AsLongAs
bindirilerek	bin+Verb^DB+Verb+Caus^DB+Verb+Pass+Pos^DB+Adverb+ByDoingSo
lanetleyerek	lanetle+Verb+Pos^DB+Adverb+ByDoingSo
boşaltıp	boşal+Verb^DB+Verb+Caus+Pos^DB+Adverb+AfterDoingSo
seçtirip	seç+Verb^DB+Verb+Caus+Pos^DB+Adverb+AfterDoingSo
taşınıp	taşı+Verb^DB+Verb+Pass+Pos^DB+Adverb+AfterDoingSo
kaçırarak	kaç+Verb^DB+Verb+Caus+Pos^DB+Adverb+ByDoingSo
güvenip	güven+Verb+Pos^DB+Adverb+AfterDoingSo
burkularak	burk+Verb^DB+Verb+Pass+Pos^DB+Adverb+ByDoingSo
dökülürken	dök+Verb^DB+Verb+Pass+Pos+Aor^DB+Adverb+While
bekleyerek	bekle+Verb+Pos^DB+Adverb+ByDoingSo
zannederek	zannet+Verb+Pos^DB+Adverb+ByDoingSo
tutuklanıp	tutukla+Verb^DB+Verb+Pass+Pos^DB+Adverb+AfterDoingSo
artarak	art+Verb+Pos^DB+Adverb+ByDoingSo
tartışılıp	tartış+Verb^DB+Verb+Pass+Pos^DB+Adverb+AfterDoingSo
yayınlayıp	yayınla+Verb+Pos^DB+Adverb+AfterDoingSo
billahi	billahi+Adverb
ödenirken	öde+Verb^DB+Verb+Pass+Pos+Aor^DB+Adverb+While
artırılarak	art+Verb^DB+Verb+Caus^DB+Verb+Pass+Pos^DB+Adverb+ByDoingSo
sağlanamayınca	sağla+Verb^DB+Verb+Pass^DB+Verb+Able+Neg^DB+Adverb+When
devredilince	devret+Verb^DB+Verb+Pass+Pos^DB+Adverb+When
cebren	cebren+Adverb
koyunca	koy+Verb+Pos^DB+Adverb+When
hukuken	hukuken+Adverb
yayınlayarak	yayınla+Verb+Pos^DB+Adverb+ByDoingSo
yanaşıp	yanaş+Verb+Pos^DB+Adverb+AfterDoingSo
soyunup	soyun+Verb+Pos^DB+Adverb+AfterDoingSo
kestirip	kes+Verb^DB+Verb+Caus+Pos^DB+Adverb+AfterDoingSo
aranıp	ara+Verb^DB+Verb+Pass+Pos^DB+Adverb+AfterDoingSo
artınca	art+Verb+Pos^DB+Adverb+When
değinirken	değin+Verb+Pos+Aor^DB+Adverb+While
duyup	duy+Verb+Pos^DB+Adverb+AfterDoingSo
dışlayarak	dışla+Verb+Pos^DB+Adverb+ByDoingSo
kızken	kız+Noun+A3sg+Pnon+Nom^DB+Verb+Zero^DB+Adverb+While
dinlenirken	dinle+Verb^DB+Verb+Pass+Pos+Aor^DB+Adverb+While
evlenip	evlen+Verb+Pos^DB+Adverb+AfterDoingSo
benzetirken	benze+Verb^DB+Verb+Caus+Pos+Aor^DB+Adverb+While
kurularak	kur+Verb^DB+Verb+Pass+Pos^DB+Adverb+ByDoingSo
güçlendirilirken	güç+Noun+A3sg+Pnon+Nom^DB+Verb+Acquire^DB+Verb+Caus^DB+Verb+Pass+Pos+Aor^DB+Adverb+While
uçurarak	uç+Verb^DB+Verb+Caus+Pos^DB+Adverb+ByDoingSo
inerek	in+Verb+Pos^DB+Adverb+ByDoingSo
avlarken	avla+Verb+Pos+Aor^DB+Adverb+While
temizlerken	temizle+Verb+Pos+Aor^DB+Adverb+While
temizleyince	temizle+Verb+Pos^DB+Adverb+When
otlatırken	otla+Verb^DB+Verb+Caus+Pos+Aor^DB+Adverb+While
alınınca	al+Verb^DB+Verb+Pass+Pos^DB+Adverb+When
meraklanarak	merak+Noun+A3sg+Pnon+Nom^DB+Verb+Acquire+Pos^DB+Adverb+ByDoingSo
kalmayıp	kal+Verb+Neg^DB+Adverb+AfterDoingSo
beğenip	beğen+Verb+Pos^DB+Adverb+AfterDoingSo
sürünürken	sürü+Verb^DB+Verb+Pass+Pos+Aor^DB+Adverb+While
dışlanırken	dışla+Verb^DB+Verb+Pass+Pos+Aor^DB+Adverb+While
soyutlanırken	soyutla+Verb^DB+Verb+Pass+Pos+Aor^DB+Adverb+While
götürülürken	götür+Verb^DB+Verb+Pass+Pos+Aor^DB+Adverb+While
uyuyup	uyu+Verb+Pos^DB+Adverb+AfterDoingSo
sevdikçe	sev+Verb+Pos^DB+Adverb+AsLongAs
attırıp	at+Verb^DB+Verb+Caus+Pos^DB+Adverb+AfterDoingSo
ettirerek	et+Verb^DB+Verb+Caus+Pos^DB+Adverb+ByDoingSo
denilince	de+Verb^DB+Verb+Pass+Pos^DB+Adverb+When
inemeyince	in+Verb^DB+Verb+Able+Neg^DB+Adverb+When
sevinip	sevin+Verb+Pos^DB+Adverb+AfterDoingSo
üzülüp	üz+Verb^DB+Verb+Pass+Pos^DB+Adverb+AfterDoingSo
kapılıp	kap+Verb^DB+Verb+Pass+Pos^DB+Adverb+AfterDoingSo
yedikçe	ye+Verb+Pos^DB+Adverb+AsLongAs
eriyip	eri+Verb+Pos^DB+Adverb+AfterDoingSo
sığdırınca	sığ+Verb^DB+Verb+Caus+Pos^DB+Adverb+When
hemencecik	hemencecik+Adverb
çocuğuyken	çocuk+Noun+A3sg+P3sg+Nom^DB+Verb+Zero^DB+Adverb+While
hissediyorken	hisset+Verb+Pos+Prog1^DB+Adverb+While
anlattıkça	anla+Verb^DB+Verb+Caus+Pos^DB+Adverb+AsLongAs
büyütüp	büyü+Verb^DB+Verb+Caus+Pos^DB+Adverb+AfterDoingSo
geçinip	geçin+Verb+Pos^DB+Adverb+AfterDoingSo
paylaşıp	paylaş+Verb+Pos^DB+Adverb+AfterDoingSo
tatildeyken	tatil+Noun+A3sg+Pnon+Loc^DB+Verb+Zero^DB+Adverb+While
yatırılarak	yat+Verb^DB+Verb+Caus^DB+Verb+Pass+Pos^DB+Adverb+ByDoingSo
kalıplaşıp	kalıplaş+Verb+Pos^DB+Adverb+AfterDoingSo
yakınlaşıp	yakın+Adj^DB+Verb+Become+Pos^DB+Adverb+AfterDoingSo
giydirip	giy+Verb^DB+Verb+Caus+Pos^DB+Adverb+AfterDoingSo
açılarak	aç+Verb^DB+Verb+Pass+Pos^DB+Adverb+ByDoingSo
evliyken	ev+Noun+A3sg+Pnon+Nom^DB+Adj+With^DB+Verb+Zero^DB+Adverb+While
boşanırken	boşa+Verb^DB+Verb+Pass+Pos+Aor^DB+Adverb+While
çirkince	çirkin+Adj^DB+Adverb+Ly
hamileyken	hamile+Noun+A3sg+Pnon+Nom^DB+Verb+Zero^DB+Adverb+While
değerlendirerek	değer+Noun+A3sg+Pnon+Nom^DB+Verb+Acquire^DB+Verb+Caus+Pos^DB+Adverb+ByDoingSo
yaparcasına	yap+Verb+Pos+Aor+A3sg^DB+Adverb+AsIf
gönderirken	gönder+Verb+Pos+Aor^DB+Adverb+While
başlatarak	başla+Verb^DB+Verb+Caus+Pos^DB+Adverb+ByDoingSo
tekrarlarken	tekrarla+Verb+Pos+Aor^DB+Adverb+While
harcadıkça	harca+Verb+Pos^DB+Adverb+AsLongAs
giyecekken	giyecek+Noun+A3sg+Pnon+Nom^DB+Verb+Zero^DB+Adverb+While
açınca	aç+Verb+Pos^DB+Adverb+When
belirtilirken	belir+Verb^DB+Verb+Caus^DB+Verb+Pass+Pos+Aor^DB+Adverb+While
görüşerek	görüş+Verb+Pos^DB+Adverb+ByDoingSo
değerlendirilerek	değer+Noun+A3sg+Pnon+Nom^DB+Verb+Acquire^DB+Verb+Caus^DB+Verb+Pass+Pos^DB+Adverb+ByDoingSo
gözetmeksizin	göze+Verb^DB+Verb+Caus+Pos^DB+Adverb+WithoutHavingDoneSo
terleyerek	terle+Verb+Pos^DB+Adverb+ByDoingSo
sıyrılıp	sıyrıl+Verb+Pos^DB+Adverb+AfterDoingSo
şaşarken	şaş+Verb+Pos+Aor^DB+Adverb+While
öldürürken	öl+Verb^DB+Verb+Caus+Pos+Aor^DB+Adverb+While
şahsen	şahsen+Adverb
tutularak	tut+Verb^DB+Verb+Pass+Pos^DB+Adverb+ByDoingSo
kavuşurken	kavuş+Verb+Pos+Aor^DB+Adverb+While
boğarak	boğ+Verb+Pos^DB+Adverb+ByDoingSo
bağlanıp	bağla+Verb^DB+Verb+Pass+Pos^DB+Adverb+AfterDoingSo
karşılaştırılıp	karşılaştır+Verb^DB+Verb+Pass+Pos^DB+Adverb+AfterDoingSo
tanışıp	tanış+Verb+Pos^DB+Adverb+AfterDoingSo
boğup	boğ+Verb+Pos^DB+Adverb+AfterDoingSo
yararlanarak	yarar+Noun+A3sg+Pnon+Nom^DB+Verb+Acquire+Pos^DB+Adverb+ByDoingSo
kalkışınca	kalkış+Verb+Pos^DB+Adverb+When
yararlanıp	yarar+Noun+A3sg+Pnon+Nom^DB+Verb+Acquire+Pos^DB+Adverb+AfterDoingSo
gerçekleşirken	gerçek+Noun+A3sg+Pnon+Nom^DB+Verb+Become+Pos+Aor^DB+Adverb+While
yükselince	yüksel+Verb+Pos^DB+Adverb+When
durdurunca	dur+Verb^DB+Verb+Caus+Pos^DB+Adverb+When
yürütülürken	yürü+Verb^DB+Verb+Caus^DB+Verb+Pass+Pos+Aor^DB+Adverb+While
gerçekleştirilirken	gerçek+Noun+A3sg+Pnon+Nom^DB+Verb+Become^DB+Verb+Caus^DB+Verb+Pass+Pos+Aor^DB+Adverb+While
detaylandırıp	detay+Noun+A3sg+Pnon+Nom^DB+Verb+Acquire^DB+Verb+Caus+Pos^DB+Adverb+AfterDoingSo
şaşırtıp	şaşır+Verb^DB+Verb+Caus+Pos^DB+Adverb+AfterDoingSo
kaplıyken	kap+Noun+A3sg+Pnon+Nom^DB+Adj+With^DB+Verb+Zero^DB+Adverb+While
gereğince	gereğince+Adverb
görüşülüp	görüş+Verb^DB+Verb+Pass+Pos^DB+Adverb+AfterDoingSo
tanışırken	tanış+Verb+Pos+Aor^DB+Adverb+While
gerçekleşip	gerçek+Adj^DB+Verb+Become+Pos^DB+Adverb+AfterDoingSo
yağlayıp	yağla+Verb+Pos^DB+Adverb+AfterDoingSo
sahiden	sahiden+Adverb
susturarak	sus+Verb^DB+Verb+Caus+Pos^DB+Adverb+ByDoingSo
ettikçe	et+Verb+Pos^DB+Adverb+AsLongAs
edildikçe	et+Verb^DB+Verb+Pass+Pos^DB+Adverb+AsLongAs
sarınca	sar+Verb+Pos^DB+Adverb+When
yapılandırarak	yapı+Noun+A3sg+Pnon+Nom^DB+Verb+Acquire^DB+Verb+Caus+Pos^DB+Adverb+ByDoingSo
ardarda	ardarda+Adverb
borçlanılarak	borç+Noun+A3sg+Pnon+Nom^DB+Verb+Acquire^DB+Verb+Pass+Pos^DB+Adverb+ByDoingSo
sıralayıp	sırala+Verb+Pos^DB+Adverb+AfterDoingSo
geçirilip	geç+Verb^DB+Verb+Caus^DB+Verb+Pass+Pos^DB+Adverb+AfterDoingSo
tuttukça	tut+Verb+Pos^DB+Adverb+AsLongAs
üretirken	üre+Verb^DB+Verb+Caus+Pos+Aor^DB+Adverb+While
izlenerek	izle+Verb^DB+Verb+Pass+Pos^DB+Adverb+ByDoingSo
artırıp	art+Verb^DB+Verb+Caus+Pos^DB+Adverb+AfterDoingSo
kaplanarak	kapla+Verb^DB+Verb+Pass+Pos^DB+Adverb+ByDoingSo
alçalarak	alçal+Verb+Pos^DB+Adverb+ByDoingSo
serpilirken	serp+Verb^DB+Verb+Pass+Pos+Aor^DB+Adverb+While
uyarlanarak	uyarla+Verb^DB+Verb+Pass+Pos^DB+Adverb+ByDoingSo
temizletip	temizle+Verb^DB+Verb+Caus+Pos^DB+Adverb+AfterDoingSo
serpip	serp+Verb+Pos^DB+Adverb+AfterDoingSo
bekletip	bekle+Verb^DB+Verb+Caus+Pos^DB+Adverb+AfterDoingSo
katlayarak	katla+Verb+Pos^DB+Adverb+ByDoingSo
bölüp	böl+Verb+Pos^DB+Adverb+AfterDoingSo
ovalayarak	ovala+Verb+Pos^DB+Adverb+ByDoingSo
kazıyıp	kazı+Verb+Pos^DB+Adverb+AfterDoingSo
katıp	kat+Verb+Pos^DB+Adverb+AfterDoingSo
ayıklayıp	ayıkla+Verb+Pos^DB+Adverb+AfterDoingSo
pişip	piş+Verb+Pos^DB+Adverb+AfterDoingSo
çırparken	çırp+Verb+Pos+Aor^DB+Adverb+While
yedirilerek	ye+Verb^DB+Verb+Caus^DB+Verb+Pass+Pos^DB+Adverb+ByDoingSo
kurutularak	kuru+Verb^DB+Verb+Caus^DB+Verb+Pass+Pos^DB+Adverb+ByDoingSo
sürülerek	sür+Verb^DB+Verb+Pass+Pos^DB+Adverb+ByDoingSo
ıslatıp	ısla+Verb^DB+Verb+Caus+Pos^DB+Adverb+AfterDoingSo
süsleyerek	süsle+Verb+Pos^DB+Adverb+ByDoingSo
koyulaşıp	koyu+Adj^DB+Verb+Become+Pos^DB+Adverb+AfterDoingSo
süsleyip	süsle+Verb+Pos^DB+Adverb+AfterDoingSo
popülerken	popüler+Adj^DB+Verb+Zero^DB+Adverb+While
verilirken	ver+Verb^DB+Verb+Pass+Pos+Aor^DB+Adverb+While
doyurup	doy+Verb^DB+Verb+Caus+Pos^DB+Adverb+AfterDoingSo
beslenirken	besle+Verb^DB+Verb+Pass+Pos+Aor^DB+Adverb+While
yumuşayıp	yumuşa+Verb+Pos^DB+Adverb+AfterDoingSo
serpiştirip	serpiş+Verb^DB+Verb+Caus+Pos^DB+Adverb+AfterDoingSo
batırarak	bat+Verb^DB+Verb+Caus+Pos^DB+Adverb+ByDoingSo
yoğurup	yoğur+Verb+Pos^DB+Adverb+AfterDoingSo
ıslatarak	ısla+Verb^DB+Verb+Caus+Pos^DB+Adverb+ByDoingSo
yuvarlayıp	yuvarla+Verb+Pos^DB+Adverb+AfterDoingSo
dizip	diz+Verb+Pos^DB+Adverb+AfterDoingSo
yerleştirip	yerleş+Verb^DB+Verb+Caus+Pos^DB+Adverb+AfterDoingSo
ufalayıp	ufala+Verb+Pos^DB+Adverb+AfterDoingSo
parçalayarak	parçala+Verb+Pos^DB+Adverb+ByDoingSo
örtüp	ört+Verb+Pos^DB+Adverb+AfterDoingSo
dinlenip	dinle+Verb^DB+Verb+Pass+Pos^DB+Adverb+AfterDoingSo
birleştirerek	birleş+Verb^DB+Verb+Caus+Pos^DB+Adverb+ByDoingSo
yağlamayıp	yağla+Verb+Neg^DB+Adverb+AfterDoingSo
soğuyunca	soğu+Verb+Pos^DB+Adverb+When
