bulunuyor	bulun	Verb	Verb
veriyor	ver	Verb	Verb
biliyorum	bile	Verb	Verb
bilmiyor	bil	Verb	Verb
benziyorsun	benze	Verb	Verb
düşünmüyorum	düşün	Verb	Verb
söylüyor	söyle	Verb	Verb
kaybediyor	kaybet	Verb	Verb
saklıyorum	sakla	Verb	Verb
istiyorsan	iste	Verb	Verb
yapıyorsa	yap	Verb	Verb
onaylıyor	onayla	Verb	Verb
etmiyorum	et	Verb	Verb
karışmıyorum	karış	Verb	Verb
geliyor	gel	Verb	Verb
sanıyorum	san	Verb	Verb
kastetmiyorsun	kastet	Verb	Verb
biliyorsun	bile	Verb	Verb
buluyorum	bula	Verb	Verb
hissediyorum	hisset	Verb	Verb
bilmiyorum	bil	Verb	Verb
sarıyor	sar	Verb	Verb
öpüyorum	öp	Verb	Verb
görüyor	gör	Verb	Verb
kalıyor	kal	Verb	Verb
anlamıyorum	anla	Verb	Verb
seviyorum	sev	Verb	Verb
istiyorum	iste	Verb	Verb
geçiyorsun	geç	Verb	Verb
yapıyor	yap	Verb	Verb
kastediyorsun	kastet	Verb	Verb
istiyorsa	iste	Verb	Verb
ediyorum	et	Verb	Verb
hoşlanıyorum	hoşlan	Verb	Verb
konuşuyorsun	konuş	Verb	Verb
sallıyor	salla	Verb	Verb
inanıyorum	inan	Verb	Verb
onaylıyorum	onayla	Verb	Verb
mahvediyor	mahvet	Verb	Verb
sürüyor	sür	Verb	Verb
bakıyor	bak	Verb	Verb
ediyorsun	et	Verb	Verb
saçıyor	saç	Verb	Verb
diliyorum	dile	Verb	Verb
görünmüyor	görün	Verb	Verb
gidiyor	git	Verb	Verb
oturuyor	otur	Verb	Verb
düşünüyorsunuz	düşün	Verb	Verb
hatırlamıyorum	hatırla	Verb	Verb
ediyor	et	Verb	Verb
gidiyorum	git	Verb	Verb
gösteriyorum	göster	Verb	Verb
yapıyorsunuz	yap	Verb	Verb
yapmıyorum	yap	Verb	Verb
çarpıyor	çarp	Verb	Verb
tanımıyorsunuz	tanı	Verb	Verb
diyorsunuz	de	Verb	Verb
bahsediyorum	bahset	Verb	Verb
hatırlıyorum	hatırla	Verb	Verb
konuşuyor	konuş	Verb	Verb
mahvediyorsunuz	mahvet	Verb	Verb
yaşıyoruz	yaşa	Verb	Verb
görmüyor	gör	Verb	Verb
kastetmiyorum	kastet	Verb	Verb
söylüyorum	söyle	Verb	Verb
büyülüyorsunuz	büyüle	Verb	Verb
koşuyor	koş	Verb	Verb
ediyorsunuz	et	Verb	Verb
anlamıyor	anla	Verb	Verb
hatırlıyor	hatırla	Verb	Verb
istemiyorum	iste	Verb	Verb
istiyorsunuz	iste	Verb	Verb
hissediyor	hisset	Verb	Verb
bırakıyorsun	bırak	Verb	Verb
biliyor	bile	Verb	Verb
veriyorum	ver	Verb	Verb
başlıyorum	başla	Verb	Verb
kalkışıyorsunuz	kalkış	Verb	Verb
gerekiyor	gerek	Verb	Verb
bakıyorsunuz	bak	Verb	Verb
konuşuyorsunuz	konuş	Verb	Verb
soruyorsunuz	sor	Verb	Verb
duruyorsunuz	dur	Verb	Verb
istemiyoruz	iste	Verb	Verb
sanıyorsunuz	san	Verb	Verb
çekiyorsunuz	çek	Verb	Verb
konuşuyorum	konuş	Verb	Verb
seviyor	sev	Verb	Verb
bilmiyorsunuz	bil	Verb	Verb
kazıyorsunuz	kaz	Verb	Verb
açıklıyorsunuz	açıkla	Verb	Verb
durmuyorum	dur	Verb	Verb
okuyor	oku	Verb	Verb
buluyorsunuz	bula	Verb	Verb
şaşıyorsunuz	şaş	Verb	Verb
girişiyorum	giriş	Verb	Verb
dinliyor	dinle	Verb	Verb
şakıyorsunuz	şakı	Verb	Verb
yaşıyorum	yaşa	Verb	Verb
görüyorsunuz	gör	Verb	Verb
ayırıyor	ayır	Verb	Verb
eğiyorum	eğ	Verb	Verb
gerekiyorsa	gerek	Verb	Verb
bağışlıyorum	bağışla	Verb	Verb
karşılaşıyorsunuz	karşılaş	Verb	Verb
seyrediyorsunuz	seyret	Verb	Verb
gidiyorsunuz	git	Verb	Verb
başlıyor	başla	Verb	Verb
duyuyorsunuz	duy	Verb	Verb
anlıyorsunuz	anla	Verb	Verb
ölüyor	öl	Verb	Verb
alıyorsunuz	al	Verb	Verb
giriyorsunuz	gir	Verb	Verb
ulaşıyor	ulaş	Verb	Verb
alıyorum	al	Verb	Verb
düşünüyor	düşün	Verb	Verb
görünüyor	görün	Verb	Verb
korkuyorum	kork	Verb	Verb
bulanıyor	bulan	Verb	Verb
çalışıyor	çalış	Verb	Verb
içiyor	iç	Verb	Verb
vermiyorlar	ver	Verb	Verb
soruyorum	sor	Verb	Verb
kokuyor	kok	Verb	Verb
duyuyor	duy	Verb	Verb
katıyor	kat	Verb	Verb
alıyor	al	Verb	Verb
yığıyor	yığ	Verb	Verb
diyor	de	Verb	Verb
diyorum	de	Verb	Verb
benziyor	benze	Verb	Verb
sağlıyor	sağla	Verb	Verb
dürtüyor	dürt	Verb	Verb
kalkıyor	kalk	Verb	Verb
paylaşıyorlarsa	paylaş	Verb	Verb
seviyorsa	sev	Verb	Verb
veriyorsa	ver	Verb	Verb
esirgiyor	esirge	Verb	Verb
sataşmıyor	sataş	Verb	Verb
korkuyor	kork	Verb	Verb
anlıyor	anla	Verb	Verb
öğreniyor	öğren	Verb	Verb
taşıyor	taş	Verb	Verb
diyorsam	de	Verb	Verb
duyuyorum	duy	Verb	Verb
düşünüyorum	düşün	Verb	Verb
alçalıyor	alçal	Verb	Verb
süzüyor	süz	Verb	Verb
tanıyor	tanı	Verb	Verb
tanıyorum	tanı	Verb	Verb
titriyorsunuz	titre	Verb	Verb
söylüyorsunuz	söyle	Verb	Verb
titriyor	titre	Verb	Verb
istiyorsanız	iste	Verb	Verb
geçiyor	geç	Verb	Verb
tutuyorum	tut	Verb	Verb
sevmiyor	sev	Verb	Verb
gülüyorsunuz	gül	Verb	Verb
çalışıyorum	çalış	Verb	Verb
gülüyorum	gül	Verb	Verb
söylemiyorsunuz	söyle	Verb	Verb
kabarıyor	kabar	Verb	Verb
bağlıyorsunuz	bağla	Verb	Verb
ağlıyor	ağla	Verb	Verb
anlıyorum	anla	Verb	Verb
şaşıyorum	şaş	Verb	Verb
çağırıyorum	çağır	Verb	Verb
diyorlar	de	Verb	Verb
duruyorlar	dur	Verb	Verb
geliyorlar	gel	Verb	Verb
atıyor	ata	Verb	Verb
dinlemiyor	dinle	Verb	Verb
gülümsüyor	gülümse	Verb	Verb
duruyor	dur	Verb	Verb
istiyor	iste	Verb	Verb
yatıyor	yat	Verb	Verb
seyrediyor	seyret	Verb	Verb
oluyor	ol	Verb	Verb
oluyorum	ol	Verb	Verb
yiyor	ye	Verb	Verb
soruyor	sor	Verb	Verb
inceliyor	incele	Verb	Verb
dolaşıyor	dolaş	Verb	Verb
uğramıyor	uğra	Verb	Verb
seziyor	sez	Verb	Verb
bakıyoruz	bak	Verb	Verb
bilmiyorsun	bil	Verb	Verb
şişiyor	şiş	Verb	Verb
çıkıyorsunuz	çık	Verb	Verb
terkediyor	terket	Verb	Verb
ediyorlar	et	Verb	Verb
giriyor	gir	Verb	Verb
soluyorlar	sol	Verb	Verb
yakışmıyor	yakış	Verb	Verb
bekliyorsanız	bekle	Verb	Verb
kullanıyor	kullan	Verb	Verb
almıyorsun	al	Verb	Verb
alıyorsun	al	Verb	Verb
anlamıyorsun	anla	Verb	Verb
saçmalıyorsun	saçmala	Verb	Verb
çeviriyor	çevir	Verb	Verb
bakıyorlar	bak	Verb	Verb
biliyorsunuz	bile	Verb	Verb
yarıyor	yara	Verb	Verb
oturuyorlar	otur	Verb	Verb
çeviriyorlar	çevir	Verb	Verb
istiyorlar	iste	Verb	Verb
yazıyor	yaz	Verb	Verb
yaşıyorlar	yaşa	Verb	Verb
uyuyor	uy	Verb	Verb
çıkıyor	çık	Verb	Verb
huylanıyor	huylan	Verb	Verb
çıkıyoruz	çık	Verb	Verb
yaşıyor	yaşa	Verb	Verb
çevreliyor	çevrele	Verb	Verb
izliyor	izle	Verb	Verb
biliyorsanız	bile	Verb	Verb
kırıyor	kır	Verb	Verb
düşünüyorsun	düşün	Verb	Verb
ağlamıyorsun	ağla	Verb	Verb
duruyorsa	dur	Verb	Verb
sanmıyorum	san	Verb	Verb
istemiyorsun	iste	Verb	Verb
dokunuyor	dokun	Verb	Verb
görünüyorsunuz	görün	Verb	Verb
görünmüyorum	görün	Verb	Verb
daralıyor	daral	Verb	Verb
biliyoruz	bile	Verb	Verb
gelmiyor	gel	Verb	Verb
gösteriyor	göster	Verb	Verb
aşağılıyor	aşağıla	Verb	Verb
davranıyor	davran	Verb	Verb
tutuyoruz	tut	Verb	Verb
çağırıyor	çağır	Verb	Verb
dağıtıyor	dağıt	Verb	Verb
korkuyorsunuz	kork	Verb	Verb
aşıyor	aş	Verb	Verb
etkiliyor	etkile	Verb	Verb
bırakıyor	bırak	Verb	Verb
emiyor	em	Verb	Verb
büyüyor	büyü	Verb	Verb
sıkıyor	sık	Verb	Verb
dönüyor	dön	Verb	Verb
olmuyor	ol	Verb	Verb
inanıyor	inan	Verb	Verb
bulmuyorum	bul	Verb	Verb
süpürüyor	süpür	Verb	Verb
inanıyorsun	inan	Verb	Verb
gitmiyorsun	git	Verb	Verb
zorluyor	zorla	Verb	Verb
sevişiyor	seviş	Verb	Verb
okuyorum	oku	Verb	Verb
okuyorlar	oku	Verb	Verb
bahsediyor	bahset	Verb	Verb
hapsediyorlar	hapset	Verb	Verb
okuyorsun	oku	Verb	Verb
uyanıyor	uyan	Verb	Verb
büyülüyor	büyüle	Verb	Verb
söylüyorsa	söyle	Verb	Verb
istiyorsun	iste	Verb	Verb
seviyorsan	sev	Verb	Verb
zayıflıyorsun	zayıfla	Verb	Verb
yaşıyorsun	yaşa	Verb	Verb
getiriyorsun	getir	Verb	Verb
diyorsun	de	Verb	Verb
yutuyor	yut	Verb	Verb
içiyorsun	iç	Verb	Verb
oluyorsa	ol	Verb	Verb
atıyorlar	ata	Verb	Verb
konuyor	kon	Verb	Verb
konuyorlar	kon	Verb	Verb
işliyorlar	işle	Verb	Verb
yapıyorlar	yap	Verb	Verb
yatıyorsunuz	yat	Verb	Verb
söylemiyorsun	söyle	Verb	Verb
bahsediyorsunuz	bahset	Verb	Verb
bahsediyoruz	bahset	Verb	Verb
bahsediyorsanız	bahset	Verb	Verb
çalıyor	çal	Verb	Verb
öğretiyor	öğret	Verb	Verb
korkmuyorum	kork	Verb	Verb
bekliyor	bekle	Verb	Verb
etmiyorlar	et	Verb	Verb
girmiyorum	gir	Verb	Verb
buluyor	bula	Verb	Verb
söylüyorlar	söyle	Verb	Verb
arıyorum	ara	Verb	Verb
hazırlıyorum	hazırla	Verb	Verb
yakıyor	yak	Verb	Verb
güveniyorum	güven	Verb	Verb
sanıyor	san	Verb	Verb
seviyorsunuz	sev	Verb	Verb
bekliyorum	bekle	Verb	Verb
duymuyor	duy	Verb	Verb
seviniyorum	sevin	Verb	Verb
yakışıyor	yakış	Verb	Verb
yetiyor	yet	Verb	Verb
duyuyorsanız	duy	Verb	Verb
bakıyorum	bak	Verb	Verb
bayılıyor	bayıl	Verb	Verb
indi	in	Verb	Verb
geriledi	gerile	Verb	Verb
düştü	düş	Verb	Verb
çıktı	çık	Verb	Verb
olmuştu	ol	Verb	Verb
yaptı	yap	Verb	Verb
bulundu	bulun	Verb	Verb
etti	et	Verb	Verb
söyledi	söyle	Verb	Verb
seçti	seç	Verb	Verb
koydu	koy	Verb	Verb
geldi	gel	Verb	Verb
verdi	ver	Verb	Verb
olsaydım	ol	Verb	Verb
olsaydı	ol	Verb	Verb
yapardım	yap	Verb	Verb
gördüm	gör	Verb	Verb
bağırdı	bağır	Verb	Verb
çekindi	çekin	Verb	Verb
idi	i	Verb	Verb
bindiler	bin	Verb	Verb
indiler	in	Verb	Verb
geçmişti	geç	Verb	Verb
gerekiyordu	gerek	Verb	Verb
istiyordu	iste	Verb	Verb
tiksiniyordu	tiksin	Verb	Verb
okşadı	okşa	Verb	Verb
bekliyordu	bekle	Verb	Verb
oturdu	otur	Verb	Verb
dolaşıyorlardı	dolaş	Verb	Verb
işitiyordu	işit	Verb	Verb
itti	it	Verb	Verb
aldı	al	Verb	Verb
düşünüyordu	düşün	Verb	Verb
olmalıydı	ol	Verb	Verb
izliyordu	izle	Verb	Verb
gitti	git	Verb	Verb
baktı	bak	Verb	Verb
gördü	gör	Verb	Verb
dedi	de	Verb	Verb
vermedi	ver	Verb	Verb
miydin	mi	Ques	Ques
çatmıştı	çat	Verb	Verb
duymuyordu	duy	Verb	Verb
çıkmamıştı	çık	Verb	Verb
salladı	salla	Verb	Verb
biliyordum	bile	Verb	Verb
sevdik	sev	Verb	Verb
yaşasaydı	yaşa	Verb	Verb
ederdi	et	Verb	Verb
haykırdı	haykır	Verb	Verb
doldu	dol	Verb	Verb
sildi	sil	Verb	Verb
fısıldadı	fısılda	Verb	Verb
öptü	öp	Verb	Verb
verdimse	ver	Verb	Verb
gösterdi	göster	Verb	Verb
olurdu	ol	Verb	Verb
kesti	kes	Verb	Verb
kayboluyordu	kaybol	Verb	Verb
duydu	duy	Verb	Verb
hatırladı	hatırla	Verb	Verb
bulunmuştu	bulun	Verb	Verb
etmedi	et	Verb	Verb
hissetti	hisset	Verb	Verb
silkindi	silkin	Verb	Verb
çattı	çat	Verb	Verb
söylemedim	söyle	Verb	Verb
söyledim	söyle	Verb	Verb
sordu	sor	Verb	Verb
gelmedik	gel	Verb	Verb
olmazdı	ol	Verb	Verb
güldü	gül	Verb	Verb
olmamıştım	ol	Verb	Verb
oldu	ol	Verb	Verb
görünüyordu	görün	Verb	Verb
söyledin	söyle	Verb	Verb
karıştı	karış	Verb	Verb
koymuştu	koy	Verb	Verb
yedim	ye	Verb	Verb
gittim	git	Verb	Verb
oynuyordu	oyna	Verb	Verb
görmeliydiniz	gör	Verb	Verb
giymişti	giy	Verb	Verb
görünmemişti	görün	Verb	Verb
taşıyordu	taş	Verb	Verb
izledim	izle	Verb	Verb
unuttum	unut	Verb	Verb
ilerliyordum	ilerle	Verb	Verb
konuştum	konuş	Verb	Verb
yaklaştı	yaklaş	Verb	Verb
öptük	öp	Verb	Verb
geliyordu	gel	Verb	Verb
titredi	titre	Verb	Verb
ürperdi	ürper	Verb	Verb
söylemedi	söyle	Verb	Verb
fısıldadılar	fısılda	Verb	Verb
yaptın	yap	Verb	Verb
bıraktım	bırak	Verb	Verb
yudumladı	yudumla	Verb	Verb
unuttun	unut	Verb	Verb
konuşmadım	konuş	Verb	Verb
mırıldandı	mırıldan	Verb	Verb
sordum	sor	Verb	Verb
değiştim	değiş	Verb	Verb
silkti	silk	Verb	Verb
geçti	geç	Verb	Verb
yudumladılar	yudumla	Verb	Verb
kapladı	kapla	Verb	Verb
hissediyordu	hisset	Verb	Verb
girmişti	gir	Verb	Verb
varmıştı	var	Verb	Verb
götürdü	götür	Verb	Verb
hoşlanmıştı	hoşlan	Verb	Verb
ediyordu	et	Verb	Verb
benziyordu	benze	Verb	Verb
asmışlardı	as	Verb	Verb
paylaştılar	paylaş	Verb	Verb
anladım	anla	Verb	Verb
düşünmüyordum	düşün	Verb	Verb
olacaktın	ol	Verb	Verb
düşündü	düşün	Verb	Verb
düşmüştü	düş	Verb	Verb
titriyordu	titre	Verb	Verb
başladı	başla	Verb	Verb
mırıldanıyordu	mırıldan	Verb	Verb
geçiyordu	geç	Verb	Verb
girdi	gir	Verb	Verb
durdu	dur	Verb	Verb
konuştu	konuş	Verb	Verb
yarattı	yarat	Verb	Verb
görünmüştü	görün	Verb	Verb
uğramışlardı	uğra	Verb	Verb
beklediler	bekle	Verb	Verb
değildi	değil	Verb	Verb
vurguluyordu	vurgula	Verb	Verb
okudu	oku	Verb	Verb
dağıldı	dağıl	Verb	Verb
başladılar	başla	Verb	Verb
giydi	giy	Verb	Verb
göründü	görün	Verb	Verb
kaybetmiyordu	kaybet	Verb	Verb
geçtim	geç	Verb	Verb
söylemiyordu	söyle	Verb	Verb
kalmazdı	kal	Verb	Verb
durmuyordu	dur	Verb	Verb
inanırdı	inan	Verb	Verb
veriyordu	ver	Verb	Verb
oturuyordu	otur	Verb	Verb
hazırlamıştı	hazırla	Verb	Verb
kemiriyordu	kemir	Verb	Verb
denemişti	dene	Verb	Verb
biliyordu	bile	Verb	Verb
başlamıştı	başla	Verb	Verb
sardı	sar	Verb	Verb
çıkmıştı	çık	Verb	Verb
mıydı	mı	Ques	Ques
dönmediler	dön	Verb	Verb
hoşlanmıyorlardı	hoşlan	Verb	Verb
basacaktı	bas	Verb	Verb
davranıyordu	davran	Verb	Verb
bağırıyorlardı	bağır	Verb	Verb
dalarlardı	dal	Verb	Verb
başlamamıştı	başla	Verb	Verb
bilmiyordu	bil	Verb	Verb
inanıyordu	inan	Verb	Verb
uyardı	uyar	Verb	Verb
koymadı	koy	Verb	Verb
gidiyordu	git	Verb	Verb
içmişti	iç	Verb	Verb
yuvarladı	yuvarla	Verb	Verb
çalışıyordu	çalış	Verb	Verb
yiyordu	ye	Verb	Verb
olacaktı	ol	Verb	Verb
yetmişti	yet	Verb	Verb
uğruyordu	uğra	Verb	Verb
oluyordu	ol	Verb	Verb
karşılaştım	karşılaş	Verb	Verb
kızdı	kız	Verb	Verb
basmadım	bas	Verb	Verb
kurtarmıştı	kurtar	Verb	Verb
etmişti	et	Verb	Verb
gerekirdi	gerek	Verb	Verb
miydiniz	mi	Ques	Ques
söylüyordunuz	söyle	Verb	Verb
istememiştiniz	iste	Verb	Verb
çekiniyordum	çekin	Verb	Verb
giderdi	gider	Verb	Verb
duydum	duy	Verb	Verb
yürüdü	yürü	Verb	Verb
uğraştı	uğraş	Verb	Verb
dinledim	dinle	Verb	Verb
duymalıydınız	duy	Verb	Verb
koydular	koy	Verb	Verb
atıyordu	ata	Verb	Verb
eğlendiniz	eğlen	Verb	Verb
gevşemişti	gevşe	Verb	Verb
vurmuştu	vur	Verb	Verb
anlıyordu	anla	Verb	Verb
sezdi	sez	Verb	Verb
hatırladın	hatırla	Verb	Verb
ettik	et	Verb	Verb
çıktım	çık	Verb	Verb
baktım	bak	Verb	Verb
buldunuz	bul	Verb	Verb
yıkasaydı	yıka	Verb	Verb
süzüyordu	süz	Verb	Verb
duruyordu	dur	Verb	Verb
evlendi	evlen	Verb	Verb
okumuştu	oku	Verb	Verb
geçinirlerdi	geçin	Verb	Verb
kayboldu	kaybol	Verb	Verb
tanışmıştım	tanış	Verb	Verb
çıkmazdı	çık	Verb	Verb
duymuştum	duy	Verb	Verb
söylüyordu	söyle	Verb	Verb
işliyordu	işle	Verb	Verb
büyüledi	büyüle	Verb	Verb
çarpıyordu	çarp	Verb	Verb
hatırladım	hatırla	Verb	Verb
unutmadım	unut	Verb	Verb
olurdum	ol	Verb	Verb
isteseydiniz	iste	Verb	Verb
geveledi	gevele	Verb	Verb
reddetti	reddet	Verb	Verb
miydi	mi	Ques	Ques
okumuştum	oku	Verb	Verb
unutmuştum	unut	Verb	Verb
kazanmıştı	kazan	Verb	Verb
gevşiyordu	gevşe	Verb	Verb
yalvarıyordu	yalvar	Verb	Verb
getirdi	getir	Verb	Verb
çöktü	çök	Verb	Verb
bağırıyordu	bağır	Verb	Verb
görürdüm	gör	Verb	Verb
söylerdik	söyle	Verb	Verb
körükledi	körükle	Verb	Verb
hissetmişti	hisset	Verb	Verb
bakardım	bak	Verb	Verb
kucakladı	kucakla	Verb	Verb
seyrediyordu	seyret	Verb	Verb
coşmuştu	coş	Verb	Verb
çevirdi	çevir	Verb	Verb
ettiniz	et	Verb	Verb
zorladı	zorla	Verb	Verb
kekeliyordu	kekele	Verb	Verb
geldiniz	gel	Verb	Verb
geveliyordu	gevele	Verb	Verb
yaptınız	yap	Verb	Verb
sokacaklardı	sok	Verb	Verb
gitmiştim	git	Verb	Verb
kalmıştım	kal	Verb	Verb
kapadı	kapa	Verb	Verb
söyleyecektim	söyle	Verb	Verb
istedi	iste	Verb	Verb
kapaklanıyordu	kapaklan	Verb	Verb
kaldı	kal	Verb	Verb
duyuyordu	duy	Verb	Verb
yanıyordu	yan	Verb	Verb
yaşarmıştı	yaşar	Verb	Verb
duymuştu	duy	Verb	Verb
süzdü	süz	Verb	Verb
tekrarladı	tekrarla	Verb	Verb
parladı	parla	Verb	Verb
dinlediniz	dinle	Verb	Verb
yaptım	yap	Verb	Verb
verdiniz	ver	Verb	Verb
miydim	mi	Ques	Ques
çevirmediniz	çevir	Verb	Verb
reddetmediniz	reddet	Verb	Verb
ayırmıştınız	ayır	Verb	Verb
buruştu	buruş	Verb	Verb
tuttu	tut	Verb	Verb
çevirmedimse	çevir	Verb	Verb
yalvardınız	yalvar	Verb	Verb
dediniz	de	Verb	Verb
görmedim	gör	Verb	Verb
vurdum	vur	Verb	Verb
vardınız	var	Verb	Verb
sordunuz	sor	Verb	Verb
istemedik	iste	Verb	Verb
diyordum	de	Verb	Verb
köpürdü	köpür	Verb	Verb
olduk	ol	Verb	Verb
kavradı	kavra	Verb	Verb
gitmemişti	git	Verb	Verb
doğdu	doğ	Verb	Verb
vuruldunuz	vurul	Verb	Verb
verdim	ver	Verb	Verb
ilişti	iliş	Verb	Verb
öğrendim	öğren	Verb	Verb
fırladı	fırla	Verb	Verb
anlattı	anlat	Verb	Verb
döndü	dön	Verb	Verb
istiyordum	iste	Verb	Verb
olurdunuz	ol	Verb	Verb
oldum	ol	Verb	Verb
konuştunuz	konuş	Verb	Verb
anladınız	anla	Verb	Verb
öğrendiniz	öğren	Verb	Verb
yapmış	yap	Verb	Verb
eskimiş	eski	Verb	Verb
çıkarmış	çık	Verb	Verb
yıpranmış	yıpran	Verb	Verb
kalmış	kal	Verb	Verb
büyülemişse	büyüle	Verb	Verb
evlenmiş	evlen	Verb	Verb
doğmuş	doğ	Verb	Verb
karşılaşmış	karşılaş	Verb	Verb
girmiş	gir	Verb	Verb
yaratmış	yarat	Verb	Verb
gelmiş	gel	Verb	Verb
etmiyormuş	et	Verb	Verb
değişmiş	değiş	Verb	Verb
yaşıyormuş	yaşa	Verb	Verb
beğenmiş	beğen	Verb	Verb
duymamış	duy	Verb	Verb
kızarmış	kız	Verb	Verb
değilmiş	değil	Verb	Verb
yemiş	ye	Verb	Verb
etmişler	et	Verb	Verb
tanışıyormuş	tanış	Verb	Verb
dikmiş	dik	Verb	Verb
coşmuş	coş	Verb	Verb
sevmemiş	sev	Verb	Verb
sıkmış	sık	Verb	Verb
evlenecekmişsiniz	evlen	Verb	Verb
duymuş	duy	Verb	Verb
öğrenmiş	öğren	Verb	Verb
görmüş	gör	Verb	Verb
bırakmamışsınız	bırak	Verb	Verb
dinlemişsiniz	dinle	Verb	Verb
sormuş	sor	Verb	Verb
kalmamış	kal	Verb	Verb
yanılmamışım	yanıl	Verb	Verb
inanmış	inan	Verb	Verb
etmiş	et	Verb	Verb
korkuyormuş	kork	Verb	Verb
kararmış	kar	Verb	Verb
emretmemiş	emret	Verb	Verb
çıkmış	çık	Verb	Verb
almış	al	Verb	Verb
yetişmemiş	yetiş	Verb	Verb
kaybetmiş	kaybet	Verb	Verb
yatmış	yat	Verb	Verb
yetmiyormuş	yet	Verb	Verb
çiğnemiş	çiğne	Verb	Verb
anlamış	anla	Verb	Verb
uyanmış	uyan	Verb	Verb
kaçmış	kaç	Verb	Verb
durmamış	dur	Verb	Verb
etmemiş	et	Verb	Verb
gözetlemiş	gözetle	Verb	Verb
becermiş	becer	Verb	Verb
konuşuyormuş	konuş	Verb	Verb
alışmış	alış	Verb	Verb
çalmışlar	çal	Verb	Verb
acımamışlar	acı	Verb	Verb
boyamışlar	boya	Verb	Verb
kalkmış	kalk	Verb	Verb
dönmüş	dön	Verb	Verb
dağılmış	dağıl	Verb	Verb
vuracakmış	vur	Verb	Verb
yaklaşmış	yaklaş	Verb	Verb
kesmiş	kes	Verb	Verb
yakalamış	yakala	Verb	Verb
olurmuşuz	ol	Verb	Verb
sersemlemiş	sersemle	Verb	Verb
ürpermiş	ürper	Verb	Verb
uzamış	uza	Verb	Verb
kaybolmuş	kaybol	Verb	Verb
oturmuş	otur	Verb	Verb
eğmiş	eğ	Verb	Verb
bıkmış	bık	Verb	Verb
usanmış	usan	Verb	Verb
karışmış	karış	Verb	Verb
kaplamış	kapla	Verb	Verb
tutmuş	tut	Verb	Verb
kısmış	kıs	Verb	Verb
unutmuş	unut	Verb	Verb
uzamışsın	uza	Verb	Verb
kullanıyormuşsun	kullan	Verb	Verb
gelmişsin	gel	Verb	Verb
soruyormuş	sor	Verb	Verb
yakışmışlar	yakış	Verb	Verb
uymuşlar	uy	Verb	Verb
yetişiyormuş	yetiş	Verb	Verb
dalmış	dal	Verb	Verb
veriyorlarmış	ver	Verb	Verb
geçecekmişiz	geç	Verb	Verb
yaparlarmış	yap	Verb	Verb
yormuş	yor	Verb	Verb
olmazmış	ol	Verb	Verb
imiş	i	Verb	Verb
otururlarmış	otur	Verb	Verb
azmış	az	Verb	Verb
buruşmuş	buruş	Verb	Verb
vurmuş	vur	Verb	Verb
sarkmış	sark	Verb	Verb
yönelmiş	yönel	Verb	Verb
edecekmiş	et	Verb	Verb
bırakmış	bırak	Verb	Verb
konuşmuş	konuş	Verb	Verb
işlemiş	işle	Verb	Verb
vermiş	ver	Verb	Verb
yapışmış	yapış	Verb	Verb
bilmiyormuş	bil	Verb	Verb
duymuşlar	duy	Verb	Verb
sanmış	san	Verb	Verb
düşmüş	düş	Verb	Verb
bulaşmış	bulaş	Verb	Verb
yapıyormuş	yap	Verb	Verb
susamış	susa	Verb	Verb
giymiş	giy	Verb	Verb
veriyormuş	ver	Verb	Verb
morarmış	morar	Verb	Verb
istemiş	iste	Verb	Verb
gitmiş	git	Verb	Verb
tasarlamış	tasarla	Verb	Verb
bulunmuş	bulun	Verb	Verb
aydınlanmış	aydınlan	Verb	Verb
oynamış	oyna	Verb	Verb
sapmış	sap	Verb	Verb
uğramış	uğra	Verb	Verb
tanımlamış	tanımla	Verb	Verb
kullanmış	kullan	Verb	Verb
birikmiş	birik	Verb	Verb
batmış	bat	Verb	Verb
içmişler	iç	Verb	Verb
arıyormuş	ara	Verb	Verb
sararmış	sar	Verb	Verb
geliyormuş	gel	Verb	Verb
kaldırmış	kaldır	Verb	Verb
almamış	al	Verb	Verb
yasaklamış	yasakla	Verb	Verb
dövüyormuş	döv	Verb	Verb
dayamış	daya	Verb	Verb
solmuş	sol	Verb	Verb
artmış	art	Verb	Verb
vazgeçmiş	vazgeç	Verb	Verb
ölmüş	öl	Verb	Verb
kaçıyormuş	kaç	Verb	Verb
uyuşmuş	uyuş	Verb	Verb
asacakmış	as	Verb	Verb
büyütmüş	büyüt	Verb	Verb
varmışız	var	Verb	Verb
gelmemişse	gel	Verb	Verb
kaykılmış	kaykıl	Verb	Verb
olmuşsunuz	ol	Verb	Verb
çalacakmış	çal	Verb	Verb
ilgileniyormuş	ilgilen	Verb	Verb
yazarmış	yaz	Verb	Verb
harcamış	harca	Verb	Verb
davranmışım	davran	Verb	Verb
götürüyormuşum	götür	Verb	Verb
erimiş	eri	Verb	Verb
çökmüş	çök	Verb	Verb
okumuş	oku	Verb	Verb
işitmiş	işit	Verb	Verb
düşecekmiş	düş	Verb	Verb
götürmüş	götür	Verb	Verb
anlıyormuş	anla	Verb	Verb
olmuşsun	ol	Verb	Verb
afallamış	afalla	Verb	Verb
atmış	at	Verb	Verb
sönmüş	sön	Verb	Verb
kalıyormuş	kal	Verb	Verb
uyumuş	uyu	Verb	Verb
olsaymış	ol	Verb	Verb
kaçarmış	kaç	Verb	Verb
yazmış	yaz	Verb	Verb
dönmüşler	dön	Verb	Verb
gevşemiş	gevşe	Verb	Verb
yetermiş	yet	Verb	Verb
utanıyormuş	utan	Verb	Verb
çıldırmış	çıldır	Verb	Verb
tanımamış	tanı	Verb	Verb
değişmişsin	değiş	Verb	Verb
kalkmışlar	kalk	Verb	Verb
girmemiş	gir	Verb	Verb
değmemiş	değ	Verb	Verb
sıkışmış	sıkış	Verb	Verb
anlamamış	anla	Verb	Verb
kırışmış	kırış	Verb	Verb
ilgilenmiş	ilgilen	Verb	Verb
ödemiş	öde	Verb	Verb
içmiş	iç	Verb	Verb
boşalmış	boşal	Verb	Verb
ödüyormuş	öde	Verb	Verb
mahvolmuş	mahvol	Verb	Verb
anlamışsınız	anla	Verb	Verb
yatmamış	yat	Verb	Verb
yalvarıyormuş	yalvar	Verb	Verb
çalışıyormuş	çalış	Verb	Verb
istiyormuş	iste	Verb	Verb
çekmemiş	çek	Verb	Verb
çarpmış	çarp	Verb	Verb
demiş	de	Verb	Verb
asmış	as	Verb	Verb
dönüşmüş	dönüş	Verb	Verb
uğraşıyormuşum	uğraş	Verb	Verb
çalmamış	çal	Verb	Verb
beklemiş	bekle	Verb	Verb
edinmiş	edin	Verb	Verb
söylemiş	söyle	Verb	Verb
okumamış	oku	Verb	Verb
durmuş	dur	Verb	Verb
oluyormuş	ol	Verb	Verb
tutunmuş	tutun	Verb	Verb
sezmiş	sez	Verb	Verb
gömmüş	göm	Verb	Verb
sürüyormuş	sür	Verb	Verb
sıçramış	sıçra	Verb	Verb
çürümüş	çürü	Verb	Verb
donmuş	don	Verb	Verb
dilemiş	dile	Verb	Verb
istememiş	iste	Verb	Verb
sürüklemiş	sürükle	Verb	Verb
bağlamış	bağla	Verb	Verb
saklamış	sakla	Verb	Verb
üstlenmiş	üstlen	Verb	Verb
bulmuş	bul	Verb	Verb
çekmiş	çek	Verb	Verb
uyumamış	uyu	Verb	Verb
göndermişse	gönder	Verb	Verb
çözmüş	çöz	Verb	Verb
tanımamışım	tanı	Verb	Verb
etkilemiş	etkile	Verb	Verb
sivrilmiş	sivril	Verb	Verb
incelmiş	incel	Verb	Verb
arınmış	arın	Verb	Verb
benimsemiş	benimse	Verb	Verb
dinlemiş	dinle	Verb	Verb
dirilmiş	diril	Verb	Verb
örtmüş	ört	Verb	Verb
boşvermiş	boşver	Verb	Verb
aşmış	aş	Verb	Verb
terlemiş	terle	Verb	Verb
göndermişler	gönder	Verb	Verb
erişmiş	eriş	Verb	Verb
bitmemiş	bit	Verb	Verb
yanmış	yan	Verb	Verb
sevmiş	sev	Verb	Verb
fısıldamış	fısılda	Verb	Verb
göçmüş	göç	Verb	Verb
arıtmış	arıt	Verb	Verb
açmış	aç	Verb	Verb
seçmiş	seç	Verb	Verb
dışlamış	dışla	Verb	Verb
oluşmuş	oluş	Verb	Verb
devralmış	devral	Verb	Verb
göndermiş	gönder	Verb	Verb
sağlamış	sağla	Verb	Verb
eklemiş	ekle	Verb	Verb
olmamışsa	ol	Verb	Verb
sağlamışsa	sağla	Verb	Verb
seçmişseniz	seç	Verb	Verb
dolmuşsa	dol	Verb	Verb
dolmamışsa	dol	Verb	Verb
sıfırlamış	sıfırla	Verb	Verb
oturuyormuş	otur	Verb	Verb
belirlemiş	belirle	Verb	Verb
adamışlar	ada	Verb	Verb
zorlamış	zorla	Verb	Verb
sarmalamış	sarmala	Verb	Verb
demirlemiş	demirle	Verb	Verb
arıyorlarmış	ara	Verb	Verb
çalmışsın	çal	Verb	Verb
soyutlamış	soyutla	Verb	Verb
görmemişim	gör	Verb	Verb
gitmişler	git	Verb	Verb
konuşmuşlar	konuş	Verb	Verb
söylüyormuş	söyle	Verb	Verb
çizmişler	çiz	Verb	Verb
gömmüşler	göm	Verb	Verb
koymuş	koy	Verb	Verb
sığınmış	sığın	Verb	Verb
gezmiş	gez	Verb	Verb
erecekmiş	er	Verb	Verb
vermişim	ver	Verb	Verb
düşmüşler	düş	Verb	Verb
imzalamış	imzala	Verb	Verb
unutmalıymışız	unut	Verb	Verb
atarmış	at	Verb	Verb
hazırlamış	hazırla	Verb	Verb
kurtulmuş	kurtul	Verb	Verb
inanmamış	inan	Verb	Verb
kalacakmış	kal	Verb	Verb
kurmuş	kur	Verb	Verb
uymamış	uy	Verb	Verb
almışlar	al	Verb	Verb
bekleyecekmişiz	bekle	Verb	Verb
çalışmış	çalış	Verb	Verb
yollamışsınız	yolla	Verb	Verb
sağlarmış	sağla	Verb	Verb
açıyorlarmış	aç	Verb	Verb
sulanıyormuş	sulan	Verb	Verb
çevirmiş	çevir	Verb	Verb
kullanmışlar	kullan	Verb	Verb
çıkmamış	çık	Verb	Verb
gitmeyecek	git	Verb	Verb
tartışmayacağım	tartış	Verb	Verb
seveceğim	sev	Verb	Verb
bulacak	bul	Verb	Verb
düşüneceğim	düşün	Verb	Verb
göreceğiz	gör	Verb	Verb
geçecek	geç	Verb	Verb
olacaksa	ol	Verb	Verb
edeceğim	et	Verb	Verb
affetmeyeceğim	affet	Verb	Verb
göreceksiniz	gör	Verb	Verb
söyleyecekler	söyle	Verb	Verb
olacağım	ol	Verb	Verb
bulacağım	bul	Verb	Verb
düşüneceksin	düşün	Verb	Verb
seveceksin	sev	Verb	Verb
olacaksın	ol	Verb	Verb
olmayacak	ol	Verb	Verb
geleceksin	gel	Verb	Verb
unutacaksınız	unut	Verb	Verb
kalkacak	kalk	Verb	Verb
vereceğim	ver	Verb	Verb
adayacağım	ada	Verb	Verb
izleyeceğim	izle	Verb	Verb
girecek	gir	Verb	Verb
etmeyeceğiz	et	Verb	Verb
çıkmayacağım	çık	Verb	Verb
verecekler	ver	Verb	Verb
duyacaksınız	duy	Verb	Verb
gideceğim	git	Verb	Verb
kopacak	kop	Verb	Verb
bulacaksınız	bul	Verb	Verb
başlayacağım	başla	Verb	Verb
eriyecek	eri	Verb	Verb
bahsedecek	bahset	Verb	Verb
ayıracaksınız	ayır	Verb	Verb
koruyacaksınız	koru	Verb	Verb
parlayacak	parla	Verb	Verb
sereceğim	ser	Verb	Verb
tekrarlayacağım	tekrarla	Verb	Verb
bırakmayacağım	bırak	Verb	Verb
bulunacağım	bulun	Verb	Verb
anlayacaklar	anla	Verb	Verb
bakacağım	bak	Verb	Verb
diyeceğim	de	Verb	Verb
yayacağım	yay	Verb	Verb
inceleyecek	incele	Verb	Verb
vereceksiniz	ver	Verb	Verb
konacak	kon	Verb	Verb
bahsedeceğim	bahset	Verb	Verb
söyleyeceğim	söyle	Verb	Verb
yapacağım	yap	Verb	Verb
olacaksınız	ol	Verb	Verb
koyacak	koy	Verb	Verb
çalışacağım	çalış	Verb	Verb
söyleyeceksiniz	söyle	Verb	Verb
koyacağız	koy	Verb	Verb
soracağım	sor	Verb	Verb
kaçacağım	kaç	Verb	Verb
kalkacaksınız	kalk	Verb	Verb
dinleyecek	dinle	Verb	Verb
kıvıracağım	kıvır	Verb	Verb
kıvıracak	kıvır	Verb	Verb
öğrenecek	öğren	Verb	Verb
yaklaşacak	yaklaş	Verb	Verb
görecek	gör	Verb	Verb
vermeyeceğim	ver	Verb	Verb
kalacağım	kal	Verb	Verb
çıkacaklar	çık	Verb	Verb
onaracağım	onar	Verb	Verb
döneceğiz	dön	Verb	Verb
gidecek	git	Verb	Verb
bulunacak	bulun	Verb	Verb
bilmeyecek	bil	Verb	Verb
kaybedeceksiniz	kaybet	Verb	Verb
güleceksiniz	gül	Verb	Verb
tanıyacak	tanı	Verb	Verb
düşleyeceğim	düşle	Verb	Verb
bulunmayacağım	bulun	Verb	Verb
uyacaksınız	uy	Verb	Verb
soracak	sor	Verb	Verb
oturacak	otur	Verb	Verb
yakacak	yak	Verb	Verb
satacak	sat	Verb	Verb
bulacağız	bul	Verb	Verb
gerekecek	gerek	Verb	Verb
değecek	değ	Verb	Verb
süreceksin	sür	Verb	Verb
vereceksin	ver	Verb	Verb
büyüyecek	büyü	Verb	Verb
açacak	aç	Verb	Verb
kurtaracak	kurtar	Verb	Verb
kalacağız	kal	Verb	Verb
yürüyeceğiz	yürü	Verb	Verb
yürüyecek	yürü	Verb	Verb
tanıyacağız	tanı	Verb	Verb
yapacağız	yap	Verb	Verb
toplayacak	topla	Verb	Verb
öğreneceksiniz	öğren	Verb	Verb
öğretecekler	öğret	Verb	Verb
alacağım	al	Verb	Verb
oturacağım	otur	Verb	Verb
ezeceğim	ez	Verb	Verb
akacak	ak	Verb	Verb
konuşacak	konuş	Verb	Verb
kaplayacak	kapla	Verb	Verb
söyleyeceksin	söyle	Verb	Verb
ağlamayacağım	ağla	Verb	Verb
görünmeyecek	görün	Verb	Verb
bakacaklar	bak	Verb	Verb
zannedecekler	zannet	Verb	Verb
duracak	dur	Verb	Verb
duracaksın	dur	Verb	Verb
hissedeceğim	hisset	Verb	Verb
yapacaklar	yap	Verb	Verb
başlayacağız	başla	Verb	Verb
vuracaksın	vur	Verb	Verb
dövecekler	döv	Verb	Verb
özetleyeceğim	özetle	Verb	Verb
istemeyeceksin	iste	Verb	Verb
tutacağım	tut	Verb	Verb
içeceğim	iç	Verb	Verb
besleyeceksin	besle	Verb	Verb
açıklayacak	açıkla	Verb	Verb
yatacağım	yat	Verb	Verb
mahvolacaksın	mahvol	Verb	Verb
belirleyecek	belirle	Verb	Verb
getireceksin	getir	Verb	Verb
yiyecekler	ye	Verb	Verb
boylayacağım	boyla	Verb	Verb
kalacaksınız	kal	Verb	Verb
çıldıracak	çıldır	Verb	Verb
olmayacaksanız	ol	Verb	Verb
anlayacak	anla	Verb	Verb
çekecek	çek	Verb	Verb
tembihleyeceğim	tembihle	Verb	Verb
söylemeyeceğim	söyle	Verb	Verb
dinleyeceksiniz	dinle	Verb	Verb
ödeyeceğim	öde	Verb	Verb
vuracak	vur	Verb	Verb
bırakacak	bırak	Verb	Verb
tutuşacaksınız	tutuş	Verb	Verb
yükselecek	yüksel	Verb	Verb
dönecek	dön	Verb	Verb
güleceğiz	gül	Verb	Verb
tüketecek	tüket	Verb	Verb
edeceğiz	et	Verb	Verb
kirletmeyecek	kirlet	Verb	Verb
kovmayacağım	kov	Verb	Verb
unutacağım	unut	Verb	Verb
kullanmayacaksa	kullan	Verb	Verb
gelmeyecek	gel	Verb	Verb
kullanacak	kullan	Verb	Verb
binecekler	bin	Verb	Verb
binmeyecek	bin	Verb	Verb
öğrenecekler	öğren	Verb	Verb
tutacağız	tut	Verb	Verb
konuşmayacağım	konuş	Verb	Verb
bilecekler	bil	Verb	Verb
dönmeyeceğim	dön	Verb	Verb
yaşayacaksınız	yaşa	Verb	Verb
girmeyeceğim	gir	Verb	Verb
bakacaksın	bak	Verb	Verb
kakmayacaksın	kak	Verb	Verb
kakacağım	kak	Verb	Verb
vermeyecek	ver	Verb	Verb
takacak	tak	Verb	Verb
alacaksın	al	Verb	Verb
yürüyeceğim	yürü	Verb	Verb
ağlayacak	ağla	Verb	Verb
öleceğim	öl	Verb	Verb
yarayacak	yara	Verb	Verb
istemeyeceğim	iste	Verb	Verb
içmeyecek	iç	Verb	Verb
anlatmayacağım	anlat	Verb	Verb
ölecek	öl	Verb	Verb
hastalanacak	hastalan	Verb	Verb
edeceksiniz	et	Verb	Verb
konuşacağım	konuş	Verb	Verb
evleneceksiniz	evlen	Verb	Verb
evleneceğim	evlen	Verb	Verb
yazacak	yaz	Verb	Verb
yetecek	yet	Verb	Verb
çözümleyeceğim	çözümle	Verb	Verb
yetişmeyecek	yetiş	Verb	Verb
çıkacağım	çık	Verb	Verb
koyacağım	koy	Verb	Verb
basacak	bas	Verb	Verb
ayıracak	ayır	Verb	Verb
koşacak	koş	Verb	Verb
getirecek	getir	Verb	Verb
saklayacağım	sakla	Verb	Verb
kanacak	kan	Verb	Verb
olacağız	ol	Verb	Verb
gelmeyeceksin	gel	Verb	Verb
aktaracağım	aktar	Verb	Verb
oturmayacağım	otur	Verb	Verb
içecekler	iç	Verb	Verb
göndereceğim	gönder	Verb	Verb
vazgeçecek	vazgeç	Verb	Verb
göreceğim	gör	Verb	Verb
sürükleyecek	sürükle	Verb	Verb
olmayacağım	ol	Verb	Verb
çarpacak	çarp	Verb	Verb
görünecek	görün	Verb	Verb
yapacaksanız	yap	Verb	Verb
görüntüleyecek	görüntüle	Verb	Verb
sağlayacak	sağla	Verb	Verb
silecek	sil	Verb	Verb
paylaşacaksanız	paylaş	Verb	Verb
açacaksa	aç	Verb	Verb
uyacak	uy	Verb	Verb
sığacak	sığ	Verb	Verb
kuracak	kur	Verb	Verb
kullanmayacaksanız	kullan	Verb	Verb
seçeceğim	seç	Verb	Verb
kullanmayacak	kullan	Verb	Verb
kesecek	kes	Verb	Verb
kullanacaksınız	kullan	Verb	Verb
aşacak	aş	Verb	Verb
yükleyecek	yükle	Verb	Verb
soğuyacak	soğu	Verb	Verb
okuyacaksınız	oku	Verb	Verb
kopmayacağım	kop	Verb	Verb
kalacaksın	kal	Verb	Verb
çalışacaksın	çalış	Verb	Verb
patlayacak	patla	Verb	Verb
esecek	es	Verb	Verb
karışacak	karış	Verb	Verb
yakalayacak	yakala	Verb	Verb
aşacağız	aş	Verb	Verb
açıklayacağım	açıkla	Verb	Verb
paylayacağız	payla	Verb	Verb
kurtaracaklar	kurtar	Verb	Verb
isteyeceksiniz	iste	Verb	Verb
açacağız	aç	Verb	Verb
yiyeceğim	ye	Verb	Verb
döneceğim	dön	Verb	Verb
önereceğim	öner	Verb	Verb
alacaksanız	al	Verb	Verb
gideceğiz	git	Verb	Verb
farkedeceksiniz	farket	Verb	Verb
kaybetmeyecek	kaybet	Verb	Verb
getireceğiz	getir	Verb	Verb
geçeceğiz	geç	Verb	Verb
olacaklar	ol	Verb	Verb
kullanacaklar	kullan	Verb	Verb
kazanacak	kazan	Verb	Verb
kavuşacak	kavuş	Verb	Verb
geleceğiz	gel	Verb	Verb
ulaşacak	ulaş	Verb	Verb
geçecekler	geç	Verb	Verb
ulaşacaklar	ulaş	Verb	Verb
duracağım	dur	Verb	Verb
okumayacağım	oku	Verb	Verb
edinecek	edin	Verb	Verb
götürecek	götür	Verb	Verb
tanışacaksınız	tanış	Verb	Verb
çizecek	çiz	Verb	Verb
kurtulacaklar	kurtul	Verb	Verb
getireceğim	getir	Verb	Verb
uyaracağım	uyar	Verb	Verb
hissedeceğiz	hisset	Verb	Verb
yapacaksın	yap	Verb	Verb
kazanacağım	kazan	Verb	Verb
bitecek	bit	Verb	Verb
belirleyeceğiz	belirle	Verb	Verb
sevinecek	sevin	Verb	Verb
pazarlayacak	pazarla	Verb	Verb
anlatacaklar	anlat	Verb	Verb
yapacaksınız	yap	Verb	Verb
gideceksin	git	Verb	Verb
alacağız	al	Verb	Verb
başlayacaksa	başla	Verb	Verb
seyredecek	seyret	Verb	Verb
atmayacak	at	Verb	Verb
bahsetmeyeceğim	bahset	Verb	Verb
dönecekler	dön	Verb	Verb
başaracağız	başar	Verb	Verb
kopmayacak	kop	Verb	Verb
karşılaşacak	karşılaş	Verb	Verb
düzelecek	düzel	Verb	Verb
esirgemeyeceğim	esirge	Verb	Verb
çalışacağız	çalış	Verb	Verb
diyecekler	de	Verb	Verb
gezineceksiniz	gezin	Verb	Verb
çalışacaksa	çalış	Verb	Verb
düşüneceksiniz	düşün	Verb	Verb
alkışlayacak	alkışla	Verb	Verb
ağrıyacak	ağrı	Verb	Verb
hissedecek	hisset	Verb	Verb
başlayacaksınız	başla	Verb	Verb
deneyecek	dene	Verb	Verb
çevirecekler	çevir	Verb	Verb
bırakacaksınız	bırak	Verb	Verb
uğraşacaklar	uğraş	Verb	Verb
inceleyeceğiz	incele	Verb	Verb
arayacağız	ara	Verb	Verb
alacaksak	al	Verb	Verb
çelişecek	çeliş	Verb	Verb
vermezsin	ver	Verb	Verb
sanırım	san	Verb	Verb
olur	ol	Verb	Verb
verirse	ver	Verb	Verb
ederim	et	Verb	Verb
bulunur	bulun	Verb	Verb
gelir	gel	Verb	Verb
istemem	iste	Verb	Verb
unutmazsa	unut	Verb	Verb
onaylamam	onayla	Verb	Verb
olursa	ol	Verb	Verb
bilirsin	bil	Verb	Verb
getirir	getir	Verb	Verb
eklerler	ekle	Verb	Verb
kalırlar	kal	Verb	Verb
olurlar	ol	Verb	Verb
zannederiz	zannet	Verb	Verb
överiz	öv	Verb	Verb
buluruz	bul	Verb	Verb
çürür	çürü	Verb	Verb
taşır	taşı	Verb	Verb
unuturuz	unut	Verb	Verb
benzemez	benze	Verb	Verb
etmez	et	Verb	Verb
eder	et	Verb	Verb
korkarım	kork	Verb	Verb
zorlar	zorla	Verb	Verb
yaşarsa	yaşa	Verb	Verb
ödemez	öde	Verb	Verb
duymaz	duy	Verb	Verb
bilmez	bil	Verb	Verb
davranırlar	davran	Verb	Verb
ederler	ederle	Verb	Verb
verirler	ver	Verb	Verb
bilmem	bil	Verb	Verb
alır	al	Verb	Verb
bırakır	bırak	Verb	Verb
bayılırım	bayıl	Verb	Verb
değişirler	değiş	Verb	Verb
izlerler	izle	Verb	Verb
yapar	yap	Verb	Verb
hisseder	hisset	Verb	Verb
dilemem	dile	Verb	Verb
yaraşır	yaraş	Verb	Verb
geliriz	gel	Verb	Verb
tanırlar	tanı	Verb	Verb
dayanır	dayan	Verb	Verb
bilir	bil	Verb	Verb
kalır	kal	Verb	Verb
gerekirse	gerek	Verb	Verb
umursamaz	umursa	Verb	Verb
biter	bit	Verb	Verb
bitmez	bit	Verb	Verb
kalkar	kalk	Verb	Verb
evlenirsek	evlen	Verb	Verb
tutarsak	tut	Verb	Verb
gelmez	gel	Verb	Verb
düşünmem	düşün	Verb	Verb
sanmam	san	Verb	Verb
giderseniz	git	Verb	Verb
anlarsınız	anla	Verb	Verb
başlar	başla	Verb	Verb
susmaz	sus	Verb	Verb
bırakmazlar	bırak	Verb	Verb
bulunmaz	bulun	Verb	Verb
bakar	bak	Verb	Verb
dersiniz	de	Verb	Verb
verir	ver	Verb	Verb
ölürüm	öl	Verb	Verb
sever	sev	Verb	Verb
severim	sev	Verb	Verb
koşarım	koş	Verb	Verb
gelirim	gel	Verb	Verb
ihtiyarlar	ihtiyarla	Verb	Verb
bırakmam	bırak	Verb	Verb
alırlar	al	Verb	Verb
yeter	yet	Verb	Verb
yatırırım	yatır	Verb	Verb
inanır	inan	Verb	Verb
reddetmezsiniz	reddet	Verb	Verb
olmazsa	ol	Verb	Verb
edersiniz	et	Verb	Verb
öğrenirim	öğren	Verb	Verb
olursanız	ol	Verb	Verb
dinlerseniz	dinle	Verb	Verb
bilirim	bil	Verb	Verb
konuşur	konuş	Verb	Verb
güler	gül	Verb	Verb
küçümser	küçümse	Verb	Verb
evlenirse	evlen	Verb	Verb
hesaplar	hesapla	Verb	Verb
düşünmez	düşün	Verb	Verb
ederiz	et	Verb	Verb
yaparız	yap	Verb	Verb
sorarsanız	sor	Verb	Verb
çıkarım	çık	Verb	Verb
olursun	ol	Verb	Verb
çıkar	çık	Verb	Verb
gerekir	gerek	Verb	Verb
sayar	say	Verb	Verb
ölmezse	öl	Verb	Verb
ederseniz	et	Verb	Verb
yayarlarsa	yay	Verb	Verb
mahvolur	mahvol	Verb	Verb
vazgeçer	vazgeç	Verb	Verb
yapışır	yapış	Verb	Verb
getiririm	getir	Verb	Verb
gideriz	git	Verb	Verb
atar	at	Verb	Verb
atmaz	at	Verb	Verb
duyar	duy	Verb	Verb
gelirse	gel	Verb	Verb
işitiriz	işit	Verb	Verb
yakışır	yakış	Verb	Verb
alışır	alış	Verb	Verb
dönerse	dön	Verb	Verb
başlarsa	başla	Verb	Verb
çıkmaz	çık	Verb	Verb
görmez	gör	Verb	Verb
uğraşırsa	uğraş	Verb	Verb
ederse	et	Verb	Verb
eğmez	eğ	Verb	Verb
yemez	ye	Verb	Verb
dilerim	dil	Verb	Verb
tanımaz	tanı	Verb	Verb
tanırım	tanı	Verb	Verb
olurum	ol	Verb	Verb
görmezsek	gör	Verb	Verb
konuşurum	konuş	Verb	Verb
böbürlenir	böbürlen	Verb	Verb
der	de	Verb	Verb
sorar	sor	Verb	Verb
durursunuz	dur	Verb	Verb
bakarsınız	bak	Verb	Verb
istemez	iste	Verb	Verb
anlar	anla	Verb	Verb
girer	gir	Verb	Verb
olursunuz	ol	Verb	Verb
yeltenmez	yelten	Verb	Verb
yaparsam	yap	Verb	Verb
gider	git	Verb	Verb
hoşlanırım	hoşlan	Verb	Verb
verirseniz	ver	Verb	Verb
beklersiniz	bekle	Verb	Verb
dururum	dur	Verb	Verb
şaşar	şaş	Verb	Verb
kalırsınız	kal	Verb	Verb
benzer	benze	Verb	Verb
dilerse	dil	Verb	Verb
bakarsanız	bak	Verb	Verb
yakar	yak	Verb	Verb
duymam	duy	Verb	Verb
çıkarsa	çık	Verb	Verb
bilmezsiniz	bil	Verb	Verb
gelmem	gel	Verb	Verb
gelirseniz	gel	Verb	Verb
darılmam	darıl	Verb	Verb
geçmez	geç	Verb	Verb
isterim	iste	Verb	Verb
derseniz	de	Verb	Verb
isterseniz	iste	Verb	Verb
benimserim	benimse	Verb	Verb
yakalarlar	yakala	Verb	Verb
yaramaz	yara	Verb	Verb
görür	gör	Verb	Verb
görürsem	gör	Verb	Verb
sokarım	sok	Verb	Verb
sürer	sür	Verb	Verb
istersen	iste	Verb	Verb
edersin	et	Verb	Verb
anlamaz	anla	Verb	Verb
isterse	iste	Verb	Verb
tanımazsın	tanı	Verb	Verb
çıkarız	çık	Verb	Verb
çıkarsak	çık	Verb	Verb
yükleriz	yükle	Verb	Verb
inmem	in	Verb	Verb
bırakırım	bırak	Verb	Verb
vurur	vur	Verb	Verb
dururlar	dur	Verb	Verb
bayılır	bayıl	Verb	Verb
başlarız	başla	Verb	Verb
başlarsın	başla	Verb	Verb
kullanırsın	kullan	Verb	Verb
alırsa	al	Verb	Verb
alırım	al	Verb	Verb
zannetmem	zannet	Verb	Verb
bırakırsak	bırak	Verb	Verb
yaşarız	yaşa	Verb	Verb
bilmezsek	bil	Verb	Verb
saklarız	sakla	Verb	Verb
yakışmaz	yakış	Verb	Verb
bulur	bul	Verb	Verb
çalışırsak	çalış	Verb	Verb
toplarlar	topla	Verb	Verb
durmazlar	dur	Verb	Verb
kötümsersin	kötümse	Verb	Verb
uyur	uyu	Verb	Verb
iliklerim	ilikle	Verb	Verb
gösteririm	göster	Verb	Verb
yaparım	yap	Verb	Verb
oturmam	otur	Verb	Verb
hatırlar	hatırla	Verb	Verb
bilirsiniz	bil	Verb	Verb
görünmez	görün	Verb	Verb
girerim	gir	Verb	Verb
düşer	düş	Verb	Verb
ölür	öl	Verb	Verb
yatırırlar	yatır	Verb	Verb
bağlamaz	bağla	Verb	Verb
kaynaşmaz	kaynaş	Verb	Verb
sarkar	sark	Verb	Verb
görmem	gör	Verb	Verb
tırmanmam	tırman	Verb	Verb
gösterir	göster	Verb	Verb
düşünür	düşün	Verb	Verb
ellerim	elle	Verb	Verb
kaldırır	kaldır	Verb	Verb
giderler	git	Verb	Verb
sığmaz	sığ	Verb	Verb
öğrenirse	öğren	Verb	Verb
derler	de	Verb	Verb
kullanırlar	kullan	Verb	Verb
karşılaşır	karşılaş	Verb	Verb
rastlar	rastla	Verb	Verb
izler	izle	Verb	Verb
giyer	giy	Verb	Verb
sızar	sız	Verb	Verb
övünür	övün	Verb	Verb
uyanır	uyan	Verb	Verb
çarpmaz	çarp	Verb	Verb
başlarlarsa	başla	Verb	Verb
kaybolur	kaybol	Verb	Verb
korkar	kork	Verb	Verb
sezer	sez	Verb	Verb
sezmez	sez	Verb	Verb
tanımlar	tanımla	Verb	Verb
dövmez	döv	Verb	Verb
kalkarsam	kalk	Verb	Verb
bulursun	bul	Verb	Verb
ayırır	ayır	Verb	Verb
konuşurlar	konuş	Verb	Verb
yıkar	yık	Verb	Verb
çekinir	çekin	Verb	Verb
değmez	değ	Verb	Verb
döver	döv	Verb	Verb
mahvolursun	mahvol	Verb	Verb
ürker	ürk	Verb	Verb
bağlarlar	bağla	Verb	Verb
doğar	doğ	Verb	Verb
ulaşır	ulaş	Verb	Verb
düşünürsek	düşün	Verb	Verb
hissetmem	hisset	Verb	Verb
sökerim	sök	Verb	Verb
yaparsan	yap	Verb	Verb
kalkışmazsan	kalkış	Verb	Verb
olurlarsa	ol	Verb	Verb
açar	aç	Verb	Verb
temizler	temizle	Verb	Verb
böler	böl	Verb	Verb
ayırmam	ayır	Verb	Verb
söylersin	söyle	Verb	Verb
kalırsa	kal	Verb	Verb
getirmem	getir	Verb	Verb
soymam	soy	Verb	Verb
sürtmem	sürt	Verb	Verb
gidersem	git	Verb	Verb
yapmazsa	yap	Verb	Verb
artar	art	Verb	Verb
değiller	değille	Verb	Verb
dokunur	dokun	Verb	Verb
yaratır	yarat	Verb	Verb
şaşırır	şaşır	Verb	Verb
danışır	danış	Verb	Verb
koşarlar	koş	Verb	Verb
yaparsınız	yap	Verb	Verb
yaparsa	yap	Verb	Verb
yararım	yar	Verb	Verb
öder	öde	Verb	Verb
görürsün	gör	Verb	Verb
alırsınız	al	Verb	Verb
emredersiniz	emret	Verb	Verb
uğrar	uğra	Verb	Verb
çıkarsınız	çık	Verb	Verb
yersiniz	ye	Verb	Verb
götürür	götür	Verb	Verb
oturursunuz	otur	Verb	Verb
verirsin	ver	Verb	Verb
demezler	de	Verb	Verb
ölürse	öl	Verb	Verb
veririm	ver	Verb	Verb
bakarsa	bak	Verb	Verb
demez	de	Verb	Verb
yemem	ye	Verb	Verb
unutmazlar	unut	Verb	Verb
götürürler	götür	Verb	Verb
sevinirim	sevin	Verb	Verb
hoşlanmam	hoşlan	Verb	Verb
gösterirler	göster	Verb	Verb
sanırsınız	san	Verb	Verb
