	
Celalirkildi.	CelalNOM;PROPN;3;SGirkilPFV;PST;V;IND;SG;3;POS._
	
İyikikediolalıbirfaretuttun,dediMelek.	iyiADJkiCONJkediNOM;N;3;SGolPFV;PRS;V;IND;POS;V.CVBbirNUMfareNOM;N;3;SGtutPFV;2;PST;V;IND;SG;POS,_dePFV;PST;V;IND;SG;3;POSMelekNOM;PROPN;3;SG._
	
Durdu.	durPFV;PST;V;IND;SG;3;POS._
	
Tutkuyukimseninanlatamayacağıgibianlattın.	tutkuSG;N;ACC;3kimseSG;GEN;N;3anlat<unk>gibiADPanlatPST;POS;IND;SG;PFV;2;V._
	
Olacaklarıbilmiştimedasıylabaşınıusulusulsallıyordu.	olacak3;ACC;ADJ;PLbil1;PFV;V;IND;SG;PST+PRF;POSedaPSS3S;INS;SG;3;NbaşPSS3S;ACC;SG;3;NusulNOM;N;3;SGusulNOM;N;3;SGsallaINFM;PST;V;IND;PROG;SG;3;POS._
	
Onayetişebilmekiçinpeşindenkoşuyordum.	oPRO;SG;3;DATyetişV.MSDR;PFV;PRS;NOM;V;POT;POSiçinADPpeşPSS3S;AT+ABL;SG;3;NkoşINFM;1;PST;V;IND;PROG;SG;POS._
	
Koro?Tabileblebi.	koroSG;3;N;NOM?_tabiADJleblebiSG;3;N;NOM._
	
Yokcanım,aşkheriklimdebiryerbulurkendine.	yokADVcanPSS1S;NOM;3;SG;N,_aşkSG;NOM;N;3herDETiklimSG;ESS;N;3birNUMyerSG;NOM;N;3bulIND;POS;3;PRS;SG;HAB;VkendiPSS3S;PRO;3;DAT;SG;REFL._
	
Artıkrehberimdenutandığımiçinbağırıpkervanıdurdurmasınıistemiyor,hızlıplanjonlarla,kızağayenidentırmanıyordum.	artıkADVrehberPSS1S;AT+ABL;SG;3;NutanPSS1S;PFV;PST;NOM;V;IND;V.PTCP;POSiçinADPbağırPFV;PRS;V;IND;POS;V.CVBkervan3;N;ACC;SGdur<unk>isteINFM;NEG;PRS;V;IND;PROG;SG;3,_hızlıADJplanjon3;N;INS;PL,_kızak3;N;DAT;SGyenidenADVtırmanINFM;1;PST;V;IND;PROG;SG;POS._
	
ikibinikiveöncekiyıllardataahhüdebağlananyatırımihalelerinedeniyleyapılanişlereilişkinödemelere,öngörülenharcamasınırlarıiçindekalmakkaydıyladevamedilecek.	ikibinikiNOM;SG;3;NUMveCONJönceNOM;N;3;SGkiADPyıl3;N;PL;ESStaahhüt3;N;DAT;SGbağlaPASS;PFV;PRS;V;IND;V.PTCP;POSyatırımNOM;N;3;SGihalePSS3S;NOM;PL;3;NnedenPSS3S;INS;SG;3;NyapPASS;PFV;PRS;V;IND;V.PTCP;POSiş3;N;PL;DATilişkinADPödeV.MSDR;PFV;PRS;V;IND;DAT;POS,_öngörPASS;PFV;PRS;V;IND;V.PTCP;POSharcaV.MSDR;PFV;PRS;NOM;V;IND;POSsınırPSS3S;NOM;PL;3;NiçPSS3S;ADJ;SG;3;ESSkalV.MSDR;PFV;PRS;NOM;V;IND;POSkayıtPSS3S;INS;SG;3;NdevamNOM;N;3;SGetFUT;PASS;PFV;V;IND;SG;3;POS._
	
Arasıratemizliğiaksatsadakendisinehepsizdiyenbirkızcağız.	araNOM;ADJ;3;SGsıraNOM;N;3;SGtemizlik3;N;ACC;SGaksaCOND;PFV;PRS;V;SG;3;CAUS;POSdaCONJkendiPSS3S;REFL;PRO;SG;3;DAThepADVsizPRO;2;NOM;PLdePFV;PRS;V;IND;V.PTCP;POSbirNUMkızcağızNOM;N;3;SG._
	
Hazinetarafındandışborçlanmalariçinverilebilecekgarantitutarıbeşyüzmilyondolarlasınırlandırıldı.	hazineNOM;N;3;SGtarafPSS3S;AT+ABL;SG;3;NdışADJborçlanV.MSDR;PFV;PRS;NOM;V;IND;POSiçinADPver<unk>garantiNOM;N;3;SGtutarPSS3S;NOM;SG;3;NbeşyüzNUMmilyonNOM;SG;3;NUMdolar3;N;INS;SGsınırlanPFV;PST;V;IND;SG;3;POS._
	
	
Üreticigüçleringelişimineolanetkisi,budönemdedolaylıdır.	ürePFV;PRS;V;IND;V.PTCP;CAUS;POSgüç3;ADJ;PL;GENgelişimPSS3S;SG;3;N;DATolPFV;PRS;V;IND;V.PTCP;POSetkiPSS3S;NOM;SG;3;N,_buDETdönem3;N;ESS;SGdolaylıNOM;ADJ;3;SGiPFV;PRS;V;SG;3._
	
Gitti,onunyanınagitti.	gitPST;3;POS;IND;SG;PFV;V,_o3;SG;PRO;GENyanPSS3S;DAT;3;ADJ;SGgitPST;3;POS;IND;SG;PFV;V._
	
Uzanıpmasanınüzerindeduransigarapaketindenbirsigaraalarak,parmaklarınınucundatuttu.	uzaPASS;POS;PRS;IND;V.CVB;PFV;VmasaSG;GEN;N;3üzerPSS3S;3;SG;N;ESSdurPOS;PRS;IND;PFV;V.PTCP;VsigaraSG;3;N;NOMpaketPSS3S;3;SG;N;AT+ABLbirNUMsigaraSG;3;N;NOMalPOS;PRS;IND;V.CVB;PFV;V,_parmakPSS3S;3;PL;N;GENuçPSS3S;3;SG;N;ESStutPST;3;POS;IND;SG;PFV;V._
	
Kafamınyetmediğifenderslerindedüşünürdüm:Aynıhocaağabeyimedeböyleanlatmış.	kafaPSS1S;GEN;SG;3;NyetPSS3S;NEG;PFV;PST;V;IND;V.PTCPfenNOM;N;3;SGdersPSS3S;PL;3;N;ESSdüşün1;HAB;PST;V;IND;SG;POS:_aynıADJhocaNOM;N;3;SGağabeyPSS1S;SG;3;N;DATdeCONJböyleADVanlatPFV;PST;V;NFH;IND;SG;3;POS._
	
Olur,dediJul.	olHAB;PRS;V;IND;SG;3;POS,_dePFV;PST;V;IND;SG;3;POSjulNOM;N;3;SG._
	
Ötekikadınıneredenduydunuz.	ötekiNOM;N;3;SGkadın3;ACC;ADJ;SGnere3;SG;PRO;AT+ABLduyPFV;2;PST;V;IND;PL;POS._
	
evyapmak,hayatıbiçimlendirmekdemektir.	evSG;NOM;N;3yapIND;NOM;V.MSDR;POS;PRS;PFV;V,_hayatACC;SG;N;3biçimlenCAUS;IND;NOM;V.MSDR;POS;PRS;PFV;VdeIND;NOM;V.MSDR;POS;PRS;PFV;ViV;3;PRS;PFV;SG._
	
Dahabununmezuniyeti,işsizliği,askerliği,Güneydoğukaygısıvar.	dahaADVbuPRO;SG;3;GENmezuniyetPSS3S;NOM;SG;3;N,_işsizlikPSS3S;NOM;SG;3;N,_askerlikPSS3S;NOM;SG;3;N,_güneydoğuNOM;ADJ;3;SGkaygıPSS3S;NOM;SG;3;NvarADJ._
	
Benbirsuperisiydim.	ben1;PRO;NOM;SGbirNUMsuNOM;N;3;SGperiPSS3S;NOM;SG;3;Ni1;PFV;V;PST;IND;SG._
	
Kadınlarıntanrısıyla,erkeklerintanrısıaynımıdır.	kadın3;ADJ;PL;GENtanrıPSS3S;INS;SG;3;N,_erkek3;ADJ;PL;GENtanrıPSS3S;NOM;SG;3;NaynıADJmıPFV;PRS;V;SG;3._
	
Fakatbuseferönlerindearaştırmalarınıgeliştirmeleriniönleyenyenibirengelvardı:zaman...	fakatCONJbuDETseferSG;3;N;NOMönPSS3P;3;PL;ADJ;ESSaraştır<unk>geliş<unk>önlePOS;PRS;IND;PFV;V.PTCP;VyeniADJbirNUMengelSG;3;N;NOMvarSG;3;ADJ;NOMiPST;V;3;IND;SG;PFV:_zamanSG;3;N;NOM..._
	
Onlarkrizmalarıylayaşıyorlar.	oPRO;NOM;PL;3krizmaPSS3P;INS;PL;3;NyaşaINFM;PRS;V;IND;PL;PROG;3;POS._
	
Açıkhesapçalıştığından,kendisinebalıkgetirentümbalıkçılarınondanherzamanalacağıolurdu.	açıkADJhesapSG;3;N;NOMçalışPSS3S;PST;POS;IND;PFV;V.PTCP;V;AT+ABL,_kendiPSS3S;DAT;3;REFL;SG;PRObalıkSG;3;ADJ;NOMgetirPOS;PRS;IND;PFV;V.PTCP;VtümDETbalıkçı3;GEN;N;PLo3;SG;PRO;AT+ABLherDETzamanSG;3;N;NOMal<unk>olPST;3;POS;IND;SG;V;HAB._
	
otuzbirOcakikibinbir'denbuyanaikiyuzbinYarisüretenfabrikada,dakikadabiradetYarisbanttançıkıyor.	otuzbirSG;NOM;N;3ocakSG;NOM;N;3ikibinbirden<unk>buDETyanSG;DAT;ADJ;3ikiyuzNUMbinNUMYarisSG;NOM;PROPN;3üreCAUS;IND;POS;PRS;PFV;V.PTCP;VfabrikaSG;ESS;N;3,_dakikaSG;ESS;N;3birNUMadetSG;NOM;N;3YarisSG;NOM;PROPN;3bantAT+ABL;SG;N;3çıkINFM;IND;POS;3;PRS;SG;PROG;V._
	
Ağarmeydanokudu.	AğarNOM;PROPN;3;SGmeydanNOM;N;3;SGokuPFV;PST;V;IND;SG;3;POS._
	
Yarıciddi-yarıalaycıbirmetinyazdık.	yarıADJciddiADJ-_yarıADJalaycıADJbirNUMmetinSG;NOM;ADJ;3yazIND;PST;POS;1;PFV;PL;V._
	
Aşınmışmermermerdivenitırmandım.	aşınPFV;PST;V;NFH;IND;V.PTCP;POSmermerADJmerdiven3;N;ACC;SGtırman1;PFV;PST;V;IND;SG;POS._
	
Dışarıyabakın.	dışarıSG;DAT;N;3bakPOS;PL;PRS;IMP;PFV;2;V._
	
Tutulmuşsunona.	tut<unk>oPRO;SG;3;DAT._
	
PekiNAüyeleriarasındahiçkayanolmuyormu?	pekiADVNaNOM;PROPN;3;SGüyePSS3S;NOM;PL;3;NaraPSS3S;ADJ;SG;3;ESShiçADVkayPFV;PRS;V;IND;V.PTCP;POSolINFM;NEG;PRS;V;IND;PROG;SG;3muPFV;PRS;V;IND;SG;3?_
	
Ramizgiripbaşınıeğerekkapınınönündedikildi.	RamizNOM;PROPN;3;SGgirPFV;PRS;V;IND;POS;V.CVBbaşPSS3S;ACC;SG;3;NeğPFV;PRS;V;IND;POS;V.CVBkapı3;N;SG;GENönPSS3S;ADJ;SG;3;ESSdikilPFV;PST;V;IND;SG;3;POS._
	
Kendisiniağlayarakdeğil,gülerekuğurlamamızıistedi.	kendiPSS3S;PRO;ACC;3;SG;REFLağlaIND;POS;PRS;PFV;V.CVB;VdeğilCONJ,_gülIND;POS;PRS;PFV;V.CVB;VuğurlaPSS1P;ACC;IND;V.MSDR;POS;PRS;PFV;VisteIND;PST;POS;3;PFV;SG;V._
	
Yediyılboyuncaçocukhasretiyleyanıptutuşuyorlardı.	yediNUMyılNOM;N;3;SGboyuncaADPçocukNOM;N;3;SGhasretPSS3S;INS;SG;3;NyanPFV;PRS;V;IND;POS;V.CVBtutuşINFM;PST;V;IND;PL;PROG;3;POS._
	
Belkidehiçaklındançıkmıyorbuihtimal,doğrumu.	belkiADVdeCONJhiçADVakılPSS2S;3;SG;N;AT+ABLçık3;IND;PRS;INFM;SG;NEG;PROG;VbuDETihtimalSG;3;N;NOM,_doğruADJmuV;3;IND;PRS;SG;PFV._
	
Zatenkendileriduygularınıtanımadıklarınısöylüyorlar.	zatenADVkendiPSS3P;REFL;PRO;NOM;PL;3duyguPSS3P;ACC;PL;3;NtanıPSS3P;NEG;ACC;PFV;PST;V;IND;V.PTCPsöyleINFM;PRS;V;IND;PL;PROG;3;POS._
	
Elinegeçirdiğikişiyikendikölesiyapmayıçokiyibilir;erointacirlerigibi...	elPSS3S;SG;3;N;DATgeçirPSS3S;PFV;PST;V;IND;V.PTCP;POSkişi3;N;ACC;SGkendiPSS3S;REFL;PRO;NOM;SG;3kölePSS3S;NOM;SG;3;NyapV.MSDR;ACC;PFV;PRS;V;IND;POSçokADViyiADJbilHAB;PRS;V;IND;SG;3;POS;_eroinNOM;N;3;SGtacirPSS3S;NOM;PL;3;NgibiADP..._
	
Yaşamınızboyuncabirçokkorkunuzoldu.	yaşamPSS2P;NOM;SG;3;NboyuncaADPbirçokDETkorkuPSS2P;NOM;SG;3;NolPFV;PST;V;IND;SG;3;POS._
	
İlletsözcük.	illetNOM;N;3;SGsözcükNOM;N;3;SG._
	
İmambayıldı.	imambayıldıNOM;N;3;SG._
	
BenMerkezcilikTerkEdilmeli.	benNOM;1;SG;PROmerkezcilikSG;3;N;NOMterkSG;3;N;NOMet<unk>._
	
	
Önünegelenleyatıpkalkıyormuşum.	önPSS3S;ADJ;SG;3;DATgel<unk>yatPFV;PRS;V;IND;POS;V.CVBkalk<unk>._
	
Genegittinoraya.	geneADVgitPFV;2;PST;V;IND;SG;POSora3;DAT;PRO;SG._
	
Aklımaaradığımızsekreteriçingazeteyeverdiğimizilangeldi.	akılPSS1S;SG;3;N;DATaraPSS1P;PFV;PST;V;IND;V.PTCP;POSsekreterNOM;N;3;SGiçinADPgazete3;N;DAT;SGverPSS1P;PFV;PST;V;IND;V.PTCP;POSilanNOM;N;3;SGgelPFV;PST;V;IND;SG;3;POS._
	
Reformlar.	reformNOM;N;PL;3._
	
Birkaçayboyuncabuarazidetüfekleriylenöbettutmasıgerekiyorçobanların.	birkaçDETaySG;NOM;N;3boyuncaADPbuDETaraziSG;ESS;N;3tüfekPSS3P;INS;3;PL;NnöbetSG;NOM;N;3tutPSS3S;IND;NOM;V.MSDR;POS;PFV;PRS;VgerekINFM;IND;POS;3;PRS;SG;PROG;VçobanGEN;PL;N;3._
	
	
onbirbindokuzyüzdoksansekiztarihli,Cumhuriyetgazetesinigerçeksamimiyetedavetediyoruzbaşlıklıbildirisinden:EvrendekiyüksekenerjidüzeyinesahiptümdüzenliyapılarınzamaniçindedüzensizliğedoğrugittiklerinibelirleyenTermodinamiğinİkincikanunu,evrendekivecanlılardakikompleksdüzenliyapılarınkendiliğindenoluşamayacağıgerçeğiyaratılışıdesteklemektedir.	onbirbindokuzyüzdoksansekizNUMtarihSG;NOM;N;3liADP,_cumhuriyetSG;NOM;N;3gazetePSS3S;ACC;3;SG;NgerçekADJsamimiyetSG;DAT;N;3davetSG;NOM;N;3etINFM;IND;POS;1;PROG;PRS;PL;VbaşlıkSG;NOM;N;3liADPbildiriPSS3S;AT+ABL;3;SG;N:_evrenSG;ESS;N;3kiADPyüksekADJenerjiSG;NOM;N;3düzeyPSS3S;3;DAT;SG;NsahipSG;NOM;N;3tümDETdüzenliADJyapıGEN;PL;N;3zamanSG;NOM;N;3içPSS3S;ESS;3;SG;ADJdüzensizlikSG;DAT;N;3doğruADPgitPSS3P;ACC;IND;PST;POS;PFV;V.PTCP;VbelirleIND;POS;PRS;PFV;V.PTCP;VtermodinamikGEN;SG;N;3ikiNUM;NOM;3;SGkanunPSS3S;NOM;3;SG;N,_evrenSG;ESS;N;3kiADPveCONJcanlıPL;ESS;ADJ;3kiADPkompleksADJdüzenliADJyapıGEN;PL;N;3kendiliğindenADVoluş<unk>gerçekPSS3S;NOM;3;SG;ADJyarat<unk>destekle<unk>._
	
Cinayethaberleriyle,parçalanmışsevişmelerle,terkedilmeninacısınıunutmayaçalışıyordum;hayatımdahiçbirteselliyoktu;kitaplarımbaşarısızolmuş,aşkmaceramtambiracıylasonaermişti.	cinayetSG;NOM;N;3haberPSS3S;INS;3;PL;N,_parçalaNFH;IND;PST;POS;PASS;PFV;V.PTCP;VsevişIND;INS;V.MSDR;POS;PRS;PFV;V,_terkSG;NOM;N;3etGEN;IND;V.MSDR;POS;PASS;PRS;PFV;VacıPSS3S;ACC;3;SG;ADJunutIND;V.MSDR;POS;DAT;PRS;PFV;VçalışINFM;IND;PST;POS;1;SG;PROG;V;_hayatPSS1S;ESS;3;SG;NhiçbirDETteselliSG;NOM;N;3yokADViV;IND;PST;3;PFV;SG;_kitapPSS1S;NOM;3;PL;NbaşarısızADJolNFH;IND;PST;POS;3;PFV;SG;V,_aşkSG;NOM;N;3maceraPSS1S;NOM;3;SG;NtamADVbirNUMacıSG;INS;ADJ;3sonSG;DAT;ADJ;3erIND;POS;3;PFV;SG;PST+PRF;V._
	
Oturmaodasındacamkaseyekurulur.	oturV.MSDR;PFV;PRS;NOM;V;IND;POSodaPSS3S;SG;3;N;ESScamADJkase3;N;DAT;SGkurPASS;HAB;PRS;V;IND;SG;3;POS._
	
Sonradabirküçükbargördüm,bakalımsenbeğenecekmisin?	sonraADVdaCONJbirNUMküçükADJbarSG;NOM;N;3görIND;PST;POS;1;PFV;SG;V,_bakPOS;1;PRS;PFV;OPT;PL;VsenPRO;2;NOM;SGbeğenIND;POS;3;FUT;PFV;SG;VmiV;2;IND;PRS;PFV;SG?_
	
Zeynep:Yeminederimkikimseyebirşeysöylemeyeceğim.	ZeynepNOM;PROPN;3;SG:_yeminNOM;N;3;SGet1;HAB;PRS;V;IND;SG;POSkiCONJkimse3;N;DAT;SGbirNUMşeyNOM;N;3;SGsöyle<unk>._
	
DedikyaLordlarKamarası(UpperHouse).	dePST;1;POS;IND;PL;PFV;VyaCONJLordlarSG;3;PROPN;NOMkamaraPSS3S;3;NOM;SG;N(_UpperSG;3;PROPN;NOMHouseSG;3;PROPN;NOM)_._
	
Baharıngelmesiyleeriyenkarsuları,mağaralaragirerekayılarınerkenuyanmasınanedenoluyor,sinirli,uykusuzveaçayılar,dahahırçınvesaldırganlaşıyorlardıbudönemde.	baharSG;GEN;N;3gelPSS3S;V.MSDR;POS;IND;PRS;PFV;INS;VeriPOS;PRS;IND;PFV;V.PTCP;VkarSG;3;N;NOMsuPSS3S;3;NOM;PL;N,_mağaraPL;DAT;N;3girPOS;PRS;IND;V.CVB;PFV;Vayı3;GEN;N;PLerkenADVuyanPSS3S;V.MSDR;DAT;POS;IND;PRS;PFV;VnedenSG;3;N;NOMol3;POS;IND;PRS;INFM;SG;PROG;V,_sinirliADJ,_uykusuzADVveCONJaçADJayı3;PL;N;NOM,_dahaADVhırçınADJveCONJsaldırganlaşPST;3;POS;PL;IND;INFM;PROG;VbuDETdönemSG;ESS;N;3._
	
Oysa,bazılarıpatlıcankulaklı!	oysaCONJ,_bazıPSS3P;3;NOM;PL;PROpatlıcanSG;3;N;NOMkulaklıADJ!_
	
İçmeye,eğlenmeye,kurtlarınıdökmeyegelmişturistlerinçokgeçmedensıkılacaklarınıbilirdi;balıkçılarında,bıraksasabahakadaroynayacaklarını...	içDAT;POS;IND;PRS;PFV;V;V.MSDR,_eğlenDAT;POS;IND;PRS;PFV;V;V.MSDR,_kurtPSS3P;3;PL;N;ACCdökDAT;POS;IND;PRS;PFV;V;V.MSDRgelPST;3;POS;IND;SG;PFV;V;NFHturist3;GEN;N;PLçokADVgeçPRS;IND;V.CVB;NEG;PFV;VsıkılPSS3P;POS;FUT;IND;PFV;ACC;V.PTCP;VbilPST;3;POS;IND;SG;V;HAB;_balıkçı3;GEN;N;PLdaCONJ,_bırak3;POS;COND;PRS;SG;PFV;VsabahSG;DAT;N;3kadarADPoynaPSS3P;POS;FUT;IND;PFV;ACC;V.PTCP;V..._
	
Herşeybitmişti,anlamıştım.	herDETşeyNOM;N;3;SGbitPFV;V;IND;SG;3;PST+PRF;POS,_anla1;PFV;V;IND;SG;PST+PRF;POS._
	
Yapacak.	yapPOS;FUT;IND;PFV;V.PTCP;V._
	
CumhurbaşkanıAhmetNecdetSezer,AkgüneyGenelBaşkanıRecepTayyipErdoğan'ınTCK'nınüçyüzoniki.maddesindenaldığıcezayailişkinhakkısıtlamalarınıtamamenortadankaldıranbasınyoluylaişlenensuçlarınertelenmesineilişkinyasayıvetoetti.	cumhurbaşkanıPSS3S;NOM;SG;3;NAhmetNOM;PROPN;3;SGNecdetNOM;PROPN;3;SGSezerNOM;PROPN;3;SG,_AkgüneyNOM;PROPN;3;SGgenelADJbaşkanPSS3S;NOM;SG;3;NRecepNOM;PROPN;3;SGTayyipNOM;PROPN;3;SGErdoğan3;PROPN;SG;GENTCKSG;3;N;GENüçyüzonikiNUM._maddePSS3S;AT+ABL;SG;3;NalPSS3S;PFV;PST;V;IND;V.PTCP;POSceza3;N;DAT;SGilişkinADPhakNOM;N;3;SGkısıtlaPSS3S;V.MSDR;ACC;PFV;PRS;V;IND;POStamamenADVorta3;ADJ;SG;AT+ABLkalPFV;PRS;V;IND;V.PTCP;CAUS;POSbasınNOM;N;3;SGyolPSS3S;INS;SG;3;NişlePASS;PFV;PRS;V;IND;V.PTCP;POSsuç3;N;PL;GENertelePSS3S;PASS;V.MSDR;PFV;PRS;V;IND;DAT;POSilişkinADPyasa3;N;ACC;SGvetoNOM;N;3;SGetPFV;PST;V;IND;SG;3;POS._
	
	
Özer'lerinMithatpaşa'dakibahçeiçindekievindeydik.	ÖzerGEN;PL;PROPN;3MithatpaşaSG;ESS;PROPN;3kiADPbahçeSG;NOM;N;3içPSS3S;ESS;3;SG;ADJkiADPevPSS3S;ESS;3;SG;NiV;IND;PST;1;PFV;PL._
	
Onuulaştırmamgerek,dedim.	o3;SG;PRO;ACCulaş<unk>gerekSG;3;N;NOM,_dePST;1;POS;IND;SG;PFV;V._
	
GörünenokiBitlisdosyasıaskerimakamlarcaaçılmamaküzereçoktankapatılmıştı.	görünPFV;PRS;V;IND;V.PTCP;POSoPRO;NOM;SG;3kiCONJBitlisNOM;PROPN;3;SGdosyaPSS3S;NOM;SG;3;NaskeriADJmakam3;N;PL;EQTVaç<unk>üzereADPçok3;ADJ;SG;AT+ABLkapaPFV;V;IND;SG;3;PST+PRF;POS._
	
Kusursuzbiryuvarlaklık,karanlığınortasındageceningüneşiymişçesinepırılpırılyanıyordu.	kusursuzADJbirNUMyuvarlaklıkNOM;N;3;SG,_karanlık3;ADJ;SG;GENortaPSS3S;ADJ;SG;3;ESSgece3;N;SG;GENgüneşPSS3S;NOM;SG;3;Ni<unk>pırıl_pırıl_yanINFM;PST;V;IND;PROG;SG;3;POS._
	
Erkeköğretmendahasertolur,kızlarlaanlaşamazdiyedüşünüyorum.	erkekNOM;ADJ;3;SGöğretmenNOM;N;3;SGdahaADVsertADJolHAB;PRS;V;IND;SG;3;POS,_kız3;INS;ADJ;PLanlaşNEG;HAB;PRS;V;POT;SG;3diyeADPdüşünINFM;1;PRS;V;IND;PROG;SG;POS._
	
Kızıbirbuçukyaşındaydı.	kızPSS3S;NOM;ADJ;SG;3birbuçukNUMyaşındaNOM;N;3;SGiPFV;V;PST;IND;SG;3._
	
Birçıkmazsokağagirdikgaliba.	birNUMçıkmazADJsokakSG;DAT;N;3girIND;PST;POS;1;PFV;PL;VgalibaADV._
	
Ayhanmezunoldugeldi...	AyhanSG;NOM;PROPN;3mezunSG;NOM;ADJ;3olIND;PST;POS;3;PFV;SG;VgelIND;PST;POS;3;PFV;SG;V..._
	
	
IrakmeselesiisegündemdekiyerinikorurkenTürkiyeileABD'ninanlayışfarklılığısürüyor.	IrakSG;3;PROPN;NOMmeselePSS3S;3;NOM;SG;NiVgündemSG;ESS;N;3kiADPyerPSS3S;3;SG;N;ACCkoru3;POS;IND;PRS;V.CVB;SG;V;HABTürkiyeSG;3;PROPN;NOMileCONJAbd3;SG;N;GENanlayışSG;3;N;NOMfarklılıkPSS3S;3;NOM;SG;Nsür3;POS;IND;PRS;INFM;SG;PROG;V._
	
Sıcaksavaştabeyintakımı.	sıcakADJsavaş3;N;ESS;SGbeyinNOM;N;3;SGtakımPSS3S;NOM;SG;3;N._
	
Alaturkanıntadıdabirbaşkacanım.	alaturka3;ADJ;SG;GENtatPSS3S;NOM;SG;3;NdaCONJbirADVbaşkaADPcanPSS1S;NOM;SG;3;N._
	
Bilimtarihinde,çokuzunvezahmetlibirkolektifsürecinürünüolanmantığısaymazsak,ikiönemliteorikatılımdönemivardır.	bilimNOM;N;3;SGtarihPSS3S;SG;3;N;ESS,_çokADVuzunADJveCONJzahmetNOM;N;3;SGliADPbirNUMkolektifADJsüreç3;N;SG;GENürünPSS3S;NOM;SG;3;NolPFV;PRS;V;IND;V.PTCP;POSmantıkPSS3S;NOM;SG;3;Nsay<unk>,_ikiNUMönemNOM;N;3;SGliADPteorikADJatılımNOM;N;3;SGdönemPSS3S;NOM;SG;3;NvarNOM;ADJ;3;SGiPFV;PRS;V;SG;3._
	
Birsüreönceocak-şubataylarındayoğunlaşanharekattarihineilişkinbeklentilerşimdimart-nisanaylarınadoğrukaymışgibigörünüyor.	birNUMsüreNOM;N;3;SGönceADPocakNOM;N;3;SG-_şubatNOM;N;3;SGayPSS3S;PL;3;N;ESSyoğunlaşPFV;PRS;V;IND;V.PTCP;POSharekatNOM;N;3;SGtarihPSS3S;SG;3;N;DATilişkinADPbeklentiNOM;N;PL;3şimdiADVmartNOM;N;3;SG-_nisanNOM;N;3;SGayPSS3S;PL;3;N;DATdoğruADPkayPFV;PST;V;NFH;IND;SG;3;POSgibiADPgörünINFM;PRS;V;IND;PROG;SG;3;POS._
	
Baksanızahallerine...diyerekMahmut'unmasasınıişaretetti.	bakPFV;PRS;2;V;PL;IMP;POShalPSS3P;PL;3;N;DAT..._dePFV;PRS;V;IND;POS;V.CVBMahmut3;PROPN;SG;GENmasaPSS3S;ACC;SG;3;NişaretNOM;N;3;SGetPFV;PST;V;IND;SG;3;POS._
	
HepaklımaKülKedisi,HanzelveGratel,PamukPrensesmasallarıgeliyor.	hepADVakılPSS1S;SG;3;N;DATkülNOM;N;3;SGkediPSS3S;NOM;SG;3;N,_HanzelNOM;PROPN;3;SGveCONJGratelNOM;PROPN;3;SG,_PamukNOM;PROPN;3;SGprensesNOM;N;3;SGmasal3;N;PL;ACCgelINFM;PRS;V;IND;PROG;SG;3;POS._
	
Taşhan'ınkapısınıitipiçeriyegirdim.	Taşhan3;PROPN;SG;GENkapıPSS3S;ACC;SG;3;NitPFV;PRS;V;IND;POS;V.CVBiçeri3;N;DAT;SGgir1;PFV;PST;V;IND;SG;POS._
	
Sarmısaklıayrıisim.	sarmısakNOM;N;3;SGliADPayrıADJisimNOM;N;3;SG._
	
	
yazarlarıTermodinamiğinİkinciYasası'nıntanımınıveyorumunuyanlışyapıyorlar!Yanlış!EntropininsürekliarttığınısavunanBoltzmannyorumu,dizgedekientropiüretimininısıakısıvebuakıyanedenolansıcaklıkgradyentindenhesaplandığınısöyler.	yazarPSS3S;NOM;PL;3;Ntermodinamik3;N;SG;GENikiNOM;SG;3;NUMyasaPSS3S;GEN;SG;3;NtanımPSS3S;ACC;SG;3;NveCONJyorumPSS3S;ACC;SG;3;NyanlışNOM;ADJ;3;SGyapINFM;PRS;V;IND;PL;PROG;3;POS!_yanlışNOM;ADJ;3;SG!_entropi3;N;SG;GENsürekliADVartPSS3S;ACC;PFV;PST;V;IND;V.PTCP;POSsavunPFV;PRS;V;IND;V.PTCP;POSBoltzmannNOM;PROPN;3;SGyorumPSS3S;NOM;SG;3;N,_dizge3;N;ESS;SGkiADPentropiNOM;N;3;SGüretimPSS3S;GEN;SG;3;NısıNOM;N;3;SGakıPSS3S;NOM;SG;3;NveCONJbuDETakı3;N;DAT;SGnedenADVolPFV;PRS;V;IND;V.PTCP;POSsıcaklıkNOM;N;3;SGgradyentPSS3S;AT+ABL;SG;3;NhesaplaPSS3S;PASS;ACC;PFV;PST;V;IND;V.PTCP;POSsöyleHAB;PRS;V;IND;SG;3;POS._
	
Birsoluktaufaklığı,annemleyaptığımızanlaşmayı,buköpeğinekadarçokistediğimiherşeyiamaherşeyieninceayrıntısınakadaranlattım.	birNUMsoluk3;ADJ;ESS;SGufaklık3;N;ACC;SG,_annePSS1S;INS;SG;3;NyapPSS1P;PFV;PST;V;IND;V.PTCP;POSanlaşma3;N;ACC;SG,_buDETköpek3;N;ACC;SGneNOM;3;PRO;SGkadarADPçokADVistePSS1S;ACC;PFV;PST;V;IND;V.PTCP;POSherşey3;N;ACC;SGamaCONJherşey3;N;ACC;SGenADVinceADJayrıntıPSS3S;SG;3;N;DATkadarADPanlat1;PFV;PST;V;IND;SG;POS._
	
Projeler,imeceler,göreceler,vesaire,herdaimdaire..	projeNOM;N;PL;3,_imeceNOM;N;PL;3,_göreceNOM;ADJ;PL;3,_vesaireNOM;N;3;SG,_herDETdaimADJdaireNOM;N;3;SG.._
	
İnsanlarınbaşkatürlü,belkidekendilerioldukları,bayağılaştıkları,sıradanlaştıkları,tenleriningizinibirsürebirbirlerineaçıpkapadıklarıbütünoantiktapınaklar...	insan3;N;PL;GENbaşkaADJtürlüADJ,_belkiADVdeCONJkendiPSS3P;REFL;PRO;NOM;PL;3olPSS3P;PFV;PST;NOM;V;IND;V.PTCP;POS,_bayağılaşPSS3P;PFV;PST;NOM;V;IND;V.PTCP;POS,_sıradanlaşPSS3P;PFV;PST;NOM;V;IND;V.PTCP;POS,_tenPSS3P;PL;3;N;GENgizPSS3S;ACC;SG;3;NbirNUMsüreNOM;N;3;SGbirbiriPSS3P;PRO;PL;3;DATaçPFV;PRS;V;IND;POS;V.CVBkapaPSS3P;PFV;PST;NOM;V;IND;V.PTCP;POSbütünADJoDETantikADJtapınakNOM;N;PL;3..._
	
DışişleriBakanlığı,Türkiye'nindevletolarakdavasürecinemüdahilolmamakararını,Yunanmevzuatınadayanarakaldı.	dışişleriNOM;N;PL;3bakanlıkPSS3S;NOM;SG;3;N,_Türkiye3;PROPN;SG;GENdevletNOM;N;3;SGolarakADPdavaNOM;N;3;SGsüreçPSS3S;SG;3;N;DATmüdahilADJolV.MSDR;NEG;PFV;PRS;NOM;V;INDkararPSS3S;ACC;SG;3;N,_YunanNOM;ADJ;3;SGmevzuatPSS3S;SG;3;N;DATdayanPFV;PRS;V;IND;POS;V.CVBalPFV;PST;V;IND;SG;3;POS._
	
Sobanınüstündeiçmesuyunadönüşecekdahasonrabunlar.	soba3;N;SG;GENüstPSS3S;ADJ;SG;3;ESSiçV.MSDR;PFV;PRS;NOM;V;IND;POSsuPSS3S;SG;3;N;DATdönüşFUT;PFV;V;IND;SG;3;POSdahaADVsonraADPbuPRO;NOM;PL;3._
	
Gençirisi.	gençNOM;ADJ;3;SGirisPSS3S;NOM;SG;3;N._
	
Senemyenibiryolaramayabaşladı.	SenemNOM;PROPN;3;SGyeniADJbirNUMyolNOM;N;3;SGaraV.MSDR;PFV;PRS;V;IND;DAT;POSbaşlaPFV;PST;V;IND;SG;3;POS._
	
Birdefasındalaforayagelirgibioldu,derhal,halledilmemişbirbaşkatartışmayıaçarakherkesisürükledim.	birNUMdefaPSS3S;SG;3;N;ESSlafNOM;N;3;SGora3;DAT;PRO;SGgelHAB;PRS;V;IND;V.PTCP;POSgibiADPolPFV;PST;V;IND;SG;3;POS,_derhalADV,_halletPASS;NEG;PFV;PST;V;NFH;IND;V.PTCPbirNUMbaşkaADJtartışV.MSDR;ACC;PFV;PRS;V;IND;POSaçPFV;PRS;V;IND;POS;V.CVBherkes3;N;ACC;SGsürükle1;PFV;PST;V;IND;SG;POS._
	
Bazendebütünparanıalır.	bazenADVdeCONJbütünADJparaPSS2S;3;SG;N;ACCal3;POS;IND;PRS;SG;V;HAB._
	
Jul,aklınaönemlibirşeygelmişgibidurdubiran,ciddişeylerdüşüneninsanlarıntavrıyla.	julSG;NOM;N;3,_akılPSS3S;3;DAT;SG;NönemSG;NOM;N;3liADPbirNUMşeySG;NOM;N;3gelNFH;IND;PST;POS;PFV;V.PTCP;VgibiADPdurIND;PST;POS;3;PFV;SG;VbirNUManSG;NOM;N;3,_ciddiADJşeyNOM;PL;N;3düşünIND;POS;PRS;PFV;V.PTCP;VinsanGEN;PL;N;3tavırPSS3S;INS;3;SG;N._
	
AmanAllahımyüzbinlira!diyehayretlebağırdıMelek.	amanINTJallahPSS1S;NOM;SG;3;NyüzNUMbinNUMliraNOM;N;3;SG!_diyeADPhayret3;N;INS;SGbağırPFV;PST;V;IND;SG;3;POSMelekNOM;PROPN;3;SG._
	
Bugünyeniteknolojilerancakbütünüylebilimselbilgilertemelindeüretilebilirhalegelmiştir.	bugünNOM;N;3;SGyeniADJteknolojiNOM;N;PL;3ancakADVbütünPSS3S;INS;ADJ;SG;3bilimselADJbilgiNOM;N;PL;3temelPSS3S;ADJ;SG;3;ESSüreHAB;PRS;V;POT;SG;3;POShaleNOM;N;3;SGgelPFV;PST;V;NFH;SG;3;POS._
	
(ÖbüryanımdabirAlman.	(_öbürADJyan<unk>birNUMAlmanSG;NOM;ADJ;3._
	
	
Hazinegarantilerinedeniyledoğabileceködemeleriçindeüçyüzyirmialtıtrilyonliralıködenekayrıldı.	hazineNOM;N;3;SGgarantiPSS3S;NOM;PL;3;NnedenPSS3S;INS;SG;3;NdoğFUT;PFV;V;POT;V.PTCP;POSödeV.MSDR;PFV;PRS;NOM;V;IND;POSiçinADPdeCONJüçyüzyirmialtıNUMtrilyonNOM;SG;3;NUMliraNOM;N;3;SGlikADPödenekNOM;N;3;SGayrılPFV;PST;V;IND;SG;3;POS._
	
Babam,avukattı.	babaPSS1S;3;NOM;SG;N,_avukatSG;3;N;NOMiPST;V;3;IND;SG;PFV._
	
İnekbakıcısıolsun,demişadam.	inekNOM;N;3;SGbakıcıPSS3S;NOM;SG;3;NolPFV;PRS;V;SG;3;IMP;POS,_dePFV;PST;V;NFH;IND;SG;3;POSadamNOM;N;3;SG._
	
1950'deotuzaltıliraaylıkiyipara,düşünsene,evkirasıaltıbuçuk,sığıretiikilira,kuzuetideikiyüzyirmibeşkuruştu.	1950NUM;ESS;3;SGotuzNUM;NOM;3;SGaltıNUM;NOM;3;SGliraSG;NOM;N;3aylıkSG;NOM;N;3iyiADJparaSG;NOM;N;3,_düşün<unk>,_evSG;NOM;N;3kiraPSS3S;NOM;3;SG;NaltıNUMbuçukADJ,_sığırSG;NOM;N;3etPSS3S;NOM;3;SG;NikiNUMliraSG;NOM;N;3,_kuzuSG;NOM;N;3etPSS3S;NOM;3;SG;NdeCONJikiNUMyüzNUMyirmiNUMbeşNUMkuruşSG;NOM;N;3iV;IND;PST;3;PFV;SG._
	
Çünküanlattığışeyler,birdindarınanlattıklarınabenzemiyor.	çünküCONJanlaPSS3S;PFV;PST;V;IND;V.PTCP;CAUS;POSşeyNOM;N;PL;3,_birNUMdindar3;ADJ;SG;GENanlatPSS3S;PFV;PST;V;IND;V.PTCP;DAT;POSbenzeINFM;NEG;PRS;V;IND;PROG;SG;3._
	
Berabercekorkunçbirsahneyarattık.	beraberceADVkorkunçADJbirNUMsahneNOM;N;3;SGyarat1;PFV;PST;V;IND;PL;POS._
	
BuaradaAlaattinYunak'ın(otuzdört)da,Diyarbakırseferinearkadaşınınyerineçıktığıöğrenildi.	buDETara3;ADJ;ESS;SGAlaattinNOM;PROPN;3;SGYunak3;PROPN;SG;GEN(_otuzdörtNOM;SG;3;NUM)_daCONJ,_DiyarbakırNOM;PROPN;3;SGseferPSS3S;SG;3;N;DATarkadaşPSS3S;GEN;SG;3;NyerPSS3S;SG;3;N;DATçıkPSS3S;PFV;PST;NOM;V;IND;V.PTCP;POSöğrenPASS;PFV;PST;V;IND;SG;3;POS._
	
İzlenimleriniertesisabah,durugünışığındakalemealmasıdahasağlıklıolacaktı.	izlenimPSS3S;ACC;PL;3;NertesiADJsabahNOM;N;3;SG,_duruADJgünNOM;N;3;SGışıkPSS3S;SG;3;N;ESSkalem3;N;DAT;SGalPSS3S;V.MSDR;PFV;PRS;NOM;V;IND;POSdahaADVsağlıkNOM;N;3;SGliADPol{FUT/PST};V;IND;PROSP;SG;3;POS._
	
Beyazpeynirgeliyor.	beyazADJpeynirNOM;N;3;SGgelINFM;PRS;V;IND;PROG;SG;3;POS._
	
Aslındabiztarafız.	aslındaADVbiz1;PRO;NOM;PLtarafNOM;N;3;SGi1;PFV;PRS;V;IND;PL._
	
Sonsevgilisiyimbenonun.	sonADJsevgiliPSS3S;NOM;ADJ;SG;3i1;PFV;PRS;V;IND;SGben1;PRO;NOM;SGoPRO;SG;3;GEN._
	
Ramizbirsıçramadaaynıyeretutundu.	RamizSG;NOM;PROPN;3birNUMsıçraIND;ESS;POS;V.MSDR;PRS;PFV;VaynıADJyerSG;DAT;N;3tutuPSS2S;NOM;3;SG;NiV;IND;PST;3;PFV;SG._
	
	
	
NedensonraKatanaağaçtansüzülüpindi.	ne3;SG;PRO;AT+ABLsonraADPKatanaNOM;PROPN;3;SGağaç3;N;SG;AT+ABLsüzülPFV;PRS;V;IND;POS;V.CVBinPFV;PST;V;IND;SG;3;POS._
	
Ogünçayakarıştırılacakmiktarıçarçabuksağıp,soğuktanüşüyenellerinisıvazlayarakiçerikoştular.	oDETgünNOM;N;3;SGçay3;N;DAT;SGkarışFUT;PFV;V;IND;V.PTCP;POSmiktarPSS3S;NOM;SG;3;NçarçabukADVsağPFV;PRS;V;IND;POS;V.CVB,_soğuk3;ADJ;SG;AT+ABLüşüPFV;PRS;V;IND;V.PTCP;POSelPSS3P;ACC;PL;3;NsıvazlaPFV;PRS;V;IND;POS;V.CVBiçeriADJkoşPFV;PST;V;IND;PL;3;POS._
	
Hakkı'ylaihtilalebakmakistiyorduk.	hakPSS3S;INS;SG;3;Nihtilal3;N;DAT;SGbakV.MSDR;PFV;PRS;NOM;V;IND;POSisteINFM;1;PST;V;IND;PL;PROG;POS._
	
Albümlerigeriyedoğruçevirdim.	albüm3;N;PL;ACCgeri3;ADJ;DAT;SGdoğruADPçevir1;PFV;PST;V;IND;SG;POS._
	
MahmutBeyiaramıştım.	MahmutNOM;PROPN;3;SGbey3;N;ACC;SGara1;PFV;V;IND;SG;PST+PRF;POS._
	
Sıkılmışkravatlarınvedarpabuçlarınesaretindeboğulmadan.	sıkPASS;PFV;PST;V;NFH;IND;V.PTCP;POSkravat3;N;PL;GENveCONJdarADJpabuç3;N;PL;GENesaretPSS3S;SG;3;N;ESSboğPASS;NEG;PFV;PRS;V;IND;V.CVB._
	
Üstündebiratletvardı.	üstPSS3S;ADJ;SG;3;ESSbirNUMatletNOM;N;3;SGvarPFV;PST;V;IND;SG;3;POS._
	
Adamınyanındakimasayaoturdum.	adam3;N;SG;GENyanPSS3S;ADJ;SG;3;ESSkiADPmasa3;N;DAT;SGotur1;PFV;PST;V;IND;SG;POS._
	
-Sizdemiyazıyorsunuz.	-_sizNOM;PL;2;PROdeCONJmiV;3;IND;PRS;SG;PFVyazPOS;PL;IND;PRS;INFM;2;PROG;V._
	
Sonraötekisorularageçtim.	sonraADVötekiSG;3;N;NOMsoruPL;DAT;N;3geçPST;1;POS;IND;SG;PFV;V._
	
Saraçgibi,marangozgibi.	saraçSG;3;N;NOMgibiADP,_marangozSG;3;N;NOMgibiADP._
	
Okulasoluksoluğageldiler.	okul3;N;DAT;SGsolukADJsoluk3;ADJ;DAT;SGgelPFV;PST;V;IND;PL;3;POS._
	
Evdedir.	ev3;N;ESS;SGiPFV;PRS;V;SG;3._
	
	
EskiDevletBakanıveBaşbakanYardımcısı,ToplumcuKurtuluşPartisi(TKP)LefkoşaMilletvekiliMustafaAkıncıda,"Denktaş'ın,izlediğipolitikaylaKıbrıs'ıkalıcıtaksimegötürdüğünü"önesürdü.	eskiADJdevletNOM;N;3;SGbakanPSS3S;NOM;SG;3;NveCONJbaşbakanNOM;N;3;SGyardımcıPSS3S;NOM;SG;3;N,_toplumcuNOM;N;3;SGkurtuluşNOM;N;3;SGpartiPSS3S;NOM;SG;3;N(_TkpNOM;PROPN;3;SG)_LefkoşaNOM;PROPN;3;SGmilletvekiliPSS3S;NOM;SG;3;NMustafaNOM;PROPN;3;SGAkıncıNOM;PROPN;3;SGdaCONJ,_"_Denktaş3;PROPN;SG;GEN,_izlePSS3S;PFV;PST;V;IND;V.PTCP;POSpolitika3;N;INS;SGKıbrıs3;PROPN;ACC;SGkalPFV;PRS;V;IND;V.PTCP;POStaksim3;N;DAT;SGgötürPSS3S;ACC;PFV;PST;V;IND;V.PTCP;POS"_ön3;ADJ;DAT;SGsürPFV;PST;V;IND;SG;3;POS._
	
':Kredilerhazır.	'_:_krediNOM;N;PL;3hazırADJ._
	
İhracattakiolumlugelişmeleridevamettirmeninönceliklihedeflerindenolduğunubelirtenEsgin,şunlarıkaydetti:"Amacımız,ikibinbeşyılındaihracatınciroiçindekipayınıyüzdeelli'yeçıkarmak.	ihracat3;N;ESS;SGkiADPolumluADJgelişV.MSDR;ACC;PFV;PRS;V;IND;POSdevamNOM;N;3;SGetV.MSDR;PFV;PRS;V;IND;CAUS;POS;GENöncelikNOM;N;3;SGliADPhedefPSS3S;AT+ABL;PL;3;NolPSS3S;ACC;PFV;PST;V;IND;V.PTCP;POSbelirPFV;PRS;V;IND;V.PTCP;CAUS;POSEsginNOM;PROPN;3;SG,_şuPRO;ACC;PL;3kaydetPFV;PST;V;IND;SG;3;POS:_"_amaçPSS1P;NOM;SG;3;N,_ikibinbeşNUMyılPSS3S;SG;3;N;ESSihracat3;N;SG;GENciroNOM;N;3;SGiçPSS3S;ADJ;SG;3;ESSkiADPpayPSS3S;ACC;SG;3;NyüzSG;3;NUM;ESSelliSG;3;NUM;DATçıkarV.MSDR;PFV;PRS;NOM;V;IND;POS._
	
Ruhunkapandığı,gövdeninseçırılçıplakgöründüğükapalı,rutubetli,bazandagizliyerler.	ruh3;N;SG;GENkapaPSS3S;PASS;PFV;PST;V;IND;V.PTCP;POS,_gövde3;N;SG;GENiCOND;PFV;PRS;V;SG;3çırılçıplakADJgörünPSS3S;PFV;PST;V;IND;V.PTCP;POSkapalıADJ,_rutubetNOM;N;3;SGliADP,_bazanADVdaCONJgizliADJyerNOM;N;PL;3._
	
Tanışmadınız,görsenşaşarsın,çokzeki,anlayışlıama...	tanışNEG;PFV;2;PST;V;IND;PL,_görCOND;PFV;PRS;2;V;SG;POSşaşHAB;2;PRS;V;IND;SG;POS,_çokADVzekiADJ,_anlayışlıADJamaCONJ..._
	
Bilmiyorum.	bilINFM;NEG;IND;1;PRS;SG;PROG;V._
	
DünakşamSezer'inverdiğiyemektedeHayrünnisaGüleşininyanındayeralmadı.	dünSG;3;N;NOMakşamSG;3;N;NOMSezerSG;GEN;PROPN;3verPSS3S;PST;POS;IND;PFV;V.PTCP;VyemekSG;ESS;N;3deCONJHayrünnisaSG;3;PROPN;NOMGülSG;3;PROPN;NOMeşPSS3S;3;ADJ;SG;GENyanPSS3S;3;ADJ;SG;ESSyerSG;3;N;NOMalPST;3;IND;SG;NEG;PFV;V._
	
Dünyadadüşünülecekoncagüzelşeyvarken,seninkuruntularyaratmanveonlarıniçindebunalmanakılalacakgibideğil.	dünya3;N;ESS;SGdüşünFUT;PASS;PFV;V;IND;V.PTCP;POSoncaADVgüzelADJşeyNOM;N;3;SGvarNOM;ADJ;3;SGiPFV;PRS;V;IND;V.CVB,_senPRO;2;SG;GENkuruntuNOM;N;PL;3yaratPSS2S;V.MSDR;PFV;PRS;NOM;V;IND;POSveCONJoPRO;PL;3;GENiçPSS3S;ADJ;SG;3;ESSbunalPSS2S;V.MSDR;PFV;PRS;NOM;V;IND;POSakılNOM;N;3;SGalFUT;PFV;V;IND;V.PTCP;POSgibiADPdeğilNEG;PFV;PRS;V;IND;SG;3._
	
Eşigeridöndüktensonradabirsüreİstanbul'dakalmayıplanlayangençkadın,anidenfikirdeğiştiripdönmeyekararverdi.	eşPSS3S;NOM;ADJ;SG;3geriNOM;ADJ;3;SGdönAT+ABL;PFV;PST;V;IND;V.PTCP;POSsonraADPdaCONJbirNUMsüreNOM;N;3;SGİstanbul3;PROPN;ESS;SGkalV.MSDR;ACC;PFV;PRS;V;IND;POSplanlaPFV;PRS;V;IND;V.PTCP;POSgençADJkadınNOM;ADJ;3;SG,_anidenADVfikirNOM;N;3;SGdeğişPFV;PRS;V;IND;CAUS;POS;V.CVBdönV.MSDR;PFV;PRS;V;IND;DAT;POSkararNOM;N;3;SGverPFV;PST;V;IND;SG;3;POS._
	
Anidenkaybolupgidiverdi.	anidenADVkaybolPFV;PRS;V;IND;POS;V.CVBgitPST;V;IND;SG;3;POS._
	
Birmüzikalyapalım:Hadifıstık,yadafındıkaryalarısöyledi.	birNUMmüzikalNOM;ADJ;3;SGyap1;OPT;PFV;PRS;V;PL;POS:_hadiINTJfıstıkNOM;N;3;SG,_yaCONJdaCONJfındıkNOM;N;3;SGarya3;N;PL;ACCsöylePFV;PST;V;IND;SG;3;POS._
	
Amaçoğununteorileritartışılırolmaktançıkmıştı...	amaCONJçokPSS3S;GEN;ADJ;SG;3teoriPSS3P;NOM;PL;3;NtartışPASS;HAB;PRS;V;IND;V.PTCP;POSolV.MSDR;AT+ABL;PFV;PRS;V;IND;POSçıkPFV;V;IND;SG;3;PST+PRF;POS..._
	
Bayağıkızıyorsun.	bayağıADJkızPOS;IND;PRS;INFM;SG;2;PROG;V._
	
İlhamigeldi.	İlhamiNOM;PROPN;3;SGgelPFV;PST;V;IND;SG;3;POS._
	
Hiiç,dedi,oturuyorum.	hiçSG;3;N;NOM,_dePST;3;POS;IND;SG;PFV;V,_otur1;POS;IND;PRS;INFM;SG;PROG;V._
	
Tabiikiciddiyapılanherişgibibudakabınasığamadı.	tabiiADJkiCONJciddiADJyapIND;POS;PASS;PRS;PFV;V.PTCP;VherDETişSG;NOM;N;3gibiADPbuDETdaCONJkapPSS3S;NOM;3;SG;NsığPOT;NEG;PST;3;PFV;SG;V._
	
	
Kaçkezdenemişti;ikitürküdensonrabalıkçılar,utangaçhallerindensıyrılıp,tarihindeğil,doğanınkendilerineverdiğiniteliğiyeğleyerek,masalardaoturanyabancıkadınlaragözsüzmeyebaşlıyorlardı.	kaçNUMkezNOM;N;3;SGdenePFV;V;IND;SG;3;PST+PRF;POS;_ikiNUMtürkü3;N;SG;AT+ABLsonraADPbalıkçıNOM;N;PL;3,_utangaçADJhalPSS3P;AT+ABL;PL;3;NsıyrılPFV;PRS;V;IND;POS;V.CVB,_tarihPSS2S;NOM;SG;3;NdeğilCONJ,_doğa3;N;SG;GENkendiPSS3P;REFL;PRO;PL;3;DATverPSS3S;PFV;PST;V;IND;V.PTCP;POSnitelik3;N;ACC;SGyeğlePFV;PRS;V;IND;POS;V.CVB,_masa3;N;PL;ESSoturPFV;PRS;V;IND;V.PTCP;POSyabancıADJkadın3;ADJ;DAT;PLgözNOM;N;3;SGsüzV.MSDR;PFV;PRS;V;IND;DAT;POSbaşlaINFM;PST;V;IND;PL;PROG;3;POS._
	
	
Arkamdaoturançocukbeniyavaşçadürttü.	arkaPSS1S;ADJ;SG;3;ESSoturPFV;PRS;V;IND;V.PTCP;POSçocukNOM;N;3;SGben1;PRO;ACC;SGyavaşçaADVdürtPFV;PST;V;IND;SG;3;POS._
	
Sesipekkeyifsizgeldi.	sesPSS3S;NOM;SG;3;NpekADVkeyifsizADJgelPFV;PST;V;IND;SG;3;POS._
	
Odakendiniyukarıçekti.	oPRO;NOM;SG;3daCONJkendiPSS3S;REFL;PRO;ACC;SG;3yukarıADJçekPFV;PST;V;IND;SG;3;POS._
	
Dikkatimiçekenherkesinbizimgibiözenligiyimiydi.	dikkatPSS1S;ACC;SG;3;NçekPFV;PRS;V;IND;V.PTCP;POSherkes3;N;SG;GENbiz1;PRO;PL;GENgibiADPözenNOM;N;3;SGliADPgiyimPSS3S;NOM;SG;3;NiPFV;V;PST;IND;SG;3._
	
İçindecinayetolmayanbircinayetromanıyazmayıdüşünüyordum.	içPSS3S;ADJ;SG;3;ESScinayetNOM;N;3;SGolNEG;PFV;PRS;V;IND;V.PTCPbirNUMcinayetNOM;N;3;SGromanPSS3S;NOM;SG;3;NyazV.MSDR;ACC;PFV;PRS;V;IND;POSdüşünINFM;1;PST;V;IND;PROG;SG;POS._
	
İnsanoğlunun-kendininde-niçinböyleceyaşamakzorundaolduğunuanlayamadığızevkçeşmeleri...	insanoğlu3;N;SG;GEN-_kendiPSS3S;GEN;REFL;PRO;SG;3deCONJ-_niçinADVböyleceADVyaşaV.MSDR;PFV;PRS;NOM;V;IND;POSzorPSS2S;ADJ;SG;3;ESSolPSS3S;ACC;PFV;PST;V;IND;V.PTCP;POSanlaPSS3S;NEG;PFV;PST;NOM;V;POT;V.PTCPzevkNOM;N;3;SGçeşmePSS3S;NOM;PL;3;N..._
	
Tuzlasudabekletilmiş,sonrakavrulmuştur.	tuzSG;INS;N;3suSG;ESS;N;3bekleNFH;IND;PST;POS;3;PFV;SG;V,_sonraADVkavrulNFH;PST;POS;3;PFV;SG;V._
	
Hukukçular.	hukukçuNOM;N;PL;3._
	
Fasulye,pilakidehavuçtanvesarmısaktantakviyealır.	fasulyeNOM;N;3;SG,_pilaki3;N;ESS;SGhavuç3;N;SG;AT+ABLveCONJsarmısak3;N;SG;AT+ABLtakviyeNOM;N;3;SGalHAB;PRS;V;IND;SG;3;POS._
	
BiradamaKabakdiyin.	birNUMadam3;N;DAT;SGkabakNOM;ADJ;3;SGdePFV;PRS;2;V;PL;IMP;POS._
	
ZatenölmekvardönmekyoksözünügündemegetirendeyineNusretSenem'di.	zatenADVölV.MSDR;PFV;PRS;NOM;V;IND;POSvarADJdönV.MSDR;PFV;PRS;NOM;V;IND;POSyokADJsözPSS3S;ACC;SG;3;Ngündem3;N;DAT;SGgetirPFV;PRS;V;IND;V.PTCP;POSdeCONJyineADVNusretNOM;PROPN;3;SGSenemNOM;PROPN;3;SGiPFV;V;PST;IND;SG;3._
	
Hadibirazdahailerigidelim.	hadiINTJbirazADVdahaADVileriNOM;ADJ;3;SGgit1;OPT;PFV;PRS;V;PL;POS._
	
Şimdibuuçakkazasındandayaralıolarakçıktı.	şimdiADVbuDETuçakNOM;N;3;SGkazaPSS3S;AT+ABL;SG;3;NdaCONJyaraNOM;N;3;SGliADPolarakADPçıkPFV;PST;V;IND;SG;3;POS._
	
Arkadaşlararasındabüyüksır.	arkadaşNOM;N;PL;3araPSS3S;ADJ;SG;3;ESSbüyükADJsırNOM;N;3;SG._
	
Birandurdum.	birNUManNOM;N;3;SGdur1;PFV;PST;V;IND;SG;POS._
	
Maydanozbaşta.	maydanozNOM;N;3;SGbaş3;N;ESS;SG._
	
Fransa'nınküflüpeyniriRoquefortvar.	FransaGEN;SG;PROPN;3küflüADJpeynirPSS3S;NOM;3;SG;NRoquefordSG;NOM;PROPN;3varADJ._
	
Annem(canımannem)severonu..	annePSS1S;NOM;SG;3;N(_canPSS1S;NOM;SG;3;NannePSS1S;NOM;SG;3;N)_sevHAB;PRS;V;IND;SG;3;POSoPRO;ACC;SG;3.._
	
Keşkehayataveaşkadairkonuşsaydınızönce...	keşkeADVhayat3;N;DAT;SGveCONJaşk3;N;DAT;SGdairADPkonuşPFV;2;PST;V;PL;POSönceADV..._
	
Heyettedörtüyedahavardı:KurmayPilotAlbayTünayÇelen,PilotBinbaşıC.	heyetSG;ESS;N;3dörtNUMüyeSG;NOM;N;3dahaADVvarSG;NOM;ADJ;3iV;IND;PST;3;PFV;SG:_kurmaySG;NOM;N;3pilotSG;NOM;N;3albaySG;NOM;N;3TünaySG;NOM;PROPN;3ÇelenSG;NOM;PROPN;3,_pilotSG;NOM;N;3binbaşıSG;NOM;N;3cSG;NOM;N;3._
	
Iraktehdidinekarşınriskalabilenyatırımcıbuseviyelerdeortaveuzunvadeliportföyoluşturabilir.	IrakNOM;PROPN;3;SGtehditPSS3S;SG;3;N;DATkarşınADPriskNOM;N;3;SGalPFV;PRS;V;POT;V.PTCP;POSyatırımcıNOM;N;3;SGbuDETseviye3;N;PL;ESSortaADJveCONJuzunADJvadeNOM;N;3;SGliADPportföyNOM;N;3;SGoluşHAB;PRS;V;POT;SG;3;CAUS;POS._
	
Benİngilizcesindenokuyorum.	ben1;PRO;NOM;SGİngilizcePSS3S;AT+ABL;ADJ;SG;3okuINFM;1;PRS;V;IND;PROG;SG;POS._
	
Beniciddiyealmamıştı.	ben1;SG;PRO;ACCciddiSG;DAT;ADJ;3al3;IND;SG;NEG;PFV;PST+PRF;V._
	
Nedemek,Benevdenkaçarım,demek?	neNOM;3;PRO;SGdeV.MSDR;PFV;PRS;NOM;V;IND;POS,_ben1;PRO;NOM;SGev3;N;SG;AT+ABLkaç1;HAB;PRS;V;IND;SG;POS,_deV.MSDR;PFV;PRS;NOM;V;IND;POS?_
	
Nesrinciddiyealmış,sürdürmeyeniyetliydi:Dibimizdeydinovakit.	NesrinSG;NOM;PROPN;3ciddiSG;DAT;ADJ;3alNFH;IND;PST;POS;3;PFV;SG;V,_sürCAUS;IND;V.MSDR;POS;DAT;PRS;PFV;VniyetliSG;NOM;ADJ;3iV;IND;PST;3;PFV;SG:_dipPSS1P;ESS;3;SG;Ni<unk>oDETvakitSG;NOM;N;3._
	
Dükkanınkapısındainsanlarikisıraoldu.	dükkan3;N;SG;GENkapıPSS3S;SG;3;N;ESSinsanNOM;N;PL;3ikiNUMsıraNOM;N;3;SGolPFV;PST;V;IND;SG;3;POS._
	
Nasılyaptığımıanımsamıyorum.	nasılADVyapPSS1S;ACC;PFV;PST;V;IND;V.PTCP;POSanımsaINFM;1;NEG;PRS;V;IND;PROG;SG._
	
Bunakarşılıkbendeonunmutsuzlukoyununuoynamadım.	buPRO;SG;3;DATkarşılıkNOM;N;3;SGben1;PRO;NOM;SGdeCONJoPRO;SG;3;GENmutsuzlukNOM;N;3;SGoyunPSS3S;ACC;SG;3;Noyna1;NEG;PFV;PST;V;IND;SG._
	
Amahastalıkbu,şıpdiyekesilmemiş.	amaCONJhastalıkSG;3;N;NOMbu3;NOM;SG;PRO,_şıpSG;3;N;NOMdiyeADPkes<unk>._
	
Buyurun.	buyuruPSS2S;NOM;SG;3;N._
	
	
PilotYunak'ınsinirkrizlerigeçirenannesiRüveydeYunakileablasıAsumanTaranisedoktor'..	pilotSG;NOM;N;3YunakGEN;SG;PROPN;3sinirSG;NOM;N;3krizPSS3S;NOM;3;PL;NgeçirIND;POS;PRS;PFV;V.PTCP;VannePSS3S;NOM;3;SG;NRüveydeSG;NOM;PROPN;3YunakSG;NOM;PROPN;3ileCONJablaPSS3S;NOM;3;SG;NAsumanSG;NOM;PROPN;3TaranSG;NOM;PROPN;3iVdoktorSG;NOM;N;3'_.._
	
Nezaman.	neNOM;3;PRO;SGzamanNOM;N;3;SG._
	
Kemal,anlayışlıbirsestonuylakonuştu:Bunuanlamayaçalışalım.	KemalSG;NOM;PROPN;3,_anlayışlıADJbirNUMsesSG;NOM;N;3tonPSS3S;INS;3;SG;NkonuşIND;PST;POS;3;PFV;SG;V:_buPRO;ACC;3;SGanlaIND;V.MSDR;POS;DAT;PRS;PFV;VçalışPOS;1;PRS;PFV;OPT;PL;V._
	
Akkaya'nınyapılanmuayenesonucundaşiddetlikarınağrısınınapandisitverahmindepatlayankisttenkaynaklandığıanlaşıldı.	AkkayaSG;GEN;PROPN;3yapPASS;POS;PRS;IND;PFV;V.PTCP;VmuayeneSG;3;N;NOMsonuçPSS3S;3;SG;N;ESSşiddetSG;3;N;NOMliADPkarınSG;3;N;NOMağrıPSS3S;3;SG;N;GENapandisitSG;3;N;NOMveCONJrahimPSS3S;3;SG;N;ESSpatlaPOS;PRS;IND;PFV;V.PTCP;VkistSG;AT+ABL;N;3kaynaklaPSS3S;PASS;PST;NOM;POS;IND;PFV;V.PTCP;VanlaşPASS;PST;3;POS;IND;SG;PFV;V._
	
Yürüdüğümüzyolbitmiş,birbaşkasokağaaçılmıştı.	yürüPSS1P;PFV;PST;V;IND;V.PTCP;POSyolNOM;N;3;SGbitPFV;PST;V;NFH;IND;SG;3;POS,_birNUMbaşkaADJsokak3;N;DAT;SGaçPASS;PFV;V;IND;SG;3;PST+PRF;POS._
	
Ayhan,bunotlarıbanaverdivedediki:Benimanlatacaklarımbukadar.	AyhanNOM;PROPN;3;SG,_buDETnot3;N;PL;ACCben1;PRO;SG;DATverPFV;PST;V;IND;SG;3;POSveCONJdePFV;PST;V;IND;SG;3;POSkiCONJ:_ben1;PRO;SG;GENanlatPSS1S;FUT;PFV;NOM;V;IND;V.PTCP;POSbuDETkadarADP._
	
Aşağıdaayrıntılarıyladeğineceğiz.	aşağı3;ADJ;ESS;SGayrıntıPSS3S;INS;PL;3;NdeğinFUT;1;PFV;V;IND;PL;POS._
	
Hememinimki,benimdebendendahabüyükbirkardeşimolsaydı,odaaynılarınıyapardı.	hemCONJeminNOM;ADJ;3;SGi1;PFV;PRS;V;IND;SGkiCONJ,_ben1;PRO;SG;GENdeCONJben1;PRO;AT+ABL;SGdahaADVbüyükADJbirNUMkardeşPSS1S;NOM;SG;3;NolCOND;PFV;PST;V;SG;3;POS,_oPRO;NOM;SG;3daCONJaynıPSS3S;ACC;ADJ;PL;3yapHAB;PST;V;IND;SG;3;POS._
	
Kızkardeşimsaçlarınıevdekendisiboyardı.	kızNOM;ADJ;3;SGkardeşPSS1S;NOM;SG;3;NsaçPSS3S;ACC;PL;3;Nev3;N;ESS;SGkendiPSS3S;REFL;PRO;NOM;SG;3boyaHAB;PST;V;IND;SG;3;POS._
	
Onugörmek...	o3;SG;PRO;ACCgörNOM;POS;IND;PRS;PFV;V;V.MSDR..._
	
Hazine'ninbuhaftabeşkatrilyonlirasıpiyasayaolmaküzeretoplamaltıkatrilyonliratutarındaiçborçgeriödemesivar.	hazineSG;GEN;N;3buDEThaftaSG;3;N;NOMbeşNUMkatrilyonNUMliraPSS3S;3;NOM;SG;NpiyasaSG;DAT;N;3olNOM;POS;IND;PRS;PFV;V;V.MSDRüzereADPtoplamSG;3;N;NOMaltıNUMkatrilyonNUMliraSG;3;N;NOMtutarPSS3S;3;SG;N;ESSiçSG;3;ADJ;NOMborçSG;3;N;NOMgeriSG;3;ADJ;NOMödePSS3S;V.MSDR;NOM;POS;IND;PRS;PFV;VvarADJ._
	
".	"_._
	
Gül,MilliSavunmaBakanıVecdiGönülveDışişleriBakanıYaşar','GenelBaşkanıTayyipErdoğan'ın,Avrupa'da,"Türkiye'deordununsiyasetekarışmadığını,ancakterörüntırmandığıdönemlerdedevreyegirdiğinibelirterekyanıtverdiğini"vurguladıklarıöğrenildi.	GülSG;3;PROPN;NOM,_milliADJsavunNOM;POS;IND;PRS;PFV;V;V.MSDRbakanPSS3S;3;NOM;SG;NVecdiSG;3;PROPN;NOMGönülSG;3;PROPN;NOMveCONJdışişleri3;PL;N;NOMbakanPSS3S;3;NOM;SG;NYaşarSG;3;PROPN;NOM'_,_'_genelADJbaşkanPSS3S;3;NOM;SG;NTayyipSG;3;PROPN;NOMErdoğanSG;GEN;PROPN;3,_AvrupaSG;ESS;PROPN;3,_"_TürkiyeSG;ESS;PROPN;3orduSG;GEN;N;3siyasetSG;DAT;N;3karışPSS3S;PST;IND;NEG;PFV;ACC;V.PTCP;V,_ancakCONJterörSG;GEN;N;3tırmanPSS3S;PST;POS;IND;PFV;V.PTCP;VdönemESS;PL;N;3devreSG;DAT;N;3girPSS3S;PST;POS;IND;PFV;ACC;V.PTCP;VbelirPOS;PRS;IND;V.CVB;PFV;V;CAUSyanıtSG;3;N;NOMverPSS3S;PST;POS;IND;PFV;ACC;V.PTCP;V"_vurgulaPSS3P;PST;NOM;POS;IND;PFV;V.PTCP;VöğrenPASS;PST;3;POS;IND;SG;PFV;V._
	
-Bençizmiyorum,yazıyorum.	-_benNOM;1;SG;PROçiz1;IND;PRS;INFM;SG;NEG;PROG;V,_yaz1;POS;IND;PRS;INFM;SG;PROG;V._
	
	
Yorucubirilkbahardönemiöncesindegüçtoplamak,eğlenmek,birazdakasabadabırakılanailelerlezamangeçirmekamaç.	yorIND;POS;PRS;PFV;V.PTCP;VbirNUMilkbaharSG;NOM;N;3dönemPSS3S;NOM;3;SG;NöncePSS3S;ESS;3;SG;NgüçSG;NOM;ADJ;3toplaIND;NOM;V.MSDR;POS;PRS;PFV;V,_eğleIND;NOM;V.MSDR;POS;PASS;PRS;PFV;V,_birazADVdaCONJkasabaSG;ESS;N;3bırakIND;POS;PASS;PRS;PFV;V.PTCP;VaileINS;PL;N;3zamanSG;NOM;N;3geçirIND;NOM;V.MSDR;POS;PRS;PFV;VamaçSG;NOM;N;3._
	
	
Nekadarürkütücüvebirokadardaçekicibiryerorası.	neNOM;3;PRO;SGkadarADPürkPFV;PRS;V;IND;V.PTCP;CAUS;POSveCONJbirADVoDETkadarADPdaCONJçekiciADJbirNUMyerNOM;N;3;SGoraPSS3S;PRO;NOM;SG;3._
	
	
Neymişbumakine...diyorduGülAbla.	neNOM;3;PRO;SGiPFV;V;PST;NFH;IND;SG;3buDETmakineNOM;N;3;SG..._deINFM;PST;V;IND;PROG;SG;3;POSGülNOM;PROPN;3;SGablaNOM;N;3;SG._
	
Burada...yoktum...diyekekeledi.	buraSG;ESS;PRO;3..._yokSG;3;ADJ;NOMiPST;V;1;IND;SG;PFV..._diyeADPkekelePST;3;POS;IND;SG;PFV;V._
	
Hemsonunakadarseninarkandaolacağımısöyledimya.	hemADVsonPSS3S;ADJ;SG;3;DATkadarADPsenPRO;2;SG;GENarkaPSS2S;ADJ;SG;3;ESSolacakPSS1S;ACC;ADJ;SG;3söyle1;PFV;PST;V;IND;SG;POSyaINTJ._
	
Müthişbirşeybumakine,dedim.	müthişADJbirNUMşeySG;3;N;NOMbuDETmakineSG;3;N;NOM,_dePST;1;POS;IND;SG;PFV;V._
	
İşyaşamım,aileyaşamım,ilişkilerimherşeyimiflasetmişti.	işNOM;N;3;SGyaşamPSS1S;NOM;SG;3;N,_aileNOM;N;3;SGyaşamPSS1S;NOM;SG;3;N,_ilişkiPSS1S;NOM;PL;3;NherDETşeyPSS1S;NOM;SG;3;NiflasNOM;N;3;SGetPFV;V;IND;SG;3;PST+PRF;POS._
	
Kavurupleblebiyaparlar.	kavurPFV;PRS;V;IND;POS;V.CVBleblebiNOM;N;3;SGyapHAB;PRS;V;IND;PL;3;POS._
	
Makineişte,kumarmakinesi...	makineNOM;N;3;SGişteADV,_kumarNOM;N;3;SGmakinePSS3S;NOM;SG;3;N..._
	
Laciverttakımelbiseli,kırsaçlıolanadam.	lacivertADJtakımNOM;N;3;SGelbiseNOM;N;3;SGliADP,_kırNOM;N;3;SGsaçNOM;N;3;SGliADPolPFV;PRS;V;IND;V.PTCP;POSadamNOM;N;3;SG._
	
Geliyoruz,diyerekgeldiler.	gelINFM;1;PRS;V;IND;PL;PROG;POS,_dePFV;PRS;V;IND;POS;V.CVBgelPFV;PST;V;IND;PL;3;POS._
	
BoşunaüzülüyorsunistediğinzamangelipKahve'yigörebilirsin.	boşunaADVüzINFM;PASS;PRS;2;V;IND;PROG;SG;POSistePSS2S;PFV;PST;V;IND;V.PTCP;POSzamanNOM;N;3;SGgelPFV;PRS;V;IND;POS;V.CVBKahve3;PROPN;ACC;SGgörHAB;2;PRS;V;POT;SG;POS._
	
-Buseninşalınmış.	-_buDETsenPRO;2;SG;GENşal3;N;SG;GENiPFV;V;PST;NFH;IND;SG;3._
	
Tümbunlarınaltındankalkamayacağımıanlamaklaberaberyinedekayıtsızşartsız,sankibirmeydansavaşıyapmıştıkveannembeniyendiğiiçinteslimoluyordum,pekidedim.	tümDETbu<unk>altPSS3S;3;ADJ;SG;AT+ABLkalk<unk>anlaPOS;IND;PRS;PFV;INS;V;V.MSDRberaberADPyineADVdeCONJkayıtsızADJşartsızADJ,_sankiADVbirNUMmeydanSG;3;N;NOMsavaşPSS3S;3;NOM;SG;Nyap1;POS;IND;PL;PFV;PST+PRF;VveCONJannePSS1S;3;NOM;SG;Nben1;SG;PRO;ACCyenPSS3S;PST;NOM;POS;IND;PFV;V.PTCP;ViçinADPteslimSG;3;N;NOMolPST;1;POS;IND;INFM;SG;PROG;V,_pekiADVdePST;1;POS;IND;SG;PFV;V._
	
Benonunsonaşığıyım,dedi.	ben1;PRO;NOM;SGoPRO;SG;3;GENsonADJâşıkPSS3S;NOM;SG;3;Ni1;PFV;PRS;V;IND;SG,_dePFV;PST;V;IND;SG;3;POS._
	
Sizlerideboşunaoyaladım.	sizPRO;ACC;2;PLdeCONJboşunaADVoyalaIND;PST;POS;1;PFV;SG;V._
	
Neyse,buldumbirşişetonik.	neyseADV,_bulPST;1;POS;IND;SG;PFV;VbirNUMşişeSG;3;N;NOMtonikSG;3;ADJ;NOM._
	
Cumhuriyet'intemelniteliklerindensapmayacakbirkadroyuz"karşılığınıverdi.	Cumhuriyet3;PROPN;SG;GENtemelADJnitelikPSS3S;AT+ABL;PL;3;NsapFUT;NEG;PFV;V;IND;V.PTCPbirNUMkadroNOM;N;3;SGi1;PFV;PRS;V;IND;PL"_karşılıkPSS3S;ACC;SG;3;NverPFV;PST;V;IND;SG;3;POS._
	
Belkidebirdahabulamayacağımorayı.	belkiADVdeCONJbirADVdahaADVbul<unk>ora3;ACC;PRO;SG._
	
Duyundaşaşınsiz.	duy2;POS;IMP;PRS;PFV;PL;VdaCONJşaş2;POS;IMP;PRS;PFV;PL;VsizPRO;2;NOM;PL._
	
OgünlerdeAnayasadüşkünlüğüvardıülkede.	oDETgünESS;PL;N;3anayasaSG;NOM;N;3düşkünlükPSS3S;NOM;3;SG;NvarIND;PST;POS;3;PFV;SG;VülkeSG;ESS;N;3._
	
Özeltelevizyonlardayok.	özelADJtelevizyonNOM;N;PL;3daCONJyokADV._
	
Kapıyıitipgirelimiçeriye,dedim.	kapıSG;N;ACC;3itPOS;PRS;IND;V.CVB;PFV;Vgir1;POS;PL;PRS;PFV;OPT;ViçeriSG;DAT;N;3,_dePST;1;POS;IND;SG;PFV;V._
	
Seslerivenefeslerikrizlerlegüçleniyor.	sesPSS3P;NOM;PL;3;NveCONJnefesPSS3P;NOM;PL;3;Nkriz3;N;INS;PLgüçlenINFM;PRS;V;IND;PROG;SG;3;POS._
	
BubüyümeiçinönceliklemakroekonomikistikrarınengeçikiyıliçindesağlanmasıgerektiğinedikkatçekenÖzilhan,işsizlikkonusundayalnızcabüyümeninyeterliolmadığını,aynızamandaAKP'ninistihdamınönündeyükselenduvarlarındayıkılmasıArchgerektiğinibelirtti.	buDETbüyüV.MSDR;PFV;PRS;NOM;V;IND;POSiçinADPöncelik3;N;INS;SGmakroekonomikADJistikrar3;N;SG;GENenADVgeçADVikiNUMyılNOM;N;3;SGiçPSS3S;ADJ;SG;3;ESSsağlaPSS3S;PASS;V.MSDR;PFV;PRS;NOM;V;IND;POSgerekPSS3S;PFV;PST;V;IND;V.PTCP;DAT;POSdikkatNOM;N;3;SGçekPFV;PRS;V;IND;V.PTCP;POSÖzilhanNOM;PROPN;3;SG,_işsizlikNOM;N;3;SGkonuPSS3S;SG;3;N;ESSyalnızcaADVbüyüV.MSDR;PFV;PRS;V;IND;POS;GENyeterliADJolPSS3S;NEG;ACC;PFV;PST;V;IND;V.PTCP,_aynıADJzaman3;N;ESS;SGAKP<unk>istihdam3;N;SG;GENönPSS3S;ADJ;SG;3;ESSyükselPFV;PRS;V;IND;V.PTCP;POSduvar3;N;PL;GENdaCONJyıkPSS3S;PASS;V.MSDR;PFV;PRS;NOM;V;IND;POSArchNOM;PROPN;3;SGgerekPSS3S;ACC;PFV;PST;V;IND;V.PTCP;POSbelirPFV;PST;V;IND;SG;3;CAUS;POS._
	
Bütünaklıfikriteniste.	bütünADJakılPSS3S;NOM;SG;3;NfikirPSS3S;NOM;SG;3;Ntenis3;N;ESS;SG._
	
EİEİ'yegirdi.	EİEİSG;3;N;DATgirPFV;PST;V;IND;SG;3;POS._
	
	
Kapıdışarıdanvuruluyor,hafifçeitiliyor,aralanıyor,yenidenkapanıyordu.	kapıNOM;N;3;SGdışarı3;N;SG;AT+ABLvurulINFM;PRS;V;IND;PROG;SG;3;POS,_hafifçeADVitINFM;PASS;PRS;V;IND;PROG;SG;3;POS,_aralaINFM;PASS;PRS;V;IND;PROG;SG;3;POS,_yenidenADVkapaINFM;PASS;PST;V;IND;PROG;SG;3;POS._
	
Kullanıyoramakafabulamıyordum.	kullanINFM;PRS;V;IND;PROG;SG;3;POSamaCONJkafaNOM;N;3;SGbulINFM;1;NEG;PST;V;POT;PROG;SG._
	
Aslındasakızlatemasıyok.	aslındaADVsakız3;N;INS;SGtemasPSS3S;NOM;SG;3;NyokADJ._
	
paralelbağlanabiliyor;amabirtrafikkazasındainsanlarınparalelbağlanabileceğiniilkkezduyuyorum.	paralelADJbağla<unk>;_amaCONJbirNUMtrafikNOM;N;3;SGkazaPSS3S;SG;3;N;ESSinsan3;N;PL;GENparalelADJbağlaPSS3S;FUT;PASS;ACC;PFV;V;POT;V.PTCP;POSilkADJkezNOM;N;3;SGduyINFM;1;PRS;V;IND;PROG;SG;POS._
	
Sorunnealacağımız.	sorunSG;NOM;N;3neSG;PRO;NOM;3al<unk>._
	
	
Onkilometrelikbuzgeçişindenöncesonbirkezmolaverilecektiburada.	onNUMkilometreSG;3;N;NOMlikADPbuzSG;3;N;NOMgeçişPSS3S;3;SG;N;AT+ABLönceADPsonADJbirNUMkezSG;3;N;NOMmolaSG;3;N;NOMver<unk>buraSG;ESS;PRO;3._
	
Benbirhizmetinsanıyım,söylerim,söylediğiminarkasındangiderimvebananeyemalolursaolsunbenbununlaiftiharederim.	ben1;PRO;NOM;SGbirNUMhizmetNOM;N;3;SGinsanPSS3S;NOM;SG;3;Ni1;PFV;PRS;V;IND;SG,_söyle1;HAB;PRS;V;IND;SG;POS,_söylePSS1S;GEN;PFV;PST;V;IND;V.PTCP;POSarkaPSS3S;AT+ABL;ADJ;SG;3git1;HAB;PRS;V;IND;SG;POSveCONJben1;PRO;SG;DATne3;DAT;PRO;SGmalNOM;N;3;SGolCOND;HAB;PRS;V;SG;3;POSolPFV;PRS;V;SG;3;IMP;POSben1;PRO;NOM;SGbuPRO;INS;SG;3iftiharNOM;N;3;SGet1;HAB;PRS;V;IND;SG;POS._
	
Hiçkonuşmasanızdaaklınızdangeçirdiğinizherşeyduyulacak.	hiçADVkonuşNEG;COND;PFV;PRS;2;V;PLdaCONJakılPSS2P;AT+ABL;SG;3;NgeçirPSS2P;PFV;PST;V;IND;V.PTCP;POSherDETşeyNOM;N;3;SGduyFUT;PASS;PFV;V;IND;SG;3;POS._
	
Oysakıçlarınıkaldırmazahmetinekatlansalardıkendilerinebıraktığımdosyadayapacağımdeneylerinüremeorganlarıylailgiliolduğunu,gönderilecekkadavranıncinsiyetinindeönemledişiolmasıgerektiğinigörebilirlerdi.	oysaCONJkıçPSS3S;ACC;PL;3;NkaldırmaNOM;N;3;SGzahmetPSS3S;SG;3;N;DATkatlan<unk>kendiPSS3P;REFL;PRO;PL;3;DATbırakPSS1S;PFV;PST;V;IND;V.PTCP;POSdosya3;N;ESS;SGyap<unk>deney3;N;PL;GENüreV.MSDR;PFV;PRS;NOM;V;IND;POSorganPSS3S;INS;PL;3;NilgiliADJolPSS3S;ACC;PFV;PST;V;IND;V.PTCP;POS,_gönderFUT;PASS;PFV;V;IND;V.PTCP;POSkadavra3;N;SG;GENcinsiyetPSS3S;GEN;SG;3;NdeCONJönem3;N;INS;SGdişiNOM;ADJ;3;SGolPSS3S;V.MSDR;PFV;PRS;NOM;V;IND;POSgerekPSS3S;ACC;PFV;PST;V;IND;V.PTCP;POSgör<unk>._
	
Banasarılmış.	ben1;PRO;SG;DATsarPASS;PFV;PST;V;NFH;IND;SG;3;POS._
	
ikibinüçyılınınilküçayınailişkingeçicibütçetasarısıTBMMGenelKurulu'ndayüzyirmialtıoyakarşılıküçyüzyirmiyedioylakabuledildi.	ikibinüçNUMyılPSS3S;GEN;3;SG;NilkADVüçNUMayPSS3S;3;DAT;SG;NilişkinADPgeçiciADJbütçeSG;NOM;N;3tasarıPSS3S;NOM;3;SG;NTbmmSG;NOM;PROPN;3genelADJkurulPSS3S;ESS;3;SG;NyüzyirmialtıNUMoySG;DAT;N;3karşılıkSG;NOM;N;3üçyüzyirmiyediNUMoySG;INS;N;3kabulSG;NOM;N;3etIND;PST;POS;3;PASS;PFV;SG;V._
	
İyiakşamlar...	iyiADJakşamNOM;N;PL;3..._
	
Çekdedik.	çekNOM;N;3;SGde1;PFV;PST;V;IND;PL;POS._
	
Müşterilerdokunmayısever.	müşteri3;PL;N;NOMdokunPOS;IND;PRS;PFV;ACC;V;V.MSDRsev3;POS;IND;PRS;SG;V;HAB._
	
Dalgalısaçlarıdümdüztaralıydı.	dalgaNOM;N;3;SGliADPsaçPSS3S;NOM;PL;3;NdümdüzADJtaralıNOM;ADJ;3;SGiPFV;V;PST;IND;SG;3._
	
Anladımkibutaşınmakararımdanhoşnut,doğallaştırıpsıradanlaştırmayaçalışıyor,amanafile,benbaşlayacakbuyeniberaberliğintazeheyecanınıbastıracakhaldedeğilim.	anla1;PFV;PST;V;IND;SG;POSkiCONJbuDETtaşınmaNOM;N;3;SGkararPSS1S;AT+ABL;SG;3;NhoşnutADJ,_doğallaşPFV;PRS;V;IND;CAUS;POS;V.CVBsıradanlaşV.MSDR;PFV;PRS;V;IND;CAUS;DAT;POSçalışINFM;PRS;V;IND;PROG;SG;3;POS,_amaCONJnafileADJ,_ben1;PRO;NOM;SGbaşlaFUT;PFV;V;IND;V.PTCP;POSbuDETyeniADJberaberlik3;N;SG;GENtazeADJheyecanPSS3S;ACC;SG;3;NbasFUT;PFV;V;IND;V.PTCP;CAUS;POShal3;N;ESS;SGdeğil1;NEG;PFV;PRS;V;IND;SG._
	
Hadiabikapagözünü,açdemedenaçmakyokha!..	hadiINTJabiNOM;N;3;SGkapaPFV;PRS;2;V;SG;IMP;POSgözPSS2S;ACC;SG;3;N,_açPFV;PRS;2;V;SG;IMP;POSdeNEG;PFV;PRS;V;IND;V.CVBaçV.MSDR;PFV;PRS;NOM;V;IND;POSyokADJhaINTJ!_.._
	
Birazdatelaşlandığımıitirafetmeliyim.	birazADVdaCONJtelaşlanPSS1S;ACC;PFV;PST;V;IND;V.PTCP;POSitirafNOM;N;3;SGet1;PFV;PRS;V;SG;POS._
	
Onlarbunlar.	oPRO;NOM;PL;3buPRO;NOM;PL;3._
	
Öylegeçeryaşam.	öyleADVgeçHAB;PRS;V;IND;SG;3;POSyaşamNOM;N;3;SG._
	
Taşhan'ınduvarınayaslandı.	Taşhan3;PROPN;SG;GENduvarPSS3S;SG;3;N;DATyaslaPASS;PFV;PST;V;IND;SG;3;POS._
	
Geçicibütçetasarısı,Meclis'esunuldu.	geçiciADJbütçeNOM;N;3;SGtasarıPSS3S;NOM;SG;3;N,_Meclis3;PROPN;DAT;SGsunPASS;PFV;PST;V;IND;SG;3;POS._
	
Çoğuluçoğulyapmayıanlamam.	çoğul3;ACC;ADJ;SGçoğulADJyapV.MSDR;ACC;PFV;PRS;V;IND;POSanla1;NEG;HAB;PRS;V;IND;SG._
	
Elinisolcebinesokupbirfotoğrafçıkarttı,uzunuzunbaktı.	elPSS3S;ACC;SG;3;NsolNOM;ADJ;3;SGcepPSS3S;SG;3;N;DATsokPFV;PRS;V;IND;POS;V.CVBbirNUMfotoğrafNOM;N;3;SGçıkarPFV;PST;V;IND;SG;3;CAUS;POS,_uzunADJuzunADJbakPFV;PST;V;IND;SG;3;POS._
	
Baksanaçocuknasılçırpınıyor.	bak<unk>çocukSG;3;N;NOMnasılADVçırpın3;POS;IND;PRS;INFM;SG;PROG;V._
	
Yarayabilir.	yaraHAB;PRS;V;POT;SG;3;POS._
	
	
Dipseviyelerdeseyredenborsadaiseyükselişinbaşlamasıdurumundaciddibirgetiriimkanıbulunuyor.	dipSG;NOM;N;3seviyeESS;PL;N;3seyretIND;POS;PRS;PFV;V.PTCP;VborsaSG;ESS;N;3iVyükselişGEN;SG;N;3başlaPSS3S;IND;NOM;V.MSDR;POS;PFV;PRS;VdurumPSS3S;ESS;3;SG;NciddiADJbirNUMgetiriSG;NOM;N;3imkanPSS3S;NOM;3;SG;NbulINFM;IND;POS;3;PASS;PRS;SG;PROG;V._
	
Bizbukadarız?	biz1;PRO;NOM;PLbuDETkadarADPi1;PFV;PRS;V;IND;PL?_
	
Fıkırfıkırsesinibeklerken,kart,öksürüklüses:Benim?Tanımadı.	fıkır_fıkır_sesPSS3S;ACC;3;SG;NbekleIND;POS;3;PRS;SG;V.CVB;HAB;V,_kartADJ,_öksürükSG;NOM;N;3liADPsesSG;NOM;N;3:_benPRO;NOM;1;SGiV;IND;1;PRS;PFV;SG?_tanıNEG;IND;PST;3;PFV;SG;V._
	
Aşırıiddialılar.	aşırıADJiddiaSG;3;N;NOMliADPiV;3;IND;PL;PRS;PFV._
	
Şimdivarırızoraya,dediKerem.	şimdiADVvar1;HAB;PRS;V;IND;PL;POSora3;DAT;PRO;SG,_dePFV;PST;V;IND;SG;3;POSKeremNOM;PROPN;3;SG._
	
Artıkbirbirimizinsinyalleriniçokiyitanıyoruz.	artıkADVbirbiri<unk>sinyalPSS3P;ACC;PL;3;NçokADViyiADJtanıINFM;1;PRS;V;IND;PL;PROG;POS._
	
Onlarlabakirelikleriortadankaldırılmaksızınyapılansevişmeler.	on<unk>bakirelikACC;PL;N;3ortaAT+ABL;SG;ADJ;3kalNEG;IND;PRS;PFV;V.CVB;VyapIND;POS;PASS;PRS;PFV;V.PTCP;VsevişIND;NOM;V.MSDR;POS;PRS;PFV;V._
	
Bilgiye,yeniaskeriaraçlarıngeliştirilmesivedevletdüzenininsağlamlaştırılmasınınaracıgözüylebakanRoma,teoriyi,vakitkaybındanbaşkabirişeyaramayanbiretkinliksayarakhorgörmüştür.	bilgi3;N;DAT;SG,_yeniADJaskeriADJaraç3;N;PL;GENgelişPSS3S;V.MSDR;PFV;PRS;NOM;V;IND;POSveCONJdevletNOM;N;3;SGdüzenPSS3S;GEN;SG;3;NsağlamlaşPSS3S;GEN;V.MSDR;PFV;PRS;V;IND;POSaraçPSS3S;NOM;SG;3;NgözPSS3S;INS;SG;3;NbakPFV;PRS;V;IND;V.PTCP;POSRomaNOM;PROPN;3;SG,_teori3;N;ACC;SG,_vakitNOM;N;3;SGkayıpPSS3S;AT+ABL;ADJ;SG;3başkaADPbirNUMiş3;N;DAT;SGyarNEG;PFV;PRS;V;POT;V.PTCPbirNUMetkinlikNOM;N;3;SGsayPFV;PRS;V;IND;POS;V.CVBhorADJgörPFV;PST;V;NFH;SG;3;POS._
	
Boğaz'ınsularıdasabahındinginliğineuymuş,ağırkıpırtılarlaakıyordu.	Boğaz3;PROPN;SG;GENsu3;N;PL;ACCdaCONJsabah3;N;SG;GENdinginlikPSS3S;SG;3;N;DATuyPFV;PST;V;NFH;IND;SG;3;POS,_ağırADJkıpırtı3;N;INS;PLakINFM;PST;V;IND;PROG;SG;3;POS._
	
Acıiçinde,çaresiz.	acıSG;NOM;ADJ;3içPSS3S;ESS;3;SG;ADJ,_çaresizADJ._
	
Ayhan,AnkaraAtatürkLisesi'nibitirdi.	AyhanSG;3;PROPN;NOM,_AnkaraSG;3;PROPN;NOMAtatürkSG;3;PROPN;NOMlisePSS3S;3;SG;N;ACCbitirPST;3;POS;IND;SG;PFV;V._
	
Buraporunbirtürlüdeşifresiniyaptıramadığınısöyledi.	buDETrapor3;N;SG;GENbirNUMtürlüADJdeşifrePSS3S;ACC;ADJ;SG;3yap<unk>söylePFV;PST;V;IND;SG;3;POS._
	
Rahibedeğila...	rahibeNOM;N;3;SGdeğilCONJaINTJ..._
	
Anlattığınagöre,EvenlerinatalarıBaykalGölü'nündağlıkveormanlıkdoğubölgesi,AmurNehriHavzasıveMançuryacivarındayaşıyordu.	anla<unk>göreADP,_Evenler3;PROPN;SG;GENataPSS3P;NOM;PL;3;NBaykalNOM;PROPN;3;SGgölPSS3S;GEN;SG;3;NdağNOM;N;3;SGlikNOM;ADP;3;SGveCONJormanNOM;N;3;SGlikNOM;ADP;3;SGdoğuNOM;ADJ;3;SGbölgePSS3S;NOM;SG;3;N,_AmurNOM;PROPN;3;SGnehirPSS3S;NOM;SG;3;NhavzaPSS3S;NOM;SG;3;NveCONJMançuryaNOM;PROPN;3;SGcivarPSS3S;SG;3;N;ESSyaşaINFM;PST;V;IND;PROG;SG;3;POS._
	
Bakınsoluksoluğakaldınız.	bakPFV;PRS;2;V;PL;IMP;POSsolukADJsoluk3;ADJ;DAT;SGkalPFV;2;PST;V;IND;PL;POS._
	
Kenttenikimikrofonla,gerekliötekiaygıtlarıgetirtmişti.	kent3;N;SG;AT+ABLikiNUMmikrofon3;N;INS;SG,_gerekliADJötekiNOM;N;3;SGaygıt3;N;PL;ACCgetirtPFV;V;IND;SG;3;PST+PRF;POS._
	
İşte,işteokadın!Mahmut'unşimdidüşündüğü.	işteADV,_işteADVoDETkadınNOM;ADJ;3;SG!_Mahmut3;PROPN;SG;GENşimdiADVdüşünPSS3S;PFV;PST;V;IND;V.PTCP;POS._
	
Dahaetkinbirdenetimyapacağız.	dahaADVetkinADJbirNUMdenetimSG;NOM;N;3yapIND;POS;1;FUT;PFV;PL;V._
	
Ancak,duvarlarınboşluğusınırlandırması,heryapıda,özellikleevde,ohacmimekanlaştırmaz.	ancakADV,_duvar3;N;PL;GENboşlukPSS3S;NOM;SG;3;Nsınırlan<unk>,_herDETyapı3;N;ESS;SG,_özellikleADVev3;N;ESS;SG,_oDEThacim3;N;ACC;SGmekanlaşNEG;HAB;PRS;V;IND;SG;3;CAUS._
	
BizimCumhuriyetBebeleri60'lıyıllarınbaşındakonmuşbirisimolaraknekadarçokşeyanlatıyormuş.	biz1;PL;PRO;GENcumhuriyetSG;3;N;NOMbebePSS3S;3;NOM;PL;N603;NOM;SG;NUMliADPyıl3;GEN;N;PLbaşPSS3S;3;SG;N;ESSkonPST;POS;IND;PFV;V.PTCP;V;NFHbirNUMisimSG;3;N;NOMolarakADPneSG;3;PRO;NOMkadarADPçokADJşeySG;3;N;NOManlat<unk>._
	
Annemesorsanhiçözlemediğinisöyler;amabenceherkesbirbiriniarıyor.	annePSS1S;SG;3;N;DATsorCOND;PFV;PRS;2;V;SG;POShiçADVözlePSS3S;NEG;ACC;PFV;PST;V;IND;V.PTCPsöyleHAB;PRS;V;IND;SG;3;POS;_amaCONJben1;PRO;SG;EQTVherkesNOM;N;3;SGbirbiriPSS3S;PRO;ACC;SG;3araINFM;PRS;V;IND;PROG;SG;3;POS._
	
Annemonuniçinözelyemekkabı,özelelbezi-dahadoğrusuağızsilmebezi-özelörtü,özelpaspasgibitümeşyalarıhazırlamıştı.	annePSS1S;NOM;SG;3;NoPRO;SG;3;GENiçinADPözelADJyemekNOM;N;3;SGkapPSS3S;NOM;SG;3;N,_özelADJelNOM;N;3;SGbezPSS3S;NOM;ADJ;SG;3-_dahaADVdoğruPSS3S;NOM;ADJ;SG;3ağızNOM;N;3;SGsilV.MSDR;PFV;PRS;NOM;V;IND;POSbezPSS3S;NOM;ADJ;SG;3-_özelADJörtüNOM;N;3;SG,_özelADJpaspasNOM;N;3;SGgibiADPtümDETeşyaPSS3S;NOM;PL;3;NhazırlaPFV;V;IND;SG;3;PST+PRF;POS._
	
Tedbirlerpaketinde,süreklivegeçiciişçilerinmemuriyetekaydırılmasıyöntemiyleikibinüçyılındayüzdoksanbeştrilyonliratasarrufsağlanmasıdahedefleniyor.	tedbir3;PL;N;NOMpaketPSS3S;3;SG;N;ESS,_sürekliADVveCONJgeçiciADJişçi3;GEN;N;PLmemuriyetSG;DAT;N;3kayPSS3S;V.MSDR;NOM;POS;IND;PRS;PFV;VyöntemPSS3S;3;SG;N;INSikibinüç3;NOM;SG;NUMyılPSS3S;3;SG;N;ESSyüzdoksanbeşNUMtrilyonNUMliraSG;3;N;NOMtasarrufSG;3;N;NOMsağlaPSS3S;V.MSDR;PASS;NOM;POS;IND;PRS;PFV;VdaCONJhedeflePASS;3;POS;IND;PRS;INFM;SG;PROG;V._
	
Nedenonlarazintiharedipçokyaşarlar.	ne3;SG;PRO;AT+ABLoPRO;NOM;PL;3azADVintiharNOM;N;3;SGetPFV;PRS;V;IND;POS;V.CVBçokADVyaşaHAB;PRS;V;IND;PL;3;POS._
	
Herkesonunpeşinde.	herkesNOM;N;3;SGoPRO;SG;3;GENpeşPSS3S;SG;3;N;ESS._
	
Yutturmaca.	yutturmacaSG;3;N;NOM._
	
Neduruyorsun...	neNOM;3;PRO;SGdurINFM;PRS;2;V;IND;PROG;SG;POS..._
	
Gidiyoruz,gelin.	gitINFM;1;PRS;V;IND;PL;PROG;POS,_gelPFV;PRS;2;V;PL;IMP;POS._
	
Artıksavınışöyledüzeltmeyiöneriyorum:Deneyselvegözlemseliçeriktenyoksunolanbirbilimselkuram,kendiiçindetutarlıdaolsamantıksalolarakzayıftır,metafiziktir.	artıkADJsavPSS2S;ACC;SG;3;NşöyleADVdüzelV.MSDR;ACC;PFV;PRS;V;IND;CAUS;POSönerINFM;1;PRS;V;IND;PROG;SG;POS:_deneyselADJveCONJgözlemselADJiçerik3;N;SG;AT+ABLyoksunADJolPFV;PRS;V;IND;V.PTCP;POSbirNUMbilimselADJkuramNOM;N;3;SG,_kendiPSS3S;REFL;PRO;NOM;SG;3içPSS3S;ADJ;SG;3;ESStutarlıADJdaCONJolCOND;PFV;PRS;V;SG;3;POSmantıksalADJolarakADPzayıfNOM;ADJ;3;SGiPFV;PRS;V;SG;3,_metafizikNOM;ADJ;3;SGiPFV;PRS;V;SG;3._
	
Doğrususizeyardımedebilmekisterdim,dediJul.	doğruPSS3S;NOM;ADJ;SG;3sizPRO;2;PL;DATyardımNOM;N;3;SGetV.MSDR;PFV;PRS;NOM;V;POT;POSiste1;HAB;PST;V;IND;SG;POS,_dePFV;PST;V;IND;SG;3;POSjulNOM;N;3;SG._
	
Hiçböyledüşünmemiştim,doğrusubugünekadarhiçböyledüşünmemiştim.	hiçADVböyleADVdüşün<unk>,_doğruPSS3S;NOM;ADJ;SG;3bugün3;N;DAT;SGkadarADPhiçADVböyleADVdüşün<unk>._
	
TunguzlarınonbirkolundanbiriEvenler.	tunguzPSS2S;NOM;PL;3;NonNUMbirNUMkolPSS3S;AT+ABL;SG;3;NbirACC;SG;3;NUMEvenlerNOM;PROPN;3;SG._
	
Fotokopiçekmeyasağıkondu.	fotokopiNOM;N;3;SGçekV.MSDR;PFV;PRS;NOM;V;IND;POSyasakPSS3S;NOM;ADJ;SG;3konPFV;PST;V;IND;SG;3;POS._
	
Enuzunbirlikteliğimizsofrabaşındaoluyor.	enADVuzunADJbirliktelikPSS1P;NOM;SG;3;NsofraNOM;N;3;SGbaşPSS3S;SG;3;N;ESSolINFM;PRS;V;IND;PROG;SG;3;POS._
	
Beniyemebemoruk,dedim,nepanayırlarkuruldubukasabaya,amahiçbirzamanaslangelmedi.	benPSS3S;NOM;SG;3;NyeNEG;PFV;PRS;2;V;SG;IMPbeINTJmorukNOM;N;3;SG,_de1;PFV;PST;V;IND;SG;POS,_neADJpanayırNOM;N;PL;3kurPASS;PFV;PST;V;IND;SG;3;POSbuDETkasaba3;N;DAT;SG,_amaCONJhiçbirDETzamanNOM;N;3;SGaslanNOM;ADJ;3;SGgelNEG;PFV;PST;V;IND;SG;3._
	
Süpürgennerede.	süpürgePSS2S;NOM;SG;3;Nnere3;ESS;PRO;SG._
	
	
-Ençokhangisiniseviyorsun.	-_enADVçokADVhangiPSS3S;ACC;3;SG;DETsevINFM;PRS;2;V;IND;PROG;SG;POS._
	
Onlarındallardanyolupyolupattığıerikleriönlüğündekitorbayadolduruyordu.	oPRO;PL;3;GENdal3;N;PL;AT+ABLyolPFV;PRS;V;IND;POS;V.CVByolPFV;PRS;V;IND;POS;V.CVBatPSS3S;PFV;PST;V;IND;V.PTCP;POSerikPSS3P;NOM;PL;3;NönlükPSS3S;SG;3;N;ESSkiADPtorba3;N;DAT;SGdolINFM;PST;V;IND;PROG;SG;3;CAUS;POS._
	
İddialıoldukçadeğerkazandıklarınıdüşünüyorlar.	iddiaNOM;N;3;SGliADPolPFV;PRS;V;IND;POS;V.CVBdeğerNOM;N;3;SGkazanPSS3P;ACC;PFV;PST;V;IND;V.PTCP;POSdüşünINFM;PRS;V;IND;PL;PROG;3;POS._
	
Yalınbirkişiliğivardır.	yalınADJbirNUMkişilikPSS3S;NOM;SG;3;NvarNOM;ADJ;3;SGiPFV;PRS;V;SG;3._
	
Yetmiyor,yinefavorimaddesineyöneliyor.	yetINFM;NEG;PRS;V;IND;PROG;SG;3,_yineADVfavoriADJmaddePSS3S;SG;3;N;DATyönelINFM;PRS;V;IND;PROG;SG;3;POS._
	
Onunevininbulunduğusokağınköşesindeki,oikikatlı,güzelkahvedeoturuyorduk.	oPRO;GEN;3;SGevPSS3S;GEN;3;SG;NbulunPSS3S;IND;PST;POS;PFV;V.PTCP;VsokakGEN;SG;N;3köşePSS3S;ESS;3;SG;NkiADP,_oPRO;NOM;3;SGikiNUMkatSG;NOM;N;3liADP,_güzelADJkahveSG;ESS;N;3oturINFM;IND;PST;POS;1;PROG;PL;V._
	
Gecekonduyapmakiçinparabiriktiriyor.	gecekonduNOM;N;3;SGyapV.MSDR;PFV;PRS;NOM;V;IND;POSiçinADPparaNOM;N;3;SGbirikINFM;PRS;V;IND;PROG;SG;3;CAUS;POS._
	
Birçokdurumdaonlarınsatınalmayacaklarıbirşeyebakmalarınısağlamakçokzordur.	birçokDETdurum3;N;ESS;SGoPRO;PL;3;GENsatınADVal<unk>birşey3;N;DAT;SGbakPSS3P;V.MSDR;ACC;PFV;PRS;V;IND;POSsağlaV.MSDR;PFV;PRS;NOM;V;IND;POSçokADJzorNOM;ADJ;3;SGiPFV;PRS;V;SG;3._
	
Şakirolduğuyerdenayağakalkmıştı.	ŞakirSG;3;PROPN;NOMolPSS3S;PST;POS;IND;PFV;V.PTCP;VyerSG;AT+ABL;N;3ayakSG;DAT;N;3kalk3;POS;IND;SG;PFV;PST+PRF;V._
	
Buaradaufaklığıveeşyalarınıtemiztutmak,evdeusludurmasınısağlamak,veterineregötürmekgibigörevlerdebanaaitti.	buDETaraSG;ESS;ADJ;3ufaklıkSG;N;ACC;3veCONJeşyaPSS3S;3;PL;N;ACCtemizADJtutNOM;POS;IND;PRS;PFV;V;V.MSDR,_evSG;ESS;N;3usluADJdurPSS3S;V.MSDR;POS;IND;PRS;PFV;ACC;VsağlaNOM;POS;IND;PRS;PFV;V;V.MSDR,_veterinerSG;DAT;N;3götürNOM;POS;IND;PRS;PFV;V;V.MSDRgibiADPgörev3;PL;N;NOMdeCONJbenDAT;1;SG;PROaitADPiPST;V;3;IND;SG;PFV._
	
Kızıllasiyaharası.	kızıl3;INS;ADJ;SGsiyahADJaraPSS3S;NOM;ADJ;SG;3._
	
Ayağımıza,bacağımıza,çenemize,hayatımıza,birhareketgeldi,birhareket...	ayakPSS1P;SG;3;N;DAT,_bacakPSS1P;SG;3;N;DAT,_çenePSS1P;SG;3;N;DAT,_hayatPSS1P;SG;3;N;DAT,_birNUMhareketNOM;N;3;SGgelPFV;PST;V;IND;SG;3;POS,_birNUMhareketNOM;N;3;SG..._
	
Mutluluğunuzunsürmedi,biryılboyuncakafandauzunsiyahbirperukladolaşıpdurdun.	mutlulukPSS2S;NOM;3;SG;NuzunADJsürNEG;IND;PST;3;PFV;SG;V,_birNUMyılSG;NOM;N;3boyuncaADPkafaPSS2S;ESS;3;SG;NuzunADJsiyahADJbirNUMperukSG;INS;N;3dolaşIND;POS;PRS;PFV;V.CVB;Vdur2;IND;PST;POS;PFV;SG;V._
	
Kasten.	kastenADV._
	
Eriklerdenbaşlarıdönmüştü.	erik3;N;PL;AT+ABLbaş3;N;PL;ACCdönPFV;V;IND;SG;3;PST+PRF;POS._
	
Kıraathaneninkapısıgıcırdayarakaçıldı.	kıraathane3;N;SG;GENkapıPSS3S;NOM;SG;3;NgıcırdaPFV;PRS;V;IND;POS;V.CVBaçPASS;PFV;PST;V;IND;SG;3;POS._
	
	
BuTürkiyeKuzeyKıbrıs'tanvazgeçenekadarsürecek.	buPRO;NOM;SG;3TürkiyeNOM;PROPN;3;SGkuzeyADJKıbrıs3;PROPN;SG;AT+ABLvazgeçPFV;PRS;V;IND;V.PTCP;SG;3;DAT;POSkadarADPsürFUT;PFV;V;IND;SG;3;POS._
	
BudurumYapıKredihisseleriüzerindebaskıyaratarakmalisektörhisseleriniolumsuzyöndeetkileyebilir.	buDETdurumNOM;N;3;SGyapıNOM;N;3;SGkrediNOM;N;3;SGhissePSS3S;NOM;PL;3;NüzerPSS3S;SG;3;N;ESSbaskıNOM;N;3;SGyaratPFV;PRS;V;IND;POS;V.CVBmaliADJsektörNOM;N;3;SGhissePSS3S;ACC;PL;3;NolumsuzADJyön3;N;ESS;SGetkileHAB;PRS;V;POT;SG;3;POS._
	
ÖnceleriRusya'dabaşlamışlardıişe.	önceleriADVRusyaSG;ESS;PROPN;3başlaIND;POS;3;PFV;PST+PRF;PL;VişSG;DAT;N;3._
	
KemalAyla'ya,Sulandırma,dedi.	KemalSG;3;PROPN;NOMAylaSG;DAT;PROPN;3,_SulanPRS;IMP;SG;NEG;PFV;2;V;CAUS,_dePST;3;POS;IND;SG;PFV;V._
	
Memurmaaşıyüzdeonoranındaartırılırsa,buotuzaltımilyondörtyüzseksensekizbinliralıkzamanlamınagelecek.	memurSG;NOM;N;3maaşPSS3S;NOM;3;SG;NyüzNUM;ESS;3;SGonNUMoranPSS3S;ESS;3;SG;NartırCOND;POS;3;PASS;PRS;SG;HAB;V,_buDETotuzaltıNUMmilyonNUMdörtyüzseksensekizNUMbinNUMliraSG;NOM;N;3likADPzamSG;NOM;N;3anlamPSS3S;3;DAT;SG;NgelIND;POS;3;FUT;PFV;SG;V._
	
OrasıSubayEvleriya.	oraPSS3S;PRO;NOM;3;SGSubaySG;NOM;PROPN;3evPSS3S;NOM;3;PL;NyaINTJ._
	
İngiliz'inneişivarorada?	İngilizGEN;SG;ADJ;3neSG;PRO;NOM;3işPSS3S;NOM;3;SG;NvarADJoraSG;PRO;ESS;3?_
	
Nasıldazorluyorkapıyı...	nasılADVdaCONJzorlaINFM;PRS;V;IND;PROG;SG;3;POSkapı3;N;ACC;SG..._
	
	
Birincisipervanebuzlanmasındanbahsediyordu.	birPSS3S;NOM;SG;3;NUMpervaneNOM;N;3;SGbuzlanPSS3S;V.MSDR;AT+ABL;PFV;PRS;V;IND;POSbahsetINFM;PST;V;IND;PROG;SG;3;POS._
	
	
OsonaHülya'yıoturtupkaçgeceuykumdanfırlamıştım.	oPRO;NOM;3;SGsonADJaINTJHülyaACC;SG;PROPN;3oturCAUS;IND;POS;PRS;PFV;V.CVB;VkaçNUMgeceSG;NOM;N;3uykuPSS1S;AT+ABL;3;SG;NfırlaIND;POS;1;PFV;SG;PST+PRF;V._
	
Bumakinesenialdatmakiçinorayayerleştirilmiş.	buDETmakineNOM;N;3;SGsenPRO;ACC;2;SGaldatV.MSDR;PFV;PRS;NOM;V;IND;POSiçinADPora3;DAT;PRO;SGyerleşPFV;PST;V;NFH;IND;SG;3;POS._
	
Oğlunuzunöleceğini,sizdenönceölebileceğinidüşünüyorsunuz.	oğulPSS2P;GEN;3;SG;NölPSS3S;ACC;IND;POS;FUT;PFV;V.PTCP;V,_siz<unk>önceADPölPSS3S;POT;ACC;POS;FUT;PFV;V.PTCP;VdüşünINFM;2;IND;POS;PROG;PRS;PL;V._
	
Klasiksüreçbaşladı...	klasikADJsüreçSG;NOM;N;3başlaIND;PST;POS;3;PFV;SG;V..._
	
Cinselçekim...diyemırıldandıadam.	cinselADJçekimNOM;N;3;SG..._diyeADPmırıldanPFV;PST;V;IND;SG;3;POSadamNOM;N;3;SG._
	
Kitaplareskimemiştibelki.	kitapNOM;N;PL;3eskiNEG;PFV;V;IND;SG;3;PST+PRFbelkiADV._
	
Havuzunbaşınaoturmuştuk.	havuzSG;GEN;N;3başPSS3S;DAT;3;SG;Notur1;POS;IND;PL;PFV;PST+PRF;V._
	
Yüzbinkağıtvermiş!...	yüzNUMbinNUMkağıtNOM;ADJ;3;SGverPFV;PST;V;NFH;IND;SG;3;POS!_..._
	
Evet.	evetSG;3;N;NOM._
	
Banahissettirirbunu.	ben1;PRO;SG;DAThissetHAB;PRS;V;IND;SG;3;CAUS;POSbuPRO;ACC;SG;3._
	
Sadecebazıkonulardauzmanlığıolanbirveyabirkaçarkadaşmisafirolarakaramızakatılıyordu.	sadeceADVbazıDETkonuESS;PL;N;3uzmanlıkPSS3S;NOM;3;SG;NolIND;POS;PRS;PFV;V.PTCP;VbirNUMveyaCONJbirkaçDETarkadaşSG;NOM;N;3misafirSG;NOM;N;3olarakADPara<unk>katINFM;IND;PST;POS;3;PASS;SG;PROG;V._
	
"Mülklerimiziçin'gaspedildi'diyebiliriz.	"_mülkPSS1P;NOM;PL;3;NiçinADP'_gaspNOM;N;3;SGetPASS;PFV;PST;V;IND;SG;3;POS'_de1;HAB;PRS;V;POT;PL;POS._
	
Dizininbirsonrakiöğesibiröncekindendahaiyidir.	diziSG;GEN;N;3birNUMsonrakiADJöğePSS3S;3;NOM;SG;NbirNUMönceSG;3;N;NOMki<unk>dahaADViyiSG;3;ADJ;NOMiV;3;PRS;SG;PFV._
	
Kalkmayahazırlananmasadakiikigençkadınınayaklarınınoynamayabaşladığını,incehırkalarınınaltındaomuzlarınıntitrediğini,parmaklarınıntempotuttuğunugördü,sevindi.	kalkV.MSDR;PFV;PRS;V;IND;DAT;POShazırlanPFV;PRS;V;IND;V.PTCP;POSmasa3;N;ESS;SGkiADPikiNUMgençADJkadı3;N;SG;GENayakPSS3P;PL;3;N;GENoynaV.MSDR;PFV;PRS;V;IND;DAT;POSbaşlaPSS3S;ACC;PFV;PST;V;IND;V.PTCP;POS,_inceADJhırkaPSS3P;PL;3;N;GENaltPSS3S;ADJ;SG;3;ESSomuzPSS3P;PL;3;N;GENtitrePSS3S;ACC;PFV;PST;V;IND;V.PTCP;POS,_parmakPSS3P;PL;3;N;GENtempoNOM;N;3;SGtutPSS3S;ACC;PFV;PST;V;IND;V.PTCP;POSgörPFV;PST;V;IND;SG;3;POS,_sevinPFV;PST;V;IND;SG;3;POS._
	
	
Yinecevapvermesinefırsatbırakmadan,Birerkekgibideğilyani,erkekleryalnızcasevişebilmekiçinyalansöyleyebilir,amaseviştiktensonrasevebilir,bundansonraiseyalansöylemez.	yineADVcevapNOM;N;3;SGverPSS3S;V.MSDR;PFV;PRS;V;IND;DAT;POSfırsatNOM;N;3;SGbırakNEG;PFV;PRS;V;IND;V.CVB,_birNUMerkekNOM;ADJ;3;SGgibiADPdeğilNEG;PFV;PRS;V;IND;SG;3yaniCONJ,_erkekNOM;ADJ;PL;3yalnızcaADVsevişV.MSDR;PFV;PRS;NOM;V;POT;POSiçinADPyalanNOM;ADJ;3;SGsöyleHAB;PRS;V;POT;SG;3;POS,_amaCONJsevişAT+ABL;PFV;PST;V;IND;V.PTCP;POSsonraADPsevHAB;PRS;V;POT;SG;3;POS,_buPRO;AT+ABL;SG;3sonraADPiVyalanNOM;ADJ;3;SGsöyleNEG;HAB;PRS;V;IND;SG;3._
	
HergünkırmızıMersedesibekleyeceğim,dediMemoheyecanla.	herDETgünNOM;N;3;SGkırmızıADJMersedes3;PROPN;ACC;SGbekleFUT;1;PFV;V;IND;SG;POS,_dePFV;PST;V;IND;SG;3;POSMemoNOM;PROPN;3;SGheyecan3;N;INS;SG._
	
Görürüzbakalım,yarınoarabayıkimsilecek,diyetehditlersavurarakuzaklaştıdiğersiliciler.	gör1;HAB;PRS;V;IND;PL;POSbak1;OPT;PFV;PRS;V;PL;POS,_yarınNOM;N;3;SGoDETaraba3;N;ACC;SGkimNOM;3;PRO;SGsilFUT;PFV;V;IND;SG;3;POS,_diyeADPtehditNOM;N;PL;3savurPFV;PRS;V;IND;POS;V.CVBuzaklaşPFV;PST;V;IND;SG;3;POSdiğerADJsiliciNOM;N;PL;3._
	
İnsanınbudünyayagelişidebirgörünüştü.	insan3;N;SG;GENbuDETdünya3;N;DAT;SGgelişPSS3S;NOM;SG;3;NdeCONJbirNUMgörünüşNOM;N;3;SGiPFV;V;PST;IND;SG;3._
	
Dünyanınhertarafında,heleheleaskeriuçakkazalarında,olaygeneldepilotunüzerineatılarakkapatılır.	dünyaGEN;SG;N;3herDETtarafPSS3S;ESS;3;SG;N,_heleADVheleADVaskeriADJuçakSG;NOM;N;3kazaPSS3S;ESS;3;PL;N,_olaySG;NOM;N;3geneldeADVpilotGEN;SG;N;3üzerPSS3S;3;DAT;SG;NatIND;POS;PASS;PRS;PFV;V.CVB;VkapaIND;POS;3;PRS;SG;HAB;V._
	
Neredeysekasıklarınaçekildi,sımsıkıetekliği.	neredeyseADVkasıkPSS3S;PL;3;N;DATçekPASS;PFV;PST;V;IND;SG;3;POS,_sımsıkıADJeteklikPSS3S;NOM;SG;3;N._
	
	
Boyunlarındatahtadanbirtasmaveyarenklikumaşbağlıolanlar,sütverendişilerdi.	boyunPSS3P;PL;3;N;ESStahta3;ADJ;SG;AT+ABLbirNUMtasmaNOM;N;3;SGveyaCONJrenkliADJkumaşNOM;ADJ;3;SGbağlıADJolPFV;PRS;NOM;V;IND;PL;V.PTCP;3;POS,_sütNOM;N;3;SGverPFV;PRS;V;IND;V.PTCP;POSdişiNOM;ADJ;PL;3iPFV;V;PST;IND;SG;3._
	
	
Başkasiyasetçiler,başkatoplumlar,başkauluslariçinanlayana...	başkaADJsiyasetçiNOM;N;PL;3,_başkaADJtoplumNOM;N;PL;3,_başkaADJulusNOM;N;PL;3içinADPanlaPFV;PRS;V;IND;V.PTCP;SG;3;DAT;POS..._
	
Açıkkapılarıboşunabulmayaçalışırsın,dedi.	açıkADJkapı3;N;PL;ACCboşunaADVbulV.MSDR;PFV;PRS;V;IND;DAT;POSçalışHAB;2;PRS;V;IND;SG;POS,_dePFV;PST;V;IND;SG;3;POS._
	
Kapıyıkapattı.	kapı3;N;ACC;SGkapaPFV;PST;V;IND;SG;3;CAUS;POS._
	
Bulgaristan'aborçparayladöndüm"dedi.	BulgaristanSG;DAT;PROPN;3borçSG;3;N;NOMparaSG;3;N;INSdönPST;1;POS;IND;SG;PFV;V"_dePST;3;POS;IND;SG;PFV;V._
	
Ancakailesihuzursuzolduğuiçinbirçokyolculuğunukarayoluylayapardı.	ancakCONJailePSS3S;NOM;SG;3;NhuzursuzADJolPSS3S;PFV;PST;NOM;V;IND;V.PTCP;POSiçinADPbirçokDETyolculukPSS3S;ACC;SG;3;Nkarayolu3;N;INS;SGyapHAB;PST;V;IND;SG;3;POS._
	
Onunyüzününyarısıgülerkenyarısıağlardı.	oPRO;SG;3;GENyüzPSS3S;GEN;SG;3;NyarıPSS3S;NOM;ADJ;SG;3gülHAB;PRS;V;IND;SG;3;POS;V.CVByarıPSS3S;NOM;ADJ;SG;3ağlaHAB;PST;V;IND;SG;3;POS._
	
BilimselDevrim'inbaşlangıçtakiesasetkisi,dahaöncededeğindiğinizgibiideolojikdüzlemdeolmuştur.	bilimselADJDevrim3;PROPN;SG;GENbaşlangıç3;N;ESS;SGkiADPesasNOM;ADJ;3;SGetkiPSS3S;NOM;SG;3;N,_dahaADVönceADVdeCONJdeğinPSS2P;PFV;PST;V;IND;V.PTCP;POSgibiADPideolojikADJdüzlem3;ADJ;ESS;SGolPFV;PST;V;NFH;SG;3;POS._
	
Yağmurçiseliyordu.	yağmurNOM;N;3;SGçiseleINFM;PST;V;IND;PROG;SG;3;POS._
	
Nemateryalizm,nedeteoriBilimselDevrim'leortayaçıkmıştır.	neCONJmateryalizmNOM;N;3;SG,_neCONJdeCONJteoriNOM;N;3;SGbilimselADJDevrim3;PROPN;INS;SGorta3;ADJ;DAT;SGçıkPFV;PST;V;NFH;SG;3;POS._
	
AllahAllah,budaneredençıktı?diyesormadık,şaşırmadık.	AllahNOM;PROPN;3;SGAllahNOM;PROPN;3;SG,_buPRO;NOM;SG;3daCONJnere3;SG;PRO;AT+ABLçıkPFV;PST;V;IND;SG;3;POS?_diyeADPsor1;NEG;PFV;PST;V;IND;PL,_şaşır1;NEG;PFV;PST;V;IND;PL._
	
BayındırSokak'takibekarevimdençıktım.	BayındırNOM;PROPN;3;SGSokak3;PROPN;ESS;SGkiADPbekarNOM;ADJ;3;SGevPSS1S;AT+ABL;SG;3;Nçık1;PFV;PST;V;IND;SG;POS._
	
Biranlamdabirordukomutanınınölmüşolması.	birNUManlamSG;ESS;N;3birNUMorduSG;3;N;NOMkomutanPSS3S;3;SG;N;GENölPST;POS;IND;PFV;V.PTCP;V;NFHolPSS3S;V.MSDR;NOM;POS;IND;PRS;PFV;V._
	
BabamlaKahve'yialmayagelecektik.	babaPSS1S;INS;3;SG;NKahveACC;SG;PROPN;3alIND;V.MSDR;POS;DAT;PRS;PFV;Vgel<unk>._
	
Kendimizibiryoklayalım.	kendiPSS1P;1;PRO;ACC;PL;REFLbirNUMyokla1;OPT;PFV;PRS;V;PL;POS._
	
Senmiydino.	senPRO;2;NOM;SGmi<unk>oPRO;NOM;3;SG._
	
Nekorkması!	neNOM;3;PRO;SGkorkPSS3S;V.MSDR;PFV;PRS;NOM;V;IND;POS!_
	
Onubulmalıyım.	o3;SG;PRO;ACCbul<unk>._
	
Giremiyoriçeriye.	girINFM;NEG;PRS;V;POT;PROG;SG;3içeri3;N;DAT;SG._
	
ekşimtırak,yakıcılezzetiyle.	ekşimtırakADJ,_yakPFV;PRS;V;IND;V.PTCP;POSlezzetPSS3S;INS;SG;3;N._
	
Açılıyor.	açINFM;PASS;PRS;V;IND;PROG;SG;3;POS._
	
Demekki;toplumlarınkültürveyaşantıfarklılıklarıortadankalktıkça,yörelerdekiyapıteknolojisibenzeştikçeveyapıendüstrisinindurumubenzeşip,malzemeleraynılaştıkça,evlerinfarklılığıortadankalkabilir.	demekADVkiCONJ;_toplum3;N;PL;GENkültürNOM;N;3;SGveCONJyaşantıNOM;N;3;SGfarklılıkPSS3S;NOM;PL;3;Norta3;ADJ;SG;AT+ABLkalkPFV;PRS;V;IND;POS;V.CVB,_yöre3;N;PL;ESSkiADPyapıNOM;N;3;SGteknolojiPSS3S;NOM;SG;3;NbenzeşPFV;PRS;V;IND;POS;V.CVBveCONJyapıNOM;N;3;SGendüstriPSS3S;GEN;SG;3;NdurumPSS3S;NOM;SG;3;NbenzeşPFV;PRS;V;IND;POS;V.CVB,_malzemeNOM;N;PL;3aynılaşPFV;PRS;V;IND;POS;V.CVB,_ev3;N;PL;GENfarklılıkPSS3S;NOM;SG;3;Norta3;ADJ;SG;AT+ABLkalkHAB;PRS;V;POT;SG;3;POS._
	
Baykal'ınsalonagirişiylebaşlayanhareketlilik,İstanbul'dangelenKadıköyİlçeKadınKollarıçalışanlarınıngelmesiyledahadaarttı.	Baykal3;PROPN;SG;GENsalon3;N;DAT;SGgirişPSS3S;INS;SG;3;NbaşlaPFV;PRS;V;IND;V.PTCP;POShareketlilikNOM;N;3;SG,_İstanbul3;PROPN;SG;AT+ABLgelPFV;PRS;V;IND;V.PTCP;POSKadıköyNOM;PROPN;3;SGilçeNOM;N;3;SGkadınNOM;ADJ;3;SGkolPSS3S;NOM;PL;3;NçalışanPSS3S;GEN;PL;3;NgelPSS3S;V.MSDR;PFV;PRS;V;INS;IND;POSdahaADVdaCONJartPFV;PST;V;IND;SG;3;POS._
	
Rastgelebirodanınkapısınıvurdum.	rastgeleADJbirNUModa3;N;SG;GENkapıPSS3S;ACC;SG;3;Nvur1;PFV;PST;V;IND;SG;POS._
	
Adana'yanakilgirişimlerindendehaberliliyim...	AdanaSG;DAT;PROPN;3nakilSG;NOM;N;3girişimPSS3P;AT+ABL;3;SG;NdeCONJhaberliSG;NOM;ADJ;3liADPiV;IND;1;PRS;PFV;SG..._
	
Artıkbuufaklığabiradkoymamızgerekiyordu.	artıkADVbuDETufaklık3;N;DAT;SGbirNUMadNOM;N;3;SGkoyPSS1P;V.MSDR;PFV;PRS;NOM;V;IND;POSgerekINFM;PST;V;IND;PROG;SG;3;POS._
	
Yoladüştük.	yol3;N;DAT;SGdüş1;PFV;PST;V;IND;PL;POS._
	
Maddiyatlailgilizatenbirbeklentisiyoktu.	maddiyat3;N;INS;SGilgiliNOM;ADJ;3;SGzatenADVbirNUMbeklentiPSS3S;NOM;SG;3;NyokADViPFV;V;PST;IND;SG;3._
	
Herkafadanbaşkabirsesçıkıyor.	herDETkafaSG;AT+ABL;N;3başkaADJbirNUMsesSG;3;N;NOMçık3;POS;IND;PRS;INFM;SG;PROG;V._
	
	
Busüreiçindedoğumyapanlarınkarlarıerimiş,otlarıçıkmayabaşlamış,suyuolan,kurtlarakarşıkorunaklıbiralandakorumaaltınaalınmalarıgerekecek.	buDETsüreSG;NOM;N;3içPSS3S;ESS;3;SG;ADJdoğumSG;NOM;N;3yapGEN;IND;POS;3;PRS;PFV;V.PTCP;PL;VkarPSS3S;NOM;3;PL;NeriNFH;IND;PST;POS;PFV;V.PTCP;V,_otPSS3S;NOM;3;PL;NçıkIND;V.MSDR;POS;DAT;PRS;PFV;VbaşlaNFH;IND;PST;POS;PFV;V.PTCP;V,_suPSS3S;NOM;3;SG;NolIND;POS;PRS;PFV;V.PTCP;V,_kurtDAT;PL;N;3karşıADPkorunakSG;NOM;N;3liADPbirNUMalanSG;ESS;N;3koruIND;NOM;V.MSDR;POS;PRS;PFV;ValtPSS3S;3;DAT;SG;ADJalPSS3S;IND;NOM;V.MSDR;POS;PASS;PFV;PRS;VgerekIND;POS;3;FUT;PFV;SG;V._
	
Yuraçoktanuyanmıştı.	YuraSG;3;PROPN;NOMçokSG;AT+ABL;ADJ;3uyan3;POS;IND;SG;PFV;PST+PRF;V._
	
Şöyleyadaböyle,duvardansözetmeksizinmekandan,mekandansözetmeksizinevdensözedemezsiniz.	şöyleADVyaCONJdaCONJböyleADV,_duvarSG;AT+ABL;N;3sözSG;3;N;NOMetPRS;IND;V.CVB;NEG;PFV;VmekanSG;AT+ABL;N;3,_mekanSG;AT+ABL;N;3sözSG;3;N;NOMetPRS;IND;V.CVB;NEG;PFV;VevSG;AT+ABL;N;3sözSG;3;N;NOMet<unk>._
	
Kaybettikleriyakınlarınırencideettiler.	kaybetPSS3P;IND;PST;POS;PFV;V.PTCP;VyakınPSS3P;ACC;3;PL;ADJrencideADJetIND;PST;POS;3;PFV;PL;V._
	
Kardeşlerzorgünlerdebirbirleriyledayanışmaiçindeolurlar.	kardeşNOM;N;PL;3zorADJgün3;N;PL;ESSbirbiriPSS3P;PRO;INS;PL;3dayanışmaNOM;N;3;SGiçPSS3S;ADJ;SG;3;ESSolHAB;PRS;V;IND;PL;3;POS._
	
Kazancınıyatırımadönüştürdü.	kazançPSS3S;ACC;SG;3;Nyatırım3;N;DAT;SGdönüşPFV;PST;V;IND;SG;3;CAUS;POS._
	
Hepaynısınıflardaokudular.	hepADVaynıADJsınıf3;N;PL;ESSokuPFV;PST;V;IND;PL;3;POS._
	
Buyuretti.	buyurPOS;PRS;IMP;SG;PFV;2;VetPST;3;POS;IND;SG;PFV;V._
	
Babacabirtasnif.	baba3;N;EQTV;SGbirNUMtasnifNOM;N;3;SG._
	
	
Alışverişlerdeçocuklarınetkisinedir?	alışveriş3;N;PL;ESSçocuk3;N;PL;GENetkiPSS3S;NOM;SG;3;NneNOM;3;PRO;SGiPFV;PRS;V;SG;3?_
	
Şimdiharbidensöyle,buişiyapanbiraslanmıydı?	şimdiADVharbiSG;AT+ABL;ADJ;3söylePOS;PRS;IMP;SG;PFV;2;V,_buDETişSG;N;ACC;3yapPOS;PRS;IND;PFV;V.PTCP;VbirNUMaslanSG;3;ADJ;NOMmıPST;V;3;IND;SG;PFV?_
	
Krizdönemlerionlarahayatveriyor.	krizNOM;N;3;SGdönemPSS3P;NOM;PL;3;NoPRO;PL;3;DAThayatNOM;N;3;SGverINFM;PRS;V;IND;PROG;SG;3;POS._
	
İlhamibüyükama,bizikikişioluncaonudöveriz.	İlhamiNOM;PROPN;3;SGbüyükADJamaCONJ,_biz1;PRO;NOM;PLikiNUMkişiNOM;N;3;SGolPFV;PRS;V;IND;POS;V.CVBoPRO;ACC;SG;3döv1;HAB;PRS;V;IND;PL;POS._
	
Öyledirefendim.	öyleNOM;ADJ;3;SGiPFV;PRS;V;SG;3efendiPSS1S;NOM;SG;3;N._
	
ToplantıdaDYP'likadınlar,Çiller'inkendileriylegörüşmemesiüzerine,"Ençokbizçalışıyoruz.	toplantıSG;ESS;N;3DYP<unk>liADPkadın3;PL;ADJ;NOM,_ÇillerSG;GEN;PROPN;3kendi<unk>görüş<unk>üzerPSS2S;DAT;3;SG;N,_"_enADVçokADJbizNOM;1;PL;PROçalış1;POS;PL;IND;PRS;INFM;PROG;V._
	
SüryaniKadimMeryemAnaKilisesiVakfıBaşkanıYakupTahincioğluveİstanbulProtestanKilisesiVakfıBaşkanıKirkorAğabaloğlu,yönetmeliklekendicemaatlerineyinemaledinmehakkıverilmediğiniifadeetti.	süryaniNOM;N;3;SGkadimADJMeryemNOM;PROPN;3;SGanaNOM;ADJ;3;SGkilisePSS3S;NOM;SG;3;NvakıfPSS3S;NOM;SG;3;Nbaşkan3;N;ACC;SGYakupNOM;PROPN;3;SGTahincioğluNOM;PROPN;3;SGveCONJİstanbulNOM;PROPN;3;SGprotestanNOM;ADJ;3;SGkilisePSS3S;NOM;SG;3;NvakıfPSS3S;NOM;SG;3;NbaşkanPSS3S;NOM;SG;3;NKirkorNOM;PROPN;3;SGAğabaloğluNOM;PROPN;3;SG,_yönetmelik3;N;INS;SGkendiPSS3S;REFL;PRO;NOM;SG;3cemaatPSS3P;SG;3;N;DATyineADVmalNOM;N;3;SGedinV.MSDR;PFV;PRS;NOM;V;IND;POShakPSS3S;NOM;SG;3;NverPSS3S;PASS;NEG;ACC;PFV;PST;V;IND;V.PTCPifadeNOM;N;3;SGetPFV;PST;V;IND;SG;3;POS._
	
	
Üniversitelerinözgürlüklere,maliözerkliklereilişkinbirikmişoncasorunuvarkenbeyliksiyasitartışmalaraçmanınarkasında,üniversitedenbağımsızniyetolduğukonusundahiçkuşkuduymuyorum.	üniversiteGEN;PL;N;3özgürlükDAT;PL;N;3,_maliADJözerklikDAT;PL;N;3ilişkinADPbirikNFH;IND;PST;POS;PFV;V.PTCP;VoncaADJsorunPSS3S;NOM;3;SG;NvarSG;NOM;ADJ;3iV;IND;PRS;PFV;V.CVBbeylikSG;NOM;N;3siyasiADJtartışIND;NOM;V.MSDR;POS;PRS;PFV;VaçGEN;IND;V.MSDR;POS;PRS;PFV;VarkaPSS3S;ESS;3;SG;ADJ,_üniversiteAT+ABL;SG;N;3bağımsızADJniyetSG;NOM;N;3olPSS3S;IND;PST;POS;PFV;V.PTCP;VkonuPSS3S;ESS;3;SG;NhiçADVkuşkuSG;NOM;N;3duyINFM;NEG;IND;1;PRS;SG;PROG;V._
	
Ailesindenkalan,harcasaharcasabitiremeyeceğikadarçokparasıolanbukadınlatanışmamınöyküsübiletekbaşınabirkitapkonusuolabilir.	ailePSS3S;AT+ABL;SG;3;NkalPFV;PRS;V;IND;V.PTCP;POS,_harcaCOND;PFV;PRS;V;SG;3;POSharcaCOND;PFV;PRS;V;SG;3;POSbitirPSS3S;FUT;NEG;PFV;V;POT;V.PTCPkadarADPçokADJparaPSS3S;NOM;SG;3;NolPFV;PRS;V;IND;V.PTCP;POSbuDETkadın3;INS;ADJ;SGtanış<unk>öyküPSS3S;NOM;SG;3;NbileADVtekADJbaşPSS3S;SG;3;N;DATbirNUMkitapNOM;N;3;SGkonuPSS3S;NOM;SG;3;NolHAB;PRS;V;POT;SG;3;POS._
	
Peşinibırakmayın.	peşPSS3S;3;SG;N;ACCbırak<unk>._
	
Hadiçağatlayalımdiyesıçratan,kıçüstüoturtan.	hadiINTJçağSG;NOM;N;3atlaPOS;1;PRS;PFV;OPT;PL;VdiyeADPsıçraCAUS;IND;POS;PRS;PFV;V.PTCP;V,_kıçüstüADVoturCAUS;IND;POS;PRS;PFV;V.PTCP;V._
	
Yoğunsisteuçakpistedoğrugelirkenpilota"Yaklaşmahattınınsolundakaldın"uyarısıyapıldığı,bununüzerinepilotunuçağıdüzeltmeyeçalıştığı,ancaksoldikmenin(anainiştakımısolu)tepeyeçarptığıifadeedildi.	yoğunADJsis3;N;ESS;SGuçakNOM;N;3;SGpist3;N;DAT;SGdoğruADPgelHAB;PRS;V;IND;SG;3;POS;V.CVBpilot3;N;DAT;SG"_yaklaşV.MSDR;PFV;PRS;NOM;V;IND;POShatPSS3S;GEN;SG;3;NsolPSS3S;ADJ;SG;3;ESSkalPFV;2;PST;V;IND;SG;POS"_uyarıPSS3S;NOM;SG;3;NyapPSS3S;PASS;PFV;PST;NOM;V;IND;V.PTCP;POS,_buPRO;SG;3;GENüzerPSS3S;SG;3;N;DATpilot3;N;SG;GENuçak3;N;ACC;SGdüzelV.MSDR;PFV;PRS;V;IND;CAUS;DAT;POSçalışPSS3S;PFV;PST;NOM;V;IND;V.PTCP;POS,_ancakCONJsolNOM;ADJ;3;SGdikme3;ADJ;SG;GEN(_anaADJinişNOM;N;3;SGtakımPSS3S;NOM;SG;3;NsolPSS3S;NOM;ADJ;SG;3)_tepe3;N;DAT;SGçarpPSS3S;PFV;PST;NOM;V;IND;V.PTCP;POSifadeNOM;N;3;SGetPASS;PFV;PST;V;IND;SG;3;POS._
	
MilliSavunmaBakanlığı'ndagörevlibirkurmayalbaysohbetsırasındafarkındaolmadankendifikrinisöyledi.	milliADJsavunV.MSDR;PFV;PRS;NOM;V;IND;POSbakanlıkPSS3S;SG;3;N;ESSgörevliADJbirNUMkurmayNOM;N;3;SGalbayNOM;N;3;SGsohbetNOM;N;3;SGsıraPSS3S;SG;3;N;ESSfarkPSS3S;SG;3;N;ESSolNEG;PFV;PRS;V;IND;V.CVBkendiPSS3S;REFL;PRO;NOM;SG;3fikirPSS3S;ACC;SG;3;NsöylePFV;PST;V;IND;SG;3;POS._
	
Budaelbetteki,üniversitekampüslerininiçindekilaboratuarlardayapılangözlemvedeneylerlegerçekleşmiştir.	bu3;NOM;SG;PROdaCONJelbetteADVkiCONJ,_üniversiteSG;3;N;NOMkampüsPSS3S;3;PL;N;GENiçPSS3S;3;ADJ;SG;ESSkiADPlaboratuarESS;PL;N;3yapPASS;POS;PRS;IND;PFV;V.PTCP;VgözlemSG;3;N;NOMveCONJdeney3;PL;N;INSgerçekleşPST;3;POS;SG;PFV;V;NFH._
	
Böyleifadeedebiliriz:...	böyleADVifadeSG;NOM;N;3etPOT;POS;1;PL;PRS;HAB;V:_..._
	
Arkadaşlar.	arkadaşNOM;N;PL;3._
	
Başesgioğlugöre,olasıIraksavaşı,OrtaDoğuveKuzeyAfrikaülkeleriniöncelikleetkiler.	BaşesgioğluNOM;PROPN;3;SGgöreADP,_olasıADJIrakNOM;PROPN;3;SGsavaşPSS3S;NOM;SG;3;N,_ortaADJDoğuNOM;PROPN;3;SGveCONJkuzeyADJAfrikaNOM;PROPN;3;SGülkePSS3S;ACC;PL;3;Nöncelik3;N;INS;SGetkileHAB;PRS;V;IND;SG;3;POS._
	
Geeç,dedigözlerinikapayıpbaşıylasınıfınarkasıralarınıgöstererek.	geçSG;3;N;NOM,_dePST;3;POS;IND;SG;PFV;VgözPSS3S;3;PL;N;ACCkapaPOS;PRS;IND;V.CVB;PFV;VbaşPSS3S;3;SG;N;INSsınıfSG;GEN;N;3arkaADJsıraPSS3S;3;PL;N;ACCgösterPOS;PRS;IND;V.CVB;PFV;V._
	
Siznedeninianlayabiliyormusunuz.	sizPRO;2;NOM;PLnedenPSS3S;ACC;SG;3;NanlaINFM;PRS;V;POT;PROG;SG;3;POSmuPFV;PRS;2;V;IND;PL._
	
OğlununcenazesiniteslimalanKemalUlusu,"Allah'tanpilotlarcamdanfırladığıiçinyanmamışlar.	oğulPSS3S;3;SG;N;GENcenazePSS3S;3;SG;N;ACCteslimSG;3;N;NOMalPOS;PRS;IND;PFV;V.PTCP;VKemalSG;3;PROPN;NOMUlusuSG;3;PROPN;NOM,_"_AllahSG;AT+ABL;PROPN;3pilot3;PL;N;NOMcamSG;AT+ABL;ADJ;3fırlaPSS3S;PST;NOM;POS;IND;PFV;V.PTCP;ViçinADPyan<unk>._
	
Sizdükkandançıkıponlarınarasınagireceksinizveyürümeyebaşlayacaksınız.	sizPRO;2;NOM;PLdükkan3;N;SG;AT+ABLçıkPFV;PRS;V;IND;POS;V.CVBoPRO;PL;3;GENaraPSS3S;ADJ;SG;3;DATgirFUT;PFV;2;V;IND;PL;POSveCONJyürüV.MSDR;PFV;PRS;V;IND;DAT;POSbaşlaFUT;PFV;2;V;IND;PL;POS._
	
Bütünsınıfönümüzdekihaftaharçlıklarımızıharcamayıpbiriktireceğiz.	bütünADJsınıfNOM;N;3;SGönPSS1P;ADJ;SG;3;ESSkiADPhaftaNOM;N;3;SGharçlıkPSS1P;ACC;PL;3;NharcaNEG;PFV;PRS;V;IND;V.CVBbirikFUT;1;PFV;V;IND;PL;CAUS;POS._
	
Bakın,kapıneredeyseaçılacak.	bak2;POS;IMP;PRS;PFV;PL;V,_kapıSG;NOM;N;3neredeyseADVaçIND;POS;3;PASS;FUT;PFV;SG;V._
	
Çıt!Söndürdümmasalambasını.	çıtNOM;N;3;SG!_sön1;PFV;PST;V;IND;SG;CAUS;POSmasaNOM;N;3;SGlambaPSS3S;ACC;SG;3;N._
	
BukuruluşlardaparalarınıMerkezBankasıveyamuhabiriniteliğindekiZiraatBankası'ndaaçacaklarıhesaplardatoplayacaklar.	buDETkuruluşNOM;N;PL;3daCONJparaPSS3P;ACC;PL;3;NmerkezNOM;N;3;SGbankaPSS3S;NOM;SG;3;NveyaCONJmuhabirPSS3S;NOM;SG;3;NnitelikPSS3S;SG;3;N;ESSkiADPziraatNOM;N;3;SGbankaPSS3S;SG;3;N;ESSaçPSS3P;FUT;PFV;NOM;V;IND;V.PTCP;POShesap3;N;PL;ESStoplaFUT;PFV;V;IND;PL;3;POS._
	
Sezonukapamaktainatçıbirgençsüratmotoruylagöremediğimbirinefiyakalaryapıyordudairelerçizerek.	sezon3;N;ACC;SGkapaFORM;PRS;V;IND;PROG;SG;3;POSinatçıADJbirNUMgençADJsüratNOM;N;3;SGmotorPSS3S;INS;SG;3;NgörPSS1S;NEG;PFV;PST;V;POT;V.PTCPbiriPSS3S;PRO;SG;3;DATfiyakaNOM;N;PL;3yapINFM;PST;V;IND;PROG;SG;3;POSdaireNOM;N;PL;3çizPFV;PRS;V;IND;POS;V.CVB._
	
Ferda,Böylebirkonudadenemeyanılmaoynanabilirmi,Selma'cım?diyekonuştu.	FerdaNOM;PROPN;3;SG,_böyleADJbirNUMkonu3;N;ESS;SGdenemeNOM;N;3;SGyanılV.MSDR;PFV;PRS;NOM;V;IND;POSoynaPASS;HAB;PRS;V;POT;SG;3;POSmiPFV;PRS;V;IND;SG;3,_Selma'cıPSS1S;NOM;SG;3;N?_diyeADPkonuşPFV;PST;V;IND;SG;3;POS._
	
Aygün,BaşbakanYardımcısıAbdüllatifŞener'legörüşmesindensonrayaptığıaçıklamadabubankaların,Vakıfbank,Şekerbank,YapıKredi,Akbank,GarantiveHalkBankasıolduğunukaydetti.	AygünSG;3;PROPN;NOM,_başbakanSG;3;N;NOMyardımcıPSS3S;3;NOM;SG;NAbdüllatifSG;3;PROPN;NOMŞenerSG;3;PROPN;INSgörüşmePSS3S;3;SG;N;AT+ABLsonraADPyapPSS3S;PST;POS;IND;PFV;V.PTCP;VaçıklaPOS;IND;PRS;PFV;V;ESS;V.MSDRbuDETbanka3;GEN;N;PL,_VakıfbankSG;3;PROPN;NOM,_ŞekerbankSG;3;PROPN;NOM,_yapıSG;3;N;NOMkrediSG;3;N;NOM,_AkbankSG;3;PROPN;NOM,_garantiSG;3;N;NOMveCONJhalkSG;3;N;NOMbankaPSS3S;3;NOM;SG;NolPSS3S;PST;POS;IND;PFV;ACC;V.PTCP;VkaydetPST;3;POS;IND;SG;PFV;V._
	
	
Sessizceonayladık.	sessizceADVonayla1;PFV;PST;V;IND;PL;POS._
	
Birsüresessizyürüdük.	birNUMsüreNOM;N;3;SGsesNOM;N;3;SGsizADPyürü1;PFV;PST;V;IND;PL;POS._
	
Bendensonraaşıkolduğuadamıgecegündüzizledim.	ben1;SG;PRO;AT+ABLsonraADPaşıkADJolPSS3S;PST;POS;IND;PFV;V.PTCP;VadamSG;N;ACC;3geceSG;3;N;NOMgündüzSG;3;N;NOMizlePST;1;POS;IND;SG;PFV;V._
	
Elimayağımtutmuyor.	elPSS1S;NOM;SG;3;NayakPSS1S;NOM;SG;3;NtutINFM;NEG;PRS;V;IND;PROG;SG;3._
	
Almanlariçin.	AlmanNOM;ADJ;PL;3içinADP._
	
CezamızbüyükmüşCeza,dedi.	cezaPSS1P;NOM;SG;3;NbüyükNOM;ADJ;3;SGiPFV;V;PST;NFH;IND;SG;3cezaNOM;N;3;SG,_dePFV;PST;V;IND;SG;3;POS._
	
Sonderecelezzetli.	sonADJdereceNOM;N;3;SGlezzetliADJ._
	
Kuşkuylabaktıyüzüme.	kuşku3;N;INS;SGbakPFV;PST;V;IND;SG;3;POSyüzPSS1S;SG;3;N;DAT._
	
AyhanFen'egeçti.	AyhanNOM;PROPN;3;SGFen3;PROPN;DAT;SGgeçPFV;PST;V;IND;SG;3;POS._
	
Bukadarçabukdabulamazdeğilmi?	buPRO;NOM;SG;3kadarADPçabukADVdaCONJbulNEG;HAB;PRS;V;POT;SG;3değilNEG;PFV;PRS;V;IND;SG;3miPFV;PRS;V;IND;SG;3?_
	
Yemeyiz,dediRamiz,öncebengirerimsınıfa,öğretmenim,derim,öğlendetarlayababamayemekgötürdüm,ondangeçkaldım.	ye<unk>,_dePST;3;POS;IND;SG;PFV;VRamizSG;3;PROPN;NOM,_önceADVbenNOM;1;SG;PROgir1;POS;IND;PRS;SG;V;HABsınıfSG;DAT;N;3,_öğretmenPSS1S;3;NOM;SG;N,_de1;POS;IND;PRS;SG;V;HAB,_öğlenSG;ESS;N;3tarlaSG;DAT;N;3babaPSS1S;DAT;3;SG;NyemekSG;3;N;NOMgötürPST;1;POS;IND;SG;PFV;V,_o3;SG;PRO;AT+ABLgeçADVkalPST;1;POS;IND;SG;PFV;V._
	
BenimsileceğimarabaMersedes,BMWfalanolacak.	ben1;PRO;SG;GENsil<unk>arabaNOM;N;3;SGMersedesNOM;PROPN;3;SG,_BmwNOM;SG;3;NfalanNOM;ADJ;3;SGolFUT;PFV;V;IND;SG;3;POS._
	
Yavaşyavaşrakısınıyudumluyordu.	yavaşADJyavaşADJrakıPSS3S;3;SG;N;ACCyudumlaPST;3;POS;IND;INFM;SG;PROG;V._
	
Zorbirgörüşmeolacak.	zorADJbirNUMgörüşmeNOM;N;3;SGolFUT;PFV;V;IND;SG;3;POS._
	
Şöylebirdolaşayımevini...	şöyleADVbirADVdolaş1;OPT;PFV;PRS;V;SG;POSevPSS2S;ACC;SG;3;N..._
	
Geloturyanıma!	gel2;POS;IMP;PRS;PFV;SG;Votur2;POS;IMP;PRS;PFV;SG;VyanPSS1S;3;DAT;SG;ADJ!_
	
Öylegünleroluyorduki,bazensabahbaşka;öğlenbaşka,akşambaşkabirkadınlabuluşuyor,hepsineayrıayrıhikayeleranlatıyordum.	öyleADJgün3;PL;N;NOMolPST;3;POS;IND;INFM;SG;PROG;VkiCONJ,_bazenADVsabahSG;3;N;NOMbaşkaADJ;_öğlenSG;3;N;NOMbaşkaADJ,_akşamSG;3;N;NOMbaşkaADJbirNUMkadınSG;3;ADJ;INSbuluş3;POS;IND;PRS;INFM;SG;PROG;V,_hepsi<unk>ayrıADJayrıADJhikaye3;PL;N;NOManlatPST;1;POS;IND;INFM;SG;PROG;V._
	
Paşa,dalkavukarıyor.	PaşaNOM;PROPN;3;SG,_dalkavukNOM;ADJ;3;SGaraINFM;PRS;V;IND;PROG;SG;3;POS._
	
	
Hazine,ikibinüçyılıdışborçlanmaprogramıçerçevesindeikinciihracınıgerçekleştirerek,beşyüzmilyonFinnurtutarındabeşyılvadeliveyüzdeonkuponfaizli'cinsitahvilihracıyaptı.	hazineNOM;N;3;SG,_ikibinüçNUMyılPSS3S;NOM;SG;3;NdışADJborçlanV.MSDR;PFV;PRS;NOM;V;IND;POSprogramPSS3S;NOM;SG;3;NçerçevePSS3S;SG;3;N;ESSikiNOM;SG;3;NUMihraçPSS3S;ACC;SG;3;NgerçekleşPFV;PRS;V;IND;CAUS;POS;V.CVB,_beşyüzNOM;SG;3;NUMmilyonNOM;SG;3;NUMFinnurNOM;PROPN;3;SGtutarPSS3S;SG;3;N;ESSbeşNUMyılNOM;N;3;SGvadeNOM;N;3;SGliADPveCONJyüzSG;3;NUM;ESSonNUMkuponNOM;N;3;SGfaizNOM;N;3;SGliADP'_cinsPSS3S;NOM;ADJ;SG;3tahvilNOM;N;3;SGihraçPSS3S;NOM;SG;3;NyapPFV;PST;V;IND;SG;3;POS._
	
Maryline'nin,birkaçyolcuylabirliktetramvaydanindiğini,sonradageçmeküzerecaddeninkıyısındakikaldırımadoğruyürüdüğünügördüm.	Maryline3;N;SG;GEN,_birkaçDETyolcu3;N;INS;SGbirlikteADPtramvay3;N;SG;AT+ABLinPSS3S;ACC;PFV;PST;V;IND;V.PTCP;POS,_sonraADVdaCONJgeçV.MSDR;PFV;PRS;NOM;V;IND;POSüzereADPcadde3;N;SG;GENkıyıPSS3S;SG;3;N;ESSkiADPkaldırım3;N;DAT;SGdoğruADPyürüPSS3S;ACC;PFV;PST;V;IND;V.PTCP;POSgör1;PFV;PST;V;IND;SG;POS._
	
Dahaönceneredeçalışıyordunuz.	dahaADVönceADVnere3;ESS;PRO;SGçalışINFM;2;PST;V;IND;PL;PROG;POS._
	
Geridebırakılanbirkaçgençveyolculuğadayanmagücüolmayanbiryaşlıkadındışındatümçobanlarkervanlayolaçıkıyorlar.	geriSG;ESS;ADJ;3bırakPASS;POS;PRS;IND;PFV;V.PTCP;VbirkaçDETgençSG;3;ADJ;NOMveCONJyolculukSG;DAT;N;3daya<unk>güçPSS3S;3;NOM;ADJ;SGolPRS;IND;NEG;PFV;V.PTCP;VbirNUMyaşlıADJkadınSG;3;ADJ;NOMdışPSS3S;3;ADJ;SG;ESStümDETçoban3;PL;N;NOMkervanSG;3;N;INSyolSG;DAT;N;3çık3;POS;PL;IND;PRS;INFM;PROG;V._
	
Kadınbakmışevkonakgibikoskocaman,ambarlarıyiyecekdolu,bağlardaüzümlersalkımsalkım,ineklerinmemelerindensütdamlıyor.	kadınNOM;ADJ;3;SGbakPFV;PST;V;NFH;IND;SG;3;POSevNOM;N;3;SGkonakNOM;N;3;SGgibiADPkoskocamanADJ,_ambarPSS3S;NOM;PL;3;NyiyecekNOM;ADJ;3;SGdoluADJ,_bağ3;N;PL;ESSüzümNOM;N;PL;3salkımNOM;N;3;SGsalkımNOM;N;3;SG,_inek3;N;PL;GENmemePSS3P;AT+ABL;PL;3;NsütNOM;N;3;SGdamlaINFM;PRS;V;IND;PROG;SG;3;POS._
	
Sokuldukçasokuluyor,benkaçındıkça.	sokPASS;POS;PRS;IND;V.CVB;PFV;VsokPASS;3;POS;IND;PRS;INFM;SG;PROG;V,_benNOM;1;SG;PROkaçınPOS;PRS;IND;V.CVB;PFV;V._
	
Evet.	evetNOM;N;3;SG._
	
Okurlaruyardılar:.	okur3;PL;N;NOMuyarPST;3;POS;IND;PL;PFV;V:_._
	
KemalUlusuoğlununnaaşınıalmakiçinDiyarbakır'agiderken,anneİlkinHanımilediğeroğluAtillailaçlarlayatıştırılmayaçalışıldı.	KemalNOM;PROPN;3;SGUlusuNOM;PROPN;3;SGoğulPSS3S;GEN;SG;3;NnaaşPSS3S;ACC;SG;3;NalV.MSDR;PFV;PRS;NOM;V;IND;POSiçinADPDiyarbakır3;PROPN;DAT;SGgitHAB;PRS;V;IND;SG;3;POS;V.CVB,_anneNOM;N;3;SGİlkinNOM;PROPN;3;SGhanımNOM;N;3;SGileCONJdiğerADJoğulPSS3S;NOM;SG;3;NAtillaNOM;PROPN;3;SGilaç3;N;INS;PLyatışV.MSDR;PFV;PRS;V;IND;DAT;POSçalışPASS;PFV;PST;V;IND;SG;3;POS._
	
Eğertazminatdavasıaçmakistersembudavayıalabileceklerini,amadiğerdavalariçinveyaaraştırmalariçinkarşılarındaSilahlıKuvvetlerolduğuiçinböylebirişegirişmekistemediklerini,neticeçıkaramayacaklarını,yanikapalıkapılarardındamücadeleyigözealamayacaklarınısöyleyerekkabuletmediler.	eğerCONJtazminatNOM;N;3;SGdavaPSS3S;NOM;SG;3;NaçV.MSDR;PFV;PRS;NOM;V;IND;POSiste1;COND;HAB;PRS;V;SG;POSbuDETdava3;N;ACC;SGalPSS3P;FUT;ACC;PFV;V;POT;V.PTCP;POS,_amaCONJdiğerADJdavaNOM;N;PL;3içinADPveyaCONJaraştırV.MSDR;PFV;PRS;NOM;V;IND;POSiçinADPkarşıPSS3P;ADJ;PL;3;ESSsilahNOM;N;3;SGliADPkuvvetNOM;N;PL;3olPSS3S;PFV;PST;NOM;V;IND;V.PTCP;POSiçinADPböyleADVbirNUMiş3;N;DAT;SGgirişV.MSDR;PFV;PRS;NOM;V;IND;POSistePSS3P;NEG;ACC;PFV;PST;V;IND;V.PTCP,_neticeNOM;N;3;SGçıkar<unk>,_yaniCONJkapalıADJkapıNOM;N;PL;3artPSS3S;SG;3;N;ESSmücadele3;N;ACC;SGgöz3;N;DAT;SGal<unk>söylePFV;PRS;V;IND;POS;V.CVBkabulNOM;N;3;SGetNEG;PFV;PST;V;IND;PL;3._
	
Benürkerimzamandan.	ben1;PRO;NOM;SGürk1;HAB;PRS;V;IND;SG;POSzaman3;N;SG;AT+ABL._
	
LenTi,işçilerinyenievlerindenmemnunolmadıklarınıduydu.	LenNOM;PROPN;3;SGTiNOM;N;3;SG,_işçi3;N;PL;GENyeniADJevPSS3P;AT+ABL;PL;3;NmemnunADJolPSS3P;NEG;ACC;PFV;PST;V;IND;V.PTCPduyPFV;PST;V;IND;SG;3;POS._
	
Oaradabirincelemeyapıyorlar.	oDETara3;ADJ;ESS;SGbirNUMinceleV.MSDR;PFV;PRS;NOM;V;IND;POSyapINFM;PRS;V;IND;PL;PROG;3;POS._
	
(on);yalnızca,evilegünlükyaşantı,hayatilişkileriyleilgilişeyler.	(_onNUM;NOM;3;SG)_;_yalnızcaADV,_evSG;NOM;N;3ileCONJgünlükADJyaşantıSG;NOM;N;3,_hayatSG;NOM;N;3ilişki<unk>ilgiliSG;NOM;N;3şey<unk>._
	
EskiİngilizparlamenterLinnLinndaBatı'nınvaatlerinegüvenerekbeklemeninyanlışolduğunuifadeederek,şunlarıkaydetti:"ABDisteseRumKesimi'ninAB'yeüyeolmasınıengelleyebilir.	eskiADJİngilizSG;3;ADJ;NOMparlamenterSG;3;N;NOMLinnSG;3;PROPN;NOMLinnSG;3;PROPN;NOMdaCONJBatıSG;GEN;PROPN;3vaatPSS3S;DAT;3;PL;NgüvenPOS;PRS;IND;V.CVB;PFV;VbeklePOS;IND;PRS;PFV;V;GEN;V.MSDRyanlışADJolPSS3S;PST;POS;IND;PFV;ACC;V.PTCP;VifadeSG;3;N;NOMetPOS;PRS;IND;V.CVB;PFV;V,_şu3;PL;PRO;ACCkaydetPST;3;POS;IND;SG;PFV;V:_"_Abd3;NOM;SG;Niste3;POS;COND;PRS;SG;PFV;VRumADJkesimPSS3S;3;SG;N;GENAbDAT;3;SG;NüyeSG;3;N;NOMolPSS3S;V.MSDR;POS;IND;PRS;PFV;ACC;Vengelle3;POS;PRS;SG;POT;V;HAB._
	
Ah,kadınlarınbukesinsözleri,yapamayacaklarışeyleriokadarkesinbirşekildesöylerlerki;inanırsanızsonraçokşaşırırsınız.	ahINTJ,_kadınGEN;PL;ADJ;3buDETkesinADJsözPSS3S;3;NOM;PL;N,_yap<unk>şeyPL;N;ACC;3oDETkadarADPkesinADJbirNUMşekilSG;ESS;N;3söyle3;POS;IND;PL;PRS;V;HABkiCONJ;_inan<unk>sonraADVçokADVşaşırPOS;IND;PL;PRS;2;V;HAB._
	
Halbukibizimkonuşmamızbuanlamdadeğildi.	halbukiCONJbiz1;PRO;PL;GENkonuşPSS1P;V.MSDR;PFV;PRS;NOM;V;IND;POSbuDETanlam3;N;ESS;SGdeğilNEG;PFV;PST;V;IND;SG;3._
	
Çünküondanuzunuyoktu.	çünküCONJoPRO;AT+ABL;SG;3uzun3;ACC;ADJ;SGyokADViPFV;V;PST;IND;SG;3._
	
Aşkdeyinceaklımageldi.	aşkNOM;N;3;SGdeyPFV;PRS;V;IND;POS;V.CVBakılPSS1S;SG;3;N;DATgelPFV;PST;V;IND;SG;3;POS._
	
Öyleceyiyin.	öyleceADVye2;POS;IMP;PRS;PFV;PL;V._
	
Hayalbuya!..	hayalSG;NOM;N;3buPRO;NOM;3;SGyaINTJ!_.._
	
ÇinKomünistPartisi'yleişbirliğikararıalanyankee,Avrupa'dadaHıristiyanDemokratlar'aüyeolmayahazırlanıyor.	ÇinNOM;PROPN;3;SGkomünistNOM;N;3;SGpartiPSS3S;INS;SG;3;NişbirliğiNOM;N;3;SGkararPSS3S;NOM;SG;3;NalPFV;PRS;V;IND;V.PTCP;POSYankeeNOM;PROPN;3;SG,_Avrupa3;PROPN;ESS;SGdaCONJhıristiyanNOM;N;3;SGdemokrat3;ADJ;DAT;PLüyeNOM;N;3;SGolV.MSDR;PFV;PRS;V;IND;DAT;POShazırlaINFM;PASS;PRS;V;IND;PROG;SG;3;POS._
	
İyiliği,hemdahaçokolayıaçıklamasındahemdedahaayrıntılıgözlemlerletutarlıolmasındayatar.	iyilikPSS3S;3;NOM;SG;N,_hemCONJdahaADVçokADJolaySG;N;ACC;3açıklaPSS3S;V.MSDR;POS;IND;PRS;PFV;V;ESShemCONJdeCONJdahaADVayrıntıSG;3;N;NOMliADPgözlem3;PL;N;INStutarlıADJolPSS3S;V.MSDR;POS;IND;PRS;PFV;V;ESSyat3;POS;IND;PRS;SG;V;HAB._
	
Oysaoraporuçağındüşüşnedeniyleilgiliolarakönemlibilgileriçeriyordu.	oysaCONJoDETraporNOM;N;3;SGuçak3;N;SG;GENdüşüşNOM;N;3;SGnedenPSS3S;INS;SG;3;NilgiliNOM;ADJ;3;SGolarakADPönemNOM;N;3;SGliADPbilgiNOM;N;PL;3içerINFM;PST;V;IND;PROG;SG;3;POS._
	
ÇokalışmıştımKahve'yebelkivazgeçersinalmaktan,annemdealıştığıiçinkalırdiyordumkendikendime.	çokADValış1;PFV;V;IND;SG;PST+PRF;POSKahve3;PROPN;DAT;SGbelkiADVvazgeçHAB;2;PRS;V;IND;SG;POSalV.MSDR;AT+ABL;PFV;PRS;V;IND;POS,_annePSS1S;NOM;SG;3;NdeCONJalışPSS3S;PFV;PST;V;IND;V.PTCP;POSiçinADPkalHAB;PRS;V;IND;SG;3;POSdeINFM;1;PST;V;IND;PROG;SG;POSkendiPSS3S;REFL;PRO;NOM;SG;3kendiPSS1S;1;PRO;SG;REFL;DAT._
	
Kerembanadönmüştü.	KeremSG;NOM;PROPN;3benPRO;DAT;1;SGdönIND;POS;3;PFV;SG;PST+PRF;V._
	
Baktım,yüzümutluydu.	bak1;PFV;PST;V;IND;SG;POS,_yüzPSS3S;NOM;SG;3;NmutluNOM;ADJ;3;SGiPFV;V;PST;IND;SG;3._
	
Dahadoğrusutakipsizlikkararıverilmişti.	dahaADVdoğruPSS3S;NOM;ADJ;SG;3takipsizlikNOM;N;3;SGkararPSS3S;NOM;SG;3;NverPASS;PFV;V;IND;SG;3;PST+PRF;POS._
	
SalatakelimesiFransızcanınProvencelehçesindengeliyor.	salataNOM;N;3;SGkelimePSS3S;NOM;SG;3;NFransızca3;ADJ;SG;GENProvenceNOM;PROPN;3;SGlehçePSS3S;AT+ABL;SG;3;NgelINFM;PRS;V;IND;PROG;SG;3;POS._
	
Alışmaklazım.	alışIND;NOM;V.MSDR;POS;PRS;PFV;VlazımADJ._
	
Neredeoturuyorsunuz.	nereSG;PRO;ESS;3oturINFM;2;IND;POS;PROG;PRS;PL;V._
	
Oanyıkıldım,perişanoldumorada.	oDETanSG;NOM;N;3yıkIND;PST;POS;PASS;1;PFV;SG;V,_perişanADJolIND;PST;POS;1;PFV;SG;VoraSG;PRO;ESS;3._
	
Çevreyiaraştırırlar.	çevre3;N;ACC;SGaraştırHAB;PRS;V;IND;PL;3;POS._
	
Babamderdiki.	babaPSS1S;NOM;SG;3;NdeHAB;PST;V;IND;SG;3;POSkiCONJ._
	
	
İstediğinizücretnedir.	istePSS2P;PFV;PST;V;IND;V.PTCP;POSücretNOM;N;3;SGneNOM;3;PRO;SGiPFV;PRS;V;SG;3._
	
Hemyarınsokağaçıkmayasağıolacaktır.	hemADVyarınNOM;N;3;SGsokak3;N;DAT;SGçıkV.MSDR;PFV;PRS;NOM;V;IND;POSyasak3;ACC;ADJ;SGolFUT;PFV;V;SG;3;POS._
	
Tutkuyuanlattınoğlum,dediŞakir.	tutku3;N;ACC;SGanlatPFV;2;PST;V;IND;SG;POSoğulPSS1S;NOM;SG;3;N,_dePFV;PST;V;IND;SG;3;POSŞakirNOM;PROPN;3;SG._
	
Boş,kiralıkapartmandairesi,birevdeğildir;o,kiralanmasıbeklenenbirkonuttur.	boşADJ,_kiraNOM;N;3;SGlikNOM;ADP;3;SGapartmanNOM;N;3;SGdairePSS3S;NOM;SG;3;N,_birNUMevNOM;N;3;SGdeğilNEG;PFV;PRS;V;SG;3;_oDET,_kiralaPSS3S;PASS;V.MSDR;PFV;PRS;NOM;V;IND;POSbeklePASS;PFV;PRS;V;IND;V.PTCP;POSbirNUMkonutNOM;N;3;SGiPFV;PRS;V;SG;3._
	
Damsarayolmuş,buzağılarileineklerdeprensinadamları...	damSG;NOM;N;3saraySG;NOM;N;3olNFH;IND;PST;POS;3;PFV;SG;V,_buzağıNOM;PL;N;3ileCONJinekNOM;PL;N;3deCONJprensGEN;SG;N;3adamPSS3S;NOM;3;PL;N..._
	
BunlarısöylerkenikiadımdaÖmürUzatmaKıraathanesi'ninkapısınavarmıştı.	buPRO;ACC;PL;3söyleHAB;PRS;V;IND;SG;3;POS;V.CVBikiNUMadım3;N;ESS;SGömürNOM;N;3;SGuzaV.MSDR;PFV;PRS;NOM;V;IND;CAUS;POSkıraathanePSS3S;GEN;SG;3;NkapıPSS3S;SG;3;N;DATvarPFV;V;IND;SG;3;PST+PRF;POS._
	
Çıtıpıtı-,minyonbirtipoldu.	çıtPSS3S;NOM;SG;3;Npıt3;N;ACC;SG-_,_minyonADJbirNUMtipNOM;N;3;SGolPFV;PST;V;IND;SG;3;POS._
	
Benşimdiiçeriyegiriyorum.	ben1;PRO;NOM;SGşimdiADViçeri3;N;DAT;SGgirINFM;1;PRS;V;IND;PROG;SG;POS._
	
BizCumhuriyetilkelerinegönüldenbağlıbirekipiz.	biz1;PRO;NOM;PLcumhuriyetNOM;N;3;SGilkePSS3S;PL;3;N;DATgönül3;N;SG;AT+ABLbağlıADJbirNUMekipNOM;N;3;SGi1;PFV;PRS;V;IND;PL._
	
Şimdidüşünüyorumda,galibaoparkındışındayapamayacağımben,dediKerem.	şimdiADVdüşünINFM;1;PRS;V;IND;PROG;SG;POSdaCONJ,_galibaADVoDETpark3;N;SG;GENdışPSS3S;ADJ;SG;3;ESSyap<unk>ben1;PRO;NOM;SG,_dePFV;PST;V;IND;SG;3;POSKeremNOM;PROPN;3;SG._
	
İnadınaaçılıyorum.	inatPSS3S;DAT;3;SG;Naç<unk>._
	
Gevşemiyorbirtürlü...	gevşeINFM;NEG;PRS;V;IND;PROG;SG;3birADVtürlüADJ..._
	
Lezzetaldımdiyorlar.	lezzetSG;3;N;NOMalPST;1;POS;IND;SG;PFV;Vde3;POS;PL;IND;PRS;INFM;PROG;V._
	
Biliyorum.	bilINFM;1;PRS;V;IND;PROG;SG;POS._
	
Biliyorum.	bilINFM;1;PRS;V;IND;PROG;SG;POS._
	
Gazetelerdekaçakçocuklarvaryaaynenöyleyaparım.	gazete3;N;PL;ESSkaçakADJçocukNOM;N;PL;3varADJyaCONJaynenADVöyleADVyap1;HAB;PRS;V;IND;SG;POS._
	
İnanbizimyazlıksitedekiUfukabidenbiledahayakışıklı.	inanPFV;PRS;2;V;SG;IMP;POSbiz1;PRO;PL;GENyazlıkNOM;N;3;SGsite3;N;ESS;SGkiADPUfukNOM;PROPN;3;SGabi3;N;SG;AT+ABLbileADVdahaADVyakışıklıADJ._
	
Aleviçinbugünyaşamakyadaölmekbiranlamifadeetmiyor.	AlevNOM;PROPN;3;SGiçinADPbugünNOM;N;3;SGyaşaV.MSDR;PFV;PRS;NOM;V;IND;POSyaCONJdaCONJölV.MSDR;PFV;PRS;NOM;V;IND;POSbirNUManlamNOM;N;3;SGifadeNOM;N;3;SGetINFM;NEG;PRS;V;IND;PROG;SG;3._
	
Geridönüyorsunona.	geriADVdönPOS;IND;PRS;INFM;SG;2;PROG;VoDAT;3;SG;PRO._
	
Utangaçutangaçgülümsedilerbirbirlerine.	utangaçADJutangaçADJgülümsePFV;PST;V;IND;PL;3;POSbirbiriPSS3P;PRO;PL;3;DAT._
	
Uzunzamandırmıgidersinizoraya.	uzunADJzamanNOM;N;3;SGiPFV;PRS;V;SG;3mıPFV;PRS;V;IND;SG;3gitHAB;2;PRS;V;IND;PL;POSora3;DAT;PRO;SG._
	
TabiibukişilerinbaşındadadavacıSaimeSezginlerveavukatıNusretSenemgeliyordu.	tabiiADJbuDETkişiGEN;PL;N;3başPSS3S;ESS;3;SG;NdaCONJdavacıSG;NOM;N;3SaimeSG;NOM;PROPN;3SezginlerSG;NOM;PROPN;3veCONJavukatPSS3S;NOM;3;SG;NNusretSG;NOM;PROPN;3SenemSG;NOM;PROPN;3gelINFM;IND;PST;POS;3;SG;PROG;V._
	
Kibirli,kendisininenzekiolduğunainananbenmerkezcikişininbirilerinikendisinerehberseçmesimümkündeğildir.	kibirliADJ,_kendiPSS3S;GEN;REFL;PRO;SG;3enADVzekiADJolPSS3S;PFV;PST;V;IND;V.PTCP;DAT;POSinanPFV;PRS;V;IND;V.PTCP;POSben1;PRO;NOM;SGmerkezciNOM;N;3;SGkişi3;N;SG;GENbiriPSS3P;PRO;ACC;PL;3kendiPSS3S;REFL;PRO;SG;3;DATrehberNOM;N;3;SGseçPSS3S;V.MSDR;PFV;PRS;NOM;V;IND;POSmümkünADJdeğilNEG;PFV;PRS;V;SG;3._
	
Okadargüzelbirkadınınnedenböyleçocuksudavranışlarıolduğunuönceanlayamamıştım,sonraonundakendigüzelliğindenkorktuğunukeşfetmiştim;bütünerkeklerionadoğruçekenvebütünkadınları,kendisinedüşmanedengüzelliğinitaşımaktazorlanıyordu.	oDETkadarADPgüzelADJbirNUMkadınSG;GEN;ADJ;3nedenADVböyleADVçocuksuADJdavranışPSS3S;3;NOM;PL;NolPSS3S;PST;POS;IND;PFV;ACC;V.PTCP;VönceADVanla<unk>,_sonraADPo3;SG;PRO;GENdaCONJkendiPSS3S;3;NOM;REFL;SG;PROgüzellikPSS3S;3;SG;N;AT+ABLkorkPSS3S;PST;POS;IND;PFV;ACC;V.PTCP;Vkeşfet1;POS;IND;SG;PFV;PST+PRF;V;_bütünADJerkekPL;ADJ;ACC;3oDAT;3;SG;PROdoğruADPçekPOS;PRS;IND;PFV;V.PTCP;VveCONJbütünADJkadınPL;ADJ;ACC;3,_kendiPSS3S;DAT;3;REFL;SG;PROdüşmanSG;3;ADJ;NOMetPOS;PRS;IND;PFV;V.PTCP;VgüzellikPSS3S;3;SG;N;ACCtaşı3;POS;IND;FORM;PRS;SG;PROG;VzorlaPASS;PST;3;POS;IND;INFM;SG;PROG;V._
	
Onueniyiokullardaokuttumdiyerekkendisinirahatlatmayollarınıarıyordu.	oPRO;ACC;SG;3enADViyiADJokul3;N;PL;ESSoku1;PFV;PST;V;IND;SG;CAUS;POSdePFV;PRS;V;IND;POS;V.CVBkendiPSS3S;REFL;PRO;ACC;SG;3rahatlaV.MSDR;PFV;PRS;NOM;V;IND;CAUS;POSyolPSS3S;ACC;PL;3;NaraINFM;PST;V;IND;PROG;SG;3;POS._
	
Banabiryolgösterebilirmisiniz?	benDAT;1;SG;PRObirNUMyolSG;3;N;NOMgöster3;POS;PRS;SG;POT;V;HABmiV;IND;PL;PRS;PFV;2?_
	
Hertaraftatanklar.	herDETtaraf3;N;ESS;SGtankNOM;N;PL;3._
	
Yadahalaanlayamıyormusunuz.	yaCONJdaCONJhalaADVanla3;PRS;INFM;SG;NEG;PROG;POT;VmuV;IND;PL;PRS;PFV;2._
	
Kim.	kimNOM;3;PRO;SG._
	
Yıllanmışşarapgibi.	YıllanPFV;PST;V;NFH;IND;V.PTCP;POSşarapNOM;N;3;SGgibiADP._
	
Alışverişinsanınkanındavar.	alışverişNOM;N;3;SGinsan3;N;SG;GENkanPSS3S;SG;3;N;ESSvarADJ._
	
TürklerAvrupa'yıFethetmemişkenbeyazpeynirbulunmazdı.	TürkNOM;ADJ;PL;3Avrupa3;PROPN;ACC;SGfethNOM;N;3;SGet<unk>beyazADJpeynirNOM;N;3;SGbulPASS;NEG;HAB;PST;V;IND;SG;3._
	
-Artıkolmaz,onukıramam.	-_artıkADVolNEG;HAB;PRS;V;IND;SG;3,_oPRO;ACC;SG;3kır1;NEG;HAB;PRS;V;POT;SG._
	
	
Kendidarbukasıiseenpahalı,eniyikalitedarbukaydı.	kendiPSS3S;REFL;PRO;NOM;SG;3darbukaPSS3S;NOM;SG;3;NiVenADVpahalıADJ,_enADViyiADJkaliteADJdarbukaNOM;N;3;SGiPFV;V;PST;IND;SG;3._
	
Raporda,bellibirtarihitibariylemevcutticarimalstoklarıvemuhtelifservetunsurlarındandüşükoranlıbirvergialınması,ancak,buamaçlayapılacakdüzenlemelerdeaksiispatedilmedikçemükellefbeyanınındoğrukabuledilmesigerektiğineyerverildi.	raporSG;ESS;N;3,_belliADJbirNUMtarihSG;3;N;NOMitibariSG;3;N;INSmevcutADJticariADJmalSG;3;N;NOMstokPSS3S;3;NOM;PL;NveCONJmuhtelifADJservetSG;3;N;NOMunsurPSS3S;3;PL;N;AT+ABLdüşükADJoranSG;3;N;NOMliADPbirNUMvergiSG;3;N;NOMalPSS3S;V.MSDR;PASS;NOM;POS;IND;PRS;PFV;V,_ancakCONJ,_buDETamaçSG;3;N;INSyapPASS;POS;FUT;IND;PFV;V.PTCP;VdüzenlePOS;IND;PRS;PFV;V;ESS;V.MSDRaksiADJispatSG;3;N;NOMetPASS;PRS;IND;V.CVB;NEG;PFV;VmükellefADJbeyanPSS3S;3;SG;N;GENdoğruADJkabulSG;3;N;NOMetPSS3S;V.MSDR;PASS;NOM;POS;IND;PRS;PFV;VgerekPSS3S;PST;DAT;POS;IND;PFV;V.PTCP;VyerSG;3;N;NOMverPASS;PST;3;POS;IND;SG;PFV;V._
	
Oynaşmayadalmışlar.	oynaşDAT;POS;IND;PRS;PFV;V;V.MSDRdalPST;3;POS;PL;IND;PFV;V;NFH._
	
Çocuklarınişizor.	çocuk3;N;PL;GENişPSS3S;NOM;SG;3;NzorADJ._
	
Amasendoğduğundasolgözüngörüyordu,solkaşınınüstündenbaşlayan,yanağınakadarinenbuderinizdeyoktu.	amaCONJsenPRO;2;NOM;SGdoğ<unk>solADJgözPSS2S;NOM;3;SG;NgörINFM;IND;PST;POS;3;SG;PROG;V,_solADJkaşPSS2S;GEN;3;SG;NüstPSS3S;AT+ABL;3;SG;ADJbaşlaIND;POS;PRS;PFV;V.PTCP;V,_yanak<unk>kadarADPinIND;POS;PRS;PFV;V.PTCP;VbuDETderinADJizSG;NOM;N;3deCONJyokADViV;IND;PST;3;PFV;SG._
	
İlkkocasımı.	ilkADJkocaPSS3S;NOM;ADJ;SG;3mıPFV;PRS;V;IND;SG;3._
	
Arkataraftaolacak.	arkaSG;3;ADJ;NOMtarafSG;ESS;N;3ol3;POS;FUT;IND;SG;PFV;V._
	
Birtakımproblemleriberaberceçözmeyeniyetlenilmesikötübirşeydeğil.	birtakımADJproblemACC;PL;N;3beraberceADVçözIND;V.MSDR;POS;DAT;PRS;PFV;VniyetlenPSS3S;IND;NOM;V.MSDR;POS;PASS;PFV;PRS;VkötüADJbirNUMşeySG;NOM;N;3değilNEG;IND;3;PRS;PFV;SG;V._
	
Eniştengelsinde...	eniştePSS2S;NOM;3;SG;NgelPOS;IMP;3;PRS;PFV;SG;VdeCONJ..._
	
Hey,Ömer,kalkoğlum,geçkalmışız.	heyINTJ,_ÖmerNOM;PROPN;3;SG,_kalkPFV;PRS;2;V;SG;IMP;POSoğulPSS1S;NOM;SG;3;N,_geçADVkal1;PFV;PST;V;NFH;IND;PL;POS._
	
İstanbulMilliEğitimMüdürüÖmerBalıbey,okulundortyuzmilyarınıCan'ınbesyuzmilyarınıdaMilliEğitim'inkarşıladığınıbelirterek,"Canileeşibilgisayarvebirçokmasrafıdaüstlendi.	İstanbulSG;NOM;PROPN;3milliADJeğitimSG;NOM;N;3müdürPSS3S;NOM;3;SG;NÖmerSG;NOM;PROPN;3BalıbeySG;NOM;PROPN;3,_okulGEN;SG;N;3dortyuzNUMmilyar<unk>CanGEN;SG;PROPN;3besyuzNUMmilyar<unk>daCONJmilliADJEğitimGEN;SG;PROPN;3karşılaPSS3S;ACC;IND;PST;POS;PFV;V.PTCP;VbelirCAUS;IND;POS;PRS;PFV;V.CVB;V,_"_CanSG;NOM;PROPN;3ileCONJeşPSS3S;NOM;3;SG;ADJbilgisayarSG;NOM;N;3veCONJbirçokDETmasrafACC;SG;N;3daCONJüstlenIND;PST;POS;3;PFV;SG;V._
	
AvrupalıBulgarderamayanlış.	AvrupalıNOM;PROPN;3;SGBulgarNOM;ADJ;3;SGdeHAB;PRS;V;IND;SG;3;POSamaCONJyanlışADJ._
	
HayriBaytaş'tanalıntı:Soğan,Kürtbaklavası'dır.	HayriSG;3;PROPN;NOMBaytaşSG;AT+ABL;PROPN;3alıntıSG;3;N;NOM:_soğanSG;3;N;NOM,_kürtSG;3;ADJ;NOMbaklavaPSS3S;3;NOM;SG;NiV;3;PRS;SG;PFV._
	
Hesapveriyoruz.	hesapSG;3;N;NOMver1;POS;PL;IND;PRS;INFM;PROG;V._
	
Parkadönmeliyim.	parkSG;DAT;N;3dön<unk>._
	
BenonlarınHüseyinabileriyim.	benPRO;NOM;1;SGoPRO;GEN;3;PLHüseyinSG;NOM;PROPN;3abiPSS3P;NOM;3;SG;NiV;IND;1;PRS;PFV;SG._
	
Deminövüpduruyordunpatlıcanı!	deminADVövPFV;PRS;V;IND;POS;V.CVBdurINFM;2;PST;V;IND;PROG;SG;POSpatlıcan3;N;ACC;SG!_
	
Oarakapıyenidentıkladı.	oDETaraNOM;ADJ;3;SGkapıNOM;N;3;SGyenidenADVtıklaPFV;PST;V;IND;SG;3;POS._
	
KısmetsizadamLeblebibilediyemedenpazarbitermiş.	kısmetsizADJadamNOM;N;3;SGleblebiNOM;N;3;SGbileADVdeNEG;PFV;PRS;V;POT;V.CVBpazarNOM;N;3;SGbitHAB;PST;NFH;V;IND;SG;3;POS._
	
Temerrüt(gecikme)faizininözelliklekrizdönemlerindesorunhalinegeldiğinisöyleyenDemiray,İşBankası'nınbukonudakiuygulamasınınkrizdönemlerindedeaynıolduğunubildirdi.	temerrütSG;3;N;NOM(_gecikNOM;POS;IND;PRS;PFV;V;V.MSDR)_faizPSS3S;3;SG;N;GENözellikleADVkrizSG;3;N;NOMdönemPSS3S;3;PL;N;ESSsorunSG;3;N;NOMhalPSS3S;DAT;3;SG;NgelPSS3S;PST;POS;IND;PFV;ACC;V.PTCP;VsöylePOS;PRS;IND;PFV;V.PTCP;VDemiraySG;3;PROPN;NOM,_işSG;3;N;NOMbankaPSS3S;3;SG;N;GENbuDETkonuSG;ESS;N;3kiADPuygulamaPSS3S;3;SG;N;GENkrizSG;3;N;NOMdönemPSS3S;3;PL;N;ESSdeCONJaynıADJolPSS3S;PST;POS;IND;PFV;ACC;V.PTCP;VbilPST;3;POS;IND;SG;PFV;V;CAUS._
	
Bölgedekibazıülkelerdeiçkarışıklıklaradanedenolabilir.	bölge3;N;ESS;SGkiADPbazıDETülke3;N;PL;ESSiçADJkarışıklık3;N;PL;DATdaCONJnedenNOM;N;3;SGolHAB;PRS;V;POT;SG;3;POS._
	
Evlerinesığınmıştım.	evPSS3P;PL;3;N;DATsığın1;PFV;V;IND;SG;PST+PRF;POS._
	
OzamanlartoprağıbololsunSayınTuluiSönmezilekonuyutartışmışveondanepeyşeyöğrenmiştim.	oDETzamanNOM;N;PL;3toprakPSS3S;NOM;SG;3;NbolADJolPFV;PRS;V;SG;3;IMP;POSsayınADJTuluiNOM;PROPN;3;SGSönmezNOM;PROPN;3;SGileCONJkonu3;N;ACC;SGtartışPFV;PST;V;NFH;IND;SG;3;POSveCONJoPRO;AT+ABL;SG;3epeyADVşeyNOM;N;3;SGöğren1;PFV;V;IND;SG;PST+PRF;POS._
	
	
MaliBarış'tanyararlanacaklarınhürriyetibağlayıcıcezalarlailgilidüzenlemelerkarşısındasorumluluklarıdevametmeli.	maliADJBarış3;PROPN;SG;AT+ABLyararlanFUT;PFV;V;IND;V.PTCP;POS;GENhürriyetPSS3S;NOM;SG;3;NbağlaPFV;PRS;V;IND;V.PTCP;POSceza3;N;INS;PLilgiliADJdüzenleV.MSDR;PFV;PRS;NOM;V;IND;POSkarşıPSS3S;ADJ;SG;3;ESSsorumlulukPSS3S;NOM;PL;3;NdevamNOM;N;3;SGetPFV;PRS;V;SG;3;POS._
	
Aslınabakarsanız,leblebiyemişdeğildir.	asılPSS3S;DAT;3;ADJ;SGbak<unk>,_leblebiSG;3;N;NOMyemişSG;3;N;NOMdeğil3;PRS;SG;NEG;PFV;V._
	
Merkezdeyim.	merkezSG;ESS;N;3iV;1;IND;PRS;SG;PFV._
	
Korkunçbirşeybu.	korkunçADJbirNUMşeyNOM;N;3;SGbuPRO;NOM;SG;3._
	
Buyaklaşım,toplumsalbilimleridekapsamınaalarak,tarihselmateryalizmidoğurmuştur.	buDETyaklaşımNOM;N;3;SG,_toplumsalADJbilim3;N;PL;ACCdeCONJkapsamPSS3S;SG;3;N;DATalPFV;PRS;V;IND;POS;V.CVB,_tarihselADJmateryalizm3;N;ACC;SGdoğurPFV;PST;V;NFH;SG;3;POS._
	
Tuhafbirkadın,diyemırıldandım.	tuhafNOM;N;3;SGbirNUMkadınNOM;ADJ;3;SG,_diyeADPmırıldan1;PFV;PST;V;IND;SG;POS._
	
	
Ulaşmakiseimkansızdı.	ulaşV.MSDR;PFV;PRS;NOM;V;IND;POSiVimkânsızNOM;ADJ;3;SGiPFV;V;PST;IND;SG;3._
	
Sorumluluktaşıyaninsanlarımızvar;verdiklerisözünarkasındadurdularveeserleryarattılar.	sorumlulukNOM;N;3;SGtaşıPFV;PRS;V;IND;V.PTCP;POSinsanPSS1P;NOM;PL;3;NvarADJ;_verPSS3P;PFV;PST;V;IND;V.PTCP;POSsöz3;N;SG;GENarkaPSS3S;ADJ;SG;3;ESSdurPFV;PST;V;IND;PL;3;POSveCONJeserNOM;N;PL;3yaratPFV;PST;V;IND;PL;3;POS._
	
Sağlığıkötüolanzatenölüyordemiştiprofesör.	sağlıkPSS3S;NOM;3;SG;NkötüADJolIND;POS;PRS;PFV;V.PTCP;VzatenADVölINFM;IND;POS;3;PRS;SG;PROG;VdeIND;POS;3;PFV;SG;PST+PRF;VprofesörSG;NOM;N;3._
	
Önemliolandizgeninerkesininyüksek,ortaveyadüşükolmasıdeğil,içindeısıakısınınolupolmadığıdır.	önemSG;3;N;NOMliADPolPOS;PRS;IND;PFV;V.PTCP;VdizgeSG;GEN;N;3erkePSS3S;3;SG;N;GENyüksekADJ,_ortaADJveyaCONJdüşükADJolPSS3S;V.MSDR;NOM;POS;IND;PRS;PFV;VdeğilCONJ,_içPSS3S;3;ADJ;SG;ESSısıSG;3;N;NOMakıPSS3S;3;SG;N;GENolPOS;PRS;IND;V.CVB;PFV;Vol<unk>iV;3;PRS;SG;PFV._
	
Busoruyu,imamniyebayılmış?diyesorun.	buDETsoruACC;SG;N;3,_imamSG;NOM;N;3niyeADVbayılNFH;IND;PST;POS;3;PFV;SG;V?_dePOS;3;PRS;PFV;SG;OPT;Vsor2;POS;IMP;PRS;PFV;PL;V._
	
Cumartesicanlımüzikvebüyükbirorkestraonlaraeşlikediyor,valsyapıyorlar.	cumartesiSG;NOM;N;3canlıSG;NOM;ADJ;3müzikSG;NOM;N;3veCONJbüyükADJbirNUMorkestraSG;NOM;N;3oPRO;3;DAT;PLeşlikSG;NOM;N;3etINFM;IND;POS;3;PRS;SG;PROG;V,_valsSG;NOM;N;3yapINFM;IND;POS;3;PROG;PRS;PL;V._
	
İstatistiklerebaktığımızdabuseviyeninmevcutbelirsizlikunsurlarınınortadankalkmasıdurumundaikibinüçyılındadabüyükbirolasılıklatestedilebileceğinitahminedebiliriz.	istatistik3;N;PL;DATbakPSS1P;POS;PFV;PST;V;IND;V.PTCP;ESSbuDETseviye3;N;SG;GENmevcutADJbelirsizlikNOM;N;3;SGunsurPSS3S;GEN;PL;3;Norta3;ADJ;SG;AT+ABLkalkPSS3S;V.MSDR;PFV;PRS;NOM;V;IND;POSdurumPSS3S;SG;3;N;ESSikibinüçNUMyılPSS3S;SG;3;N;ESSdaCONJbüyükADJbirNUMolasılık3;N;INS;SGtestNOM;N;3;SGetPSS3S;FUT;PASS;ACC;PFV;V;POT;V.PTCP;POStahminNOM;N;3;SGet1;HAB;PRS;V;POT;PL;POS._
	
Benimiçinoyönüçokönemliydi.	benNOM;1;SG;PROiV;1;IND;PRS;SG;PFViçinADPoDETyönPSS3S;3;NOM;SG;NçokADVönemSG;3;N;NOMliADPiPST;V;3;IND;SG;PFV._
	
Kadınabaktım,havalıydı,hoştu.	kadın3;ADJ;DAT;SGbak1;PFV;PST;V;IND;SG;POS,_havalıNOM;ADJ;3;SGiPFV;V;PST;IND;SG;3,_hoşADViPFV;V;PST;IND;SG;3._
	
Öylebirfelsefekibu,kendiiçindebirçelişkiyitaşıyor;varoluşlayaşamanınbirbirinehiçuygundüşmeyeceğini,buikisiarasındakiçelişkiyianlatıyor.	öyleADJbirNUMfelsefeNOM;N;3;SGkiCONJbuPRO;NOM;SG;3,_kendiPSS3S;REFL;PRO;NOM;SG;3içPSS3S;ADJ;SG;3;ESSbirNUMçelişki3;N;ACC;SGtaşıINFM;PRS;V;IND;PROG;SG;3;POS;_varoluş3;N;INS;SGyaşaV.MSDR;PFV;PRS;V;IND;POS;GENbirbiriPSS3S;PRO;SG;3;DAThiçADVuygunADJdüşPSS3S;FUT;NEG;ACC;PFV;V;IND;V.PTCP,_buDETikiPSS3S;NOM;SG;3;NUMaraPSS3S;ADJ;SG;3;ESSkiADPçelişki3;N;ACC;SGanlatINFM;PRS;V;IND;PROG;SG;3;POS._
	
Kimbilirbelkibirgün,mezaragirmedenyadahapsedüşmedenönceararvekatılır.	kimNOM;3;PRO;SGbilHAB;PRS;V;IND;SG;3;POSbelkiADVbirNUMgünNOM;N;3;SG,_mezar3;N;DAT;SGgirNEG;PFV;PRS;V;IND;V.CVByaCONJdaCONJhapis3;N;DAT;SGdüşNEG;PFV;PRS;V;IND;V.CVBönceADParaHAB;PRS;V;IND;SG;3;POSveCONJkatPASS;HAB;PRS;V;IND;SG;3;POS._
	
İnsanlaraözgüzannettiğimbirçoközelliğinhayvanlaralemindedegeçerliolabileceğinidahaöncehiçdüşünmemiştim.	insan3;N;PL;DATözgüADJzannetPSS1S;PFV;PST;V;IND;V.PTCP;POSbirADVçokADJözellik3;N;SG;GENhayvanNOM;ADJ;PL;3alemPSS3S;SG;3;N;ESSdeCONJgeçerliADJolPSS3S;FUT;ACC;PFV;V;POT;V.PTCP;POSdahaADVönceADVhiçADVdüşün<unk>._
	
Yorum:Zago'nuntercümanınınverdiğibilgiyegörefutbolcu,bindokuzyuzdoksandokuzveikibinbiryıllarındaCorrieredelloSportokurlarıarasındayapılanoylamaylaRoma'nınoyılkieniyioyuncususeçilmiş.	yorumNOM;N;3;SG:_Zago3;PROPN;SG;GENtercümanPSS3S;GEN;SG;3;NverPSS3S;PFV;PST;V;IND;V.PTCP;POSbilgi3;N;DAT;SGgöreADPfutbolcuNOM;N;3;SG,_bindokuzyuzdoksandokuzNOM;SG;3;NUMveCONJikibinbirNOM;SG;3;NUMyılPSS3P;SG;3;N;ESSCorriereNOM;PROPN;3;SGdelloNOM;PROPN;3;SGSportNOM;PROPN;3;SGokurPSS3P;NOM;SG;3;NaraPSS3S;ADJ;SG;3;ESSyapPASS;PFV;PRS;V;IND;V.PTCP;POSoylaV.MSDR;PFV;PRS;V;INS;IND;POSRoma3;PROPN;SG;GENoDETyılNOM;N;3;SGkiADPenADViyiADJoyuncuPSS3S;NOM;SG;3;NseçPASS;PFV;PST;V;NFH;IND;SG;3;POS._
	
Elkaldırmadık.	elNOM;N;3;SGkal1;NEG;PFV;PST;V;IND;PL;CAUS._
	
Servet(ellialtı)veSevinçKaradağ(elliüç)çiftininardındabitmeyenaşklarınınmutluhikayesi,gözüyaşlıçocuklarıveyakınlarıkaldı.	ServetNOM;PROPN;3;SG(_ellialtıNOM;SG;3;NUM)_veCONJSevinçNOM;PROPN;3;SGKaradağNOM;PROPN;3;SG(_elliüçNOM;SG;3;NUM)_çiftPSS3S;GEN;ADJ;SG;3artPSS3S;SG;3;N;ESSbitNEG;PFV;PRS;V;IND;V.PTCPaşkPSS3P;SG;3;N;GENmutluADJhikayePSS3S;NOM;SG;3;N,_gözPSS3S;NOM;SG;3;NyaşlıADJçocukPSS3P;NOM;PL;3;NveCONJyakınPSS3P;NOM;ADJ;PL;3kalPFV;PST;V;IND;SG;3;POS._
	
Bugörüş,kölesahibinindünyagörüşüdür.	buDETgörüşNOM;N;3;SG,_köleNOM;N;3;SGsahipPSS3S;GEN;SG;3;NdünyaNOM;N;3;SGgörüşPSS3S;NOM;SG;3;NiPFV;PRS;V;SG;3._
	
Celalirkildi.	CelalSG;3;PROPN;NOMirkilPST;3;POS;IND;SG;PFV;V._
	
İTÜ'lüdüramadediğinibilenbiridirAyhan.	İTÜSG;3;PROPN;NOMliADPiV;3;PRS;SG;PFVamaCONJdePSS3S;PST;POS;IND;PFV;ACC;V.PTCP;VbilPOS;PRS;IND;PFV;V.PTCP;VbiriPSS3S;3;NOM;SG;PROiV;3;PRS;SG;PFVAyhanSG;3;PROPN;NOM._
	
İkimizdeaynıandaTaşhan'ınkapısınabirkadınınyaklaştığınıgördük.	ikiPSS1P;NOM;SG;3;NUMdeCONJaynıADJan3;N;ESS;SGTaşhan3;PROPN;SG;GENkapıPSS3S;SG;3;N;DATbirNUMkadın3;ADJ;SG;GENyaklaşPSS3S;ACC;PFV;PST;V;IND;V.PTCP;POSgör1;PFV;PST;V;IND;PL;POS._
	
Ölüyormuşaşkımdan.	öl<unk>aşkPSS1S;3;SG;N;AT+ABL._
	
Norveç'tenithaledilenDestecioğlucihazınınmaliyetiüçyüzellibindoları(yaklaşıkbeşyüzellimilyarlira)buluyor.	Norveç3;PROPN;SG;AT+ABLithalNOM;N;3;SGetPASS;PFV;PRS;V;IND;V.PTCP;POSDestecioğluNOM;PROPN;3;SGcihazPSS3S;GEN;SG;3;NmaliyetPSS3S;NOM;SG;3;NüçyüzelliNUMbinNOM;SG;3;NUMdolar3;N;ACC;SG(_yaklaşıkADJbeşyüzelliNUMmilyarNUMliraNOM;N;3;SG)_bulINFM;PRS;V;IND;PROG;SG;3;POS._
	
Arınçkürsüdeönemliaçıklamalaryaparken,babaylaoğludaanfidesohbetetti.	ArınçNOM;PROPN;3;SGkürsü3;N;ESS;SGönemNOM;N;3;SGliADPaçıklaV.MSDR;PFV;PRS;NOM;V;IND;POSyapHAB;PRS;V;IND;SG;3;POS;V.CVB,_baba3;N;INS;SGoğulPSS3S;NOM;SG;3;NdaCONJanfi3;N;ESS;SGsohbetNOM;N;3;SGetPFV;PST;V;IND;SG;3;POS._
	
Alfven,FizikdalındaNobelödüllübirbilimcidir.	AlfvenNOM;PROPN;3;SG,_fizikNOM;N;3;SGdalPSS3S;SG;3;N;ESSNobelNOM;PROPN;3;SGödülNOM;N;3;SGliADPbirNUMbilimciNOM;N;3;SGiPFV;PRS;V;SG;3._
	
Neyse,nasılbuldunöykümüngirişini.	neyseADV,_nasılADVbulPFV;2;PST;V;IND;SG;POSöyküPSS1S;GEN;SG;3;NgirişPSS3S;ACC;SG;3;N._
	
Çalsınsazlar...	çalPFV;PRS;V;SG;3;IMP;POSsazNOM;ADJ;PL;3..._
	
	
Öylebirşeyki...	öyleADVbirNUMşeySG;NOM;N;3kiCONJ..._
	
Hummalıbirtartışmasürüyorduşimditoplanmış,örtüsüsilkelenmişsofrada.	hummaNOM;N;3;SGliADPbirNUMtartışV.MSDR;PFV;PRS;NOM;V;IND;POSsürINFM;PST;V;IND;PROG;SG;3;POSşimdiADVtoplaPASS;PFV;PST;V;NFH;IND;V.PTCP;POS,_örtüPSS3S;NOM;SG;3;NsilkelePASS;PFV;PST;V;NFH;IND;V.PTCP;POSsofra3;N;ESS;SG._
	
Bürokratlıkstatüdeğil,karakterdir.	bürokratSG;NOM;N;3likADP;SG;NOM;3statüSG;NOM;N;3değilCONJ,_karakterSG;NOM;N;3iV;3;PRS;PFV;SG._
	
Günümüzde,etkinolarakçalışanbiliminsanısayısınıngenelnüfusaoranı,heryılyayımlananbilimselmakalesayısıvebenzerigöstergeler,insanlıktarihininhiçbirdönemindegörülmediğikadaryüksekdüzeydedir.	günPSS1P;ESS;3;SG;N,_etkinADJolarakADPçalışIND;POS;PRS;PFV;V.PTCP;VbilimSG;NOM;N;3insanPSS3S;NOM;3;SG;NsayıPSS3S;GEN;3;SG;NgenelADJnüfusSG;DAT;N;3oranPSS3S;NOM;3;SG;N,_herDETyılSG;NOM;N;3yayımlaIND;POS;PASS;PRS;PFV;V.PTCP;VbilimselADJmakaleSG;NOM;N;3sayıPSS3S;NOM;3;SG;NveCONJbenzeriADJgöstergeNOM;PL;N;3,_insanlıkSG;NOM;N;3tarihPSS3S;GEN;3;SG;NhiçbirDETdönemPSS3S;ESS;3;SG;Ngör<unk>kadarADPyüksekADJdüzeySG;ESS;N;3iV;3;PRS;PFV;SG._
	
Benerkeköğretmenistemiyorum.	benNOM;1;SG;PROerkekSG;3;ADJ;NOMöğretmenSG;3;N;NOMiste1;IND;PRS;INFM;SG;NEG;PROG;V._
	
	
Buöngörülerindoğruluğunusınayacakolanlaryinegözlemvedeneylerdir.	buDETöngörü3;N;PL;GENdoğrulukPSS3S;ACC;SG;3;NsınaFUT;PFV;V;IND;V.PTCP;POSolPFV;PRS;NOM;V;IND;PL;V.PTCP;3;POSyineADVgözlemNOM;N;3;SGveCONJdeneyNOM;N;PL;3iPFV;PRS;V;SG;3._
	
Kimliğibelirlenenonaltıkişinincenazeside,uçağınkargobölümündeİstanbul'agetirildi.	kimlikPSS3S;NOM;SG;3;NbelirlePASS;PFV;PRS;V;IND;V.PTCP;POSonaltıNUMkişi3;N;SG;GENcenazePSS3S;NOM;SG;3;NdeCONJ,_uçak3;N;SG;GENkargoNOM;N;3;SGbölümPSS3S;SG;3;N;ESSİstanbul3;PROPN;DAT;SGgetirPASS;PFV;PST;V;IND;SG;3;POS._
	
Etrafızamanzamanonmetreyekadaryükselenvebirsuradönüşenkayalarlaçevrelenenbuırmak,geyiksürülerinindışarıdangelebileceksaldırılarakarşıkendilerinikoruduklarıdoğalbirsığınaktı.	etrafPSS3S;NOM;SG;3;NzamanNOM;N;3;SGzamanNOM;N;3;SGonNUMmetre3;N;DAT;SGkadarADPyükselPFV;PRS;V;IND;V.PTCP;POSveCONJbirNUMsur3;N;DAT;SGdönüşPFV;PRS;V;IND;V.PTCP;POSkaya3;N;INS;PLçevrelePASS;PFV;PRS;V;IND;V.PTCP;POSbuDETırmakNOM;N;3;SG,_geyikNOM;N;3;SGsürüPSS3S;GEN;PL;3;Ndışarı3;N;SG;AT+ABLgelFUT;PFV;V;POT;V.PTCP;POSsaldırı3;N;PL;DATkarşıADPkendiPSS3P;REFL;PRO;ACC;PL;3koruPSS3P;PFV;PST;V;IND;V.PTCP;POSdoğalADJbirNUMsığınakNOM;N;3;SGiPFV;V;PST;IND;SG;3._
	
Olayınilkgünüdüzenlenmişbirraporvarörneğin.	olay3;N;SG;GENilkADJgünPSS3S;NOM;SG;3;NdüzenlePASS;PFV;PST;V;NFH;IND;V.PTCP;POSbirNUMraporNOM;N;3;SGvarADJörneğinCONJ._
	
Oistemediuzatılmasını,neyapayım.	o3;NOM;SG;PROistePST;3;IND;SG;NEG;PFV;VuzaPSS3S;V.MSDR;POS;IND;PRS;PFV;ACC;V,_neSG;3;PRO;NOMyap1;POS;PRS;SG;PFV;OPT;V._
	
Odasoğanı,maydanozu,sirkeyi,zeytini,yumurtayıyardımaçağırır.	oPRO;NOM;3;SGdaCONJsoğanACC;SG;N;3,_maydanozACC;SG;N;3,_sirkeACC;SG;N;3,_zeytinACC;SG;ADJ;3,_yumurtaACC;SG;N;3yardımSG;DAT;N;3çağırIND;POS;3;PRS;SG;HAB;V._
	
Nesandınsenbeni.	neNOM;3;PRO;SGsanPFV;2;PST;V;IND;SG;POSsenPRO;2;NOM;SGben1;PRO;ACC;SG._
	
Yürüdüğümüzyolbitmiş,birbaşkasokağaaçılmıştı.	yürüPSS1P;PST;POS;IND;PFV;V.PTCP;VyolSG;3;N;NOMbitPST;3;POS;IND;SG;PFV;V;NFH,_birNUMbaşkaADJsokakSG;DAT;N;3açPASS;3;POS;IND;SG;PFV;PST+PRF;V._
	
Hepimizkıraathaneyegelenbuyabancıyadikkatlebakıyorduk.	hep<unk>kıraathaneSG;DAT;N;3gelIND;POS;PRS;PFV;V.PTCP;VbuDETyabancıSG;DAT;ADJ;3dikkatSG;INS;N;3bakINFM;IND;PST;POS;1;PROG;PL;V._
	
Netuhaf,dahaöncedikkatimiçekmemişlerdi.	neNOM;3;PRO;SGtuhafNOM;N;3;SG,_dahaADVönceADVdikkatPSS1S;ACC;SG;3;Nçek<unk>._
	
Silisimibeğendiğiiçinyüzbinliraverdi,hemyinegörüşürüzdedi.	silisPSS1S;ACC;SG;3;NbeğenPSS3S;PFV;PST;NOM;V;IND;V.PTCP;POSiçinADPyüzNUMbinNUMliraNOM;N;3;SGverPFV;PST;V;IND;SG;3;POS,_hemADVyineADVgörüş1;HAB;PRS;V;IND;PL;POSdePFV;PST;V;IND;SG;3;POS._
	
Yavaşçayanınayaklaştım.	YavaşçaADVyanPSS3S;ADJ;SG;3;DATyaklaş1;PFV;PST;V;IND;SG;POS._
	
Gidiyorum,parkagidiyorumyeniden.	git1;POS;IND;PRS;INFM;SG;PROG;V,_parkSG;DAT;N;3git1;POS;IND;PRS;INFM;SG;PROG;VyenidenADV._
	
Niyeolmasın;işhayatındakibaşarınınsırrı,ciddiyet;güvenilirolmak,amaençokdatakipçiliktir,bütünbunlardayeğenlerdefazlasıylavardoğrusu.	niyeADVolNEG;PFV;PRS;V;SG;3;IMP;_işNOM;N;3;SGhayatPSS3S;SG;3;N;ESSkiADPbaşarı3;N;SG;GENsırPSS3S;NOM;SG;3;N,_ciddiyetNOM;N;3;SG;_güvenPASS;HAB;PRS;V;IND;V.PTCP;POSolV.MSDR;PFV;PRS;NOM;V;IND;POS,_amaCONJenADVçokADVdaCONJtakipçilikNOM;N;3;SGiPFV;PRS;V;SG;3,_bütünADJbuPRO;NOM;PL;3daCONJyeğen3;N;PL;ESSfazlasıylaADVvarPFV;PRS;2;V;SG;IMP;POSdoğruPSS3S;NOM;ADJ;SG;3._
	
Öncekahvelerimiziiçelimde...	önceADVkahvePSS1P;ACC;PL;3;Niç1;OPT;PFV;PRS;V;PL;POSdeCONJ..._
	
Evet.	evetNOM;N;3;SG._
	
Apandistiverahmindekikistialındı.	apandisNOM;N;3;SGiPFV;V;PST;IND;SG;3veCONJrahimPSS3S;SG;3;N;ESSkiADPkistPSS3S;NOM;SG;3;NalPASS;PFV;PST;V;IND;SG;3;POS._
	
Bunuçokiyibiliyorum.	buPRO;ACC;SG;3çokADViyiADJbilINFM;1;PRS;V;IND;PROG;SG;POS._
	
Hattakavramlardadeğil,sözcükler.	hattaCONJkavramNOM;PL;N;3daCONJdeğilNEG;IND;3;PRS;PFV;SG;V,_sözcükNOM;PL;N;3._
	
Gerçekbiredebiyatçıolduğunuteksözcükleaçıkladı.	gerçekADJbirNUMedebiyatçıSG;NOM;N;3olPSS3S;ACC;IND;PST;POS;PFV;V.PTCP;VtekADJsözcükSG;INS;N;3açıklaIND;PST;POS;3;PFV;SG;V._
	
Yerindenkalkmıştı.	yerPSS3S;AT+ABL;3;SG;NkalkIND;POS;3;PFV;SG;PST+PRF;V._
	
Başınıkaldır!	başPSS3S;3;SG;N;ACCkalPOS;PRS;IMP;SG;PFV;2;V;CAUS!_
	
Asgarigarantiikiyılolacak.	asgariADJgarantiNOM;N;3;SGikiNOM;SG;3;NUMyılNOM;N;3;SGolFUT;PFV;V;IND;SG;3;POS._
	
Belkibirdahahiçgiremeyeceğimoraya.	belkiADVbirADVdahaADVhiçADVgir<unk>ora3;DAT;PRO;SG._
	
Dörtokurumuzagörevar.	dörtNUMokurPSS1P;SG;3;N;DATgöreADPvarADJ._
	
SovyetdönemisonrasındayenibiryapılanmayagirenSakaCumhuriyeti'nde,Evenlerdepekçoközelhaklarkazandı.	SovyetSG;NOM;PROPN;3dönemPSS3S;NOM;3;SG;NsonraPSS3S;ESS;3;SG;NyeniADJbirNUMyapılanIND;V.MSDR;POS;DAT;PRS;PFV;VgirIND;POS;PRS;PFV;V.PTCP;VsakaSG;NOM;N;3cumhuriyetPSS3S;ESS;3;SG;N,_EvenlerSG;NOM;PROPN;3deCONJpekADVçokADVözelADJhakNOM;PL;N;3kazanIND;PST;POS;3;PFV;SG;V._
	
Saffet,bağlamanıntellerine,akorduanlamak,sesiayarlamakiçinşöylebirdokundu.	SaffetNOM;PROPN;3;SG,_bağlama3;N;SG;GENtelPSS3S;PL;3;N;DAT,_akort3;N;ACC;SGanlaV.MSDR;PFV;PRS;NOM;V;IND;POS,_ses3;N;ACC;SGayarlaV.MSDR;PFV;PRS;NOM;V;IND;POSiçinADPşöyleADVbirADVdokunPFV;PST;V;IND;SG;3;POS._
	
Saffet,geceleyin,yemeklerbitmeyeyüztutup,içkileryarıyıgeçtiktensonra,teybekoyduğuşarkılarıkeser,bağlamasınıelinealır;küçükbirsahnehalinegetirdiğibirkaçmetrekaregenişliğindeki,birkarışlıkyükseltiyebirtaburekoyar,otururdu.	SaffetNOM;PROPN;3;SG,_geceleyinADV,_yemekNOM;N;PL;3bitV.MSDR;PFV;PRS;V;IND;DAT;POSyüzNOM;N;3;SGtutPFV;PRS;V;IND;POS;V.CVB,_içkiNOM;N;PL;3yarı3;ACC;ADJ;SGgeçAT+ABL;PFV;PST;V;IND;V.PTCP;POSsonraADP,_teyp3;N;DAT;SGkoyPSS3S;PFV;PST;V;IND;V.PTCP;POSşarkı3;N;PL;ACCkesHAB;PRS;V;IND;SG;3;POS,_bağlamaPSS3S;ACC;SG;3;NelPSS3S;SG;3;N;DATalHAB;PRS;V;IND;SG;3;POS;_küçükADJbirNUMsahneNOM;N;3;SGhalPSS3S;SG;3;N;DATgetirPSS3S;PFV;PST;V;IND;V.PTCP;POSbirkaçDETmetrekareNOM;N;3;SGgenişlikPSS3S;SG;3;N;ESSkiADP,_birNUMkarışNOM;N;3;SGlikNOM;ADP;3;SGyükselti3;N;DAT;SGbirNUMtabureNOM;N;3;SGkoyHAB;PRS;V;IND;SG;3;POS,_oturHAB;PST;V;IND;SG;3;POS._
	
Kendişirketindeaskeriyemühimmatsatışıyapardı.	kendiPSS3S;PRO;NOM;3;SG;REFLşirketPSS3S;ESS;3;SG;NaskeriyeSG;NOM;N;3mühimmatSG;NOM;N;3satışPSS3S;NOM;3;SG;NyapIND;PST;POS;3;SG;HAB;V._
	
Rakısofrasınınözevlatlarıyeşillikleriunutmayalım.	rakıNOM;N;3;SGsofraPSS3S;GEN;SG;3;NözADJevlatPSS3S;NOM;PL;3;Nyeşillik3;N;PL;ACCunut1;OPT;NEG;PFV;PRS;V;PL._
	
Dünyanınmerkezindekendisivardı.	dünyaGEN;SG;N;3merkezPSS3S;ESS;3;SG;NkendiPSS3S;PRO;NOM;3;SG;REFLvarIND;PST;POS;3;PFV;SG;V._
	
Özerdeonaelçırparakeşlikediyordu.	ÖzerSG;3;PROPN;NOMdeCONJoDAT;3;SG;PROelSG;3;N;NOMçırpPOS;PRS;IND;V.CVB;PFV;VeşlikSG;3;N;NOMetPST;3;POS;IND;INFM;SG;PROG;V._
	
Kendiaçıklıyor.	kendiPSS3S;3;NOM;REFL;SG;PROaçıkla3;POS;IND;PRS;INFM;SG;PROG;V._
	
Parktançıkıpburayadoğrukoşarkenhepsiaklımdaydı.	parkAT+ABL;SG;N;3çıkIND;POS;PRS;PFV;V.CVB;VburaSG;PRO;DAT;3doğruADPkoşIND;POS;3;PRS;SG;V.CVB;HAB;VhepsiPSS3P;PRO;NOM;3;PLakılPSS1S;ESS;3;SG;NiV;IND;PST;3;PFV;SG._
	
Sonuçtaolayınbuzlanmadanvepilothatasındanmeydanageldiğigibibirneticeyevarılmıştı.	sonuçSG;ESS;N;3olaySG;GEN;N;3buzlanPOS;IND;PRS;PFV;V;AT+ABL;V.MSDRveCONJpilotSG;3;N;NOMhataPSS3S;3;SG;N;AT+ABLmeydanSG;DAT;N;3gelPSS3S;PST;NOM;POS;IND;PFV;V.PTCP;VgibiADPbirNUMneticeSG;DAT;N;3varPASS;3;POS;IND;SG;PFV;PST+PRF;V._
	
Birdilimkavunaldı.	birNUMdilimSG;NOM;N;3kavunSG;NOM;N;3alIND;PST;POS;3;PFV;SG;V._
	
Ozamandamda,ineklerleyatsın.	oNOM;N;3;SGzamanNOM;N;3;SGdam3;N;ESS;SG,_inek3;N;INS;PLyatPFV;PRS;V;SG;3;IMP;POS._
	
Geçicibütçede,Türkiye'ninvergirekortmenleriarasındayeralanTürkiyePetrolleriAnonimOrtaklığı(TPAO)ileKıyıEmniyeti'nin,gelirlerininyüzde10'ununbütçeyeaktarılmasıöngörüldü.	geçiciADJbütçeSG;ESS;N;3,_TürkiyeSG;GEN;PROPN;3vergiSG;3;N;NOMrekortmenPSS3S;3;NOM;PL;NaraPSS3S;3;ADJ;SG;ESSyerSG;3;N;NOMalPOS;PRS;IND;PFV;V.PTCP;VTürkiyeSG;3;PROPN;NOMpetrolPSS3P;3;NOM;SG;NanonimSG;3;N;NOMortaklıkPSS3S;3;NOM;SG;N(_TpaoSG;3;PROPN;NOM)_ileCONJkıyıSG;3;N;NOMemniyetPSS3S;3;SG;N;GEN,_gelirPSS3S;3;PL;N;GENyüz3;SG;NUM;ESS10<unk>bütçeSG;DAT;N;3aktarPSS3S;V.MSDR;PASS;NOM;POS;IND;PRS;PFV;VöngörPASS;PST;3;POS;IND;SG;PFV;V._
	
Biraniçinsokaktakiköpeklernasılhayattakalıyorlardiyedüşündüm.	birNUManNOM;N;3;SGiçinADPsokak3;N;ESS;SGkiADPköpekNOM;N;PL;3nasılADVhayat3;N;ESS;SGkalINFM;PRS;V;IND;PL;PROG;3;POSdiyeADPdüşün1;PFV;PST;V;IND;SG;POS._
	
İthalederler.	ithalNOM;N;3;SGetHAB;PRS;V;IND;PL;3;POS._
	
Böylece,insanlarlaberaberkalveyalnızlığıunut.	böyleceADV,_insan3;N;INS;PLberaberADVkalPFV;PRS;2;V;SG;IMP;POSveCONJyalnızlık3;N;ACC;SGunutPFV;PRS;2;V;SG;IMP;POS._
	
Birtanedebenekleyeyim:Yiyebilirmiyim?diyebayılmış.	birNUMtaneNOM;N;3;SGdeCONJben1;PRO;NOM;SGekle1;OPT;PFV;PRS;V;SG;POS:_yeHAB;PRS;V;POT;SG;3;POSmi1;PFV;PRS;V;IND;SG?_diyeADPbayılPFV;PST;V;NFH;IND;SG;3;POS._
	
Biliminbulgularınınidealizmekarşıeldeetmişolduğubukesinüstünlüğekarşın,bugüngelişmişkapitalistülkelerde,bilimvedin,şizofrenikbiçimdekompartımanlaraayrılmışbiryaşamınikiayrıalanınayerleştirilmişşekilde,birbirlerinedokunmaksızınbarışiçindeyaşamaktadır.	bilimSG;GEN;N;3bulguPSS3S;3;PL;N;GENidealizmSG;DAT;N;3karşıADPelSG;ESS;N;3etPST;3;POS;IND;SG;PFV;V;NFHolPSS3S;PST;POS;IND;PFV;V.PTCP;VbuDETkesinADJüstünlükSG;DAT;N;3karşınADP,_bugünSG;3;N;NOMgelişPST;POS;IND;PFV;V.PTCP;V;NFHkapitalistSG;3;N;NOMülkeESS;PL;N;3,_bilimSG;3;N;NOMveCONJdinSG;3;N;NOM,_şizofrenikADJbiçimSG;ESS;N;3kompartımanPL;DAT;N;3ayrılPST;POS;IND;PFV;V.PTCP;V;NFHbirNUMyaşamSG;GEN;N;3ikiNUMayrıADJalanPSS3S;DAT;3;SG;NyerleşPST;POS;IND;PFV;V.PTCP;V;NFHşekilSG;ESS;N;3,_birbiri<unk>dokunPRS;IND;V.CVB;NEG;PFV;VbarışSG;3;N;NOMiçPSS3S;3;ADJ;SG;ESSyaşa3;POS;FORM;PRS;SG;PROG;V._
	
