<s>at</s>	<s>atlarız</s>	<s>atız</s>
<s>kot</s>	<s>kotları</s>	<s>kotları</s>
<s>haç</s>	<s>haçımızın</s>	<s>haçımızın</s>
<s>baz</s>	<s>bazlardır</s>	<s>bazlardır</s>
<s>azdı</s>	<s>azarlar</s>	<s>azırlar</s>
<s>cami</s>	<s>camilerimi</s>	<s>camilerimi</s>
<s>kora</s>	<s>korlarının</s>	<s>korlarının</s>
<s>dadı</s>	<s>dadında</s>	<s>dadısında</s>
<s>popo</s>	<s>poposu</s>	<s>poposu</s>
<s>lord</s>	<s>lordların</s>	<s>lordların</s>
<s>içim</s>	<s>içleri</s>	<s>içleri</s>
<s>dağa</s>	<s>dağının</s>	<s>dağının</s>
<s>aşın</s>	<s>aşlarından</s>	<s>aşlarından</s>
<s>deney</s>	<s>deneylerinizden</s>	<s>deneylerinizden</s>
<s>görür</s>	<s>görüyordum</s>	<s>görüyordum</s>
<s>çinko</s>	<s>çinkoda</s>	<s>çinkoda</s>
<s>döner</s>	<s>dönecekler</s>	<s>dönecekler</s>
<s>tütün</s>	<s>tütülerin</s>	<s>tütülerin</s>
<s>ojesi</s>	<s>ojenizden</s>	<s>ojenizden</s>
<s>aklar</s>	<s>akımda</s>	<s>akımda</s>
<s>ayına</s>	<s>ayıları</s>	<s>ayıları</s>
<s>işimi</s>	<s>işimizden</s>	<s>işimizden</s>
<s>ekini</s>	<s>ekinin</s>	<s>ekinin</s>
<s>üçgen</s>	<s>üçgenin</s>	<s>üçgenin</s>
<s>haber</s>	<s>haberimize</s>	<s>haberimize</s>
<s>fener</s>	<s>fenerler</s>	<s>fenerler</s>
<s>görüş</s>	<s>görüşlerimizi</s>	<s>görüşlerimizi</s>
<s>peder</s>	<s>pederlerimiz</s>	<s>pederlerimiz</s>
<s>bildi</s>	<s>bilmeyeceksiniz</s>	<s>bilmeyeceksiniz</s>
<s>mügene</s>	<s>mügelerinin</s>	<s>mügelerinin</s>
<s>cüceni</s>	<s>cücelerimize</s>	<s>cücelerimize</s>
<s>uydusu</s>	<s>uydumuza</s>	<s>uydumuza</s>
<s>karnım</s>	<s>karnılarınızda</s>	<s>karınlarınızda</s>
<s>kocaya</s>	<s>kocaları</s>	<s>kocaları</s>
<s>laleme</s>	<s>laleymişsiniz</s>	<s>laleymişsiniz</s>
<s>kenara</s>	<s>kenardan</s>	<s>kenardan</s>
<s>kalfan</s>	<s>kalfanızdan</s>	<s>kalfanızdan</s>
<s>kocama</s>	<s>kocamda</s>	<s>kocamda</s>
<s>kirişi</s>	<s>kirişinize</s>	<s>kirişinize</s>
<s>geçtik</s>	<s>geçmiyordunuz</s>	<s>geçmiyordunuz</s>
<s>yaramı</s>	<s>yaralarınıza</s>	<s>yaralarınıza</s>
<s>eşyana</s>	<s>eşyamız</s>	<s>eşyamız</s>
<s>özünde</s>	<s>özlerinizden</s>	<s>özlerinizden</s>
<s>tıklar</s>	<s>tıkıyordu</s>	<s>tıklıyordu</s>
<s>babaya</s>	<s>babalardık</s>	<s>babalardık</s>
<s>zafere</s>	<s>zaferler</s>	<s>zaferler</s>
<s>kükürt</s>	<s>kütüklere</s>	<s>kükürtlere</s>
<s>netler</s>	<s>netlerinin</s>	<s>netlerinin</s>
<s>yılana</s>	<s>yılanında</s>	<s>yılanında</s>
<s>üretti</s>	<s>üretiyorum</s>	<s>üretiyorum</s>
<s>öcümün</s>	<s>öçleri</s>	<s>öçleri</s>
<s>sesçin</s>	<s>sesçiyi</s>	<s>sesçiyi</s>
<s>kocana</s>	<s>kocalarınız</s>	<s>kocalarınız</s>
<s>kabağı</s>	<s>kabaklarınızın</s>	<s>kabaklarınızın</s>
<s>saydık</s>	<s>saymıyor</s>	<s>saymıyor</s>
<s>cihaza</s>	<s>cihazlarının</s>	<s>cihazlarının</s>
<s>olmadı</s>	<s>oluyordum</s>	<s>oluyordum</s>
<s>tayfan</s>	<s>tayfalarmışız</s>	<s>tayfalarmışız</s>
<s>oymağa</s>	<s>oymağında</s>	<s>oymağında</s>
<s>yedeği</s>	<s>yedeklerdi</s>	<s>yedeklerdi</s>
<s>tütüde</s>	<s>tütümüzü</s>	<s>tütümüzü</s>
<s>koyunu</s>	<s>koylar</s>	<s>koylar</s>
<s>karını</s>	<s>karımıza</s>	<s>karımıza</s>
<s>eşyamı</s>	<s>eşyalardan</s>	<s>eşyalardan</s>
<s>sillen</s>	<s>sillelerde</s>	<s>sillelerde</s>
<s>takımı</s>	<s>takınızdan</s>	<s>takınızdan</s>
<s>meleğe</s>	<s>meleklerin</s>	<s>meleklerin</s>
<s>objede</s>	<s>objelerinde</s>	<s>objelerinde</s>
<s>durduk</s>	<s>duruyordu</s>	<s>duruyordu</s>
<s>elçini</s>	<s>elçilerini</s>	<s>elçilerini</s>
<s>kızmam</s>	<s>kızmayacağız</s>	<s>kızmayacağız</s>
<s>füzede</s>	<s>füzeden</s>	<s>füzeden</s>
<s>âlemim</s>	<s>âlemlerinden</s>	<s>âlemlerinden</s>
<s>âlimim</s>	<s>âlimlerinde</s>	<s>âlimlerinde</s>
<s>kanatı</s>	<s>kanatlardan</s>	<s>kanatlardan</s>
<s>yazmaz</s>	<s>yazmıyordu</s>	<s>yazmıyordu</s>
<s>adımın</s>	<s>adınızı</s>	<s>adınızı</s>
<s>yongan</s>	<s>yongamın</s>	<s>yongamın</s>
<s>terlik</s>	<s>terliğini</s>	<s>terliğini</s>
<s>elmamı</s>	<s>elmaları</s>	<s>elmaları</s>
<s>fosfor</s>	<s>fosforda</s>	<s>fosforda</s>
<s>meşede</s>	<s>meşeyi</s>	<s>meşeyi</s>
<s>argoda</s>	<s>argolardan</s>	<s>argolardan</s>
<s>kızlık</s>	<s>kızlıklarımda</s>	<s>kızlıklarımda</s>
<s>perona</s>	<s>peronunuzdan</s>	<s>peronunuzdan</s>
<s>atmazız</s>	<s>atmadık</s>	<s>atmatık</s>
<s>sikişir</s>	<s>sikişmedi</s>	<s>sikişmedi</s>
<s>süreriz</s>	<s>sürüyorlar</s>	<s>sürüyorlar</s>
<s>asmadım</s>	<s>astı</s>	<s>astı</s>
<s>konunun</s>	<s>konunuzun</s>	<s>konunuzun</s>
<s>gazelin</s>	<s>gazelsiniz</s>	<s>gazelsiniz</s>
<s>içerler</s>	<s>içtin</s>	<s>içtin</s>
<s>zulmüne</s>	<s>zulmümüzü</s>	<s>zulmümüzü</s>
<s>anketim</s>	<s>anketler</s>	<s>anketler</s>
<s>kanarım</s>	<s>kanamayacağım</s>	<s>kanamayacağım</s>
<s>sonuçta</s>	<s>sonuçtuk</s>	<s>sonuçtuk</s>
<s>ilminde</s>	<s>ilmimizi</s>	<s>ilmimizi</s>
<s>bayılma</s>	<s>bayılmalarında</s>	<s>bayılmalarında</s>
<s>kıblesi</s>	<s>kıblemi</s>	<s>kıblemi</s>
<s>kalemiz</s>	<s>kalelerinden</s>	<s>kalelerinden</s>
<s>dededen</s>	<s>dedenin</s>	<s>dedenin</s>
<s>bakmayı</s>	<s>bakmada</s>	<s>bakmada</s>
<s>yağışım</s>	<s>yağışlarına</s>	<s>yağışlarına</s>
<s>asandan</s>	<s>asalarımı</s>	<s>asalarımı</s>
<s>maskara</s>	<s>maskaralarını</s>	<s>maskaralarını</s>
<s>özünüzü</s>	<s>özlerine</s>	<s>özlerine</s>
<s>çırağım</s>	<s>çıraklarız</s>	<s>çıraklarız</s>
<s>kılıfın</s>	<s>kılıflarımıza</s>	<s>kılıflarımıza</s>
<s>uçmuşuz</s>	<s>uçmuşlar</s>	<s>uçmuşlar</s>
<s>acıktım</s>	<s>acıktınız</s>	<s>acıktınız</s>
<s>çığımda</s>	<s>çığları</s>	<s>çığları</s>
<s>iyisine</s>	<s>iyiydiler</s>	<s>iyiydiler</s>
<s>sirkten</s>	<s>sirkinizden</s>	<s>sirkinizden</s>
<s>çıkarır</s>	<s>çıkarmıyoruz</s>	<s>çıkarmıyoruz</s>
<s>eklerdi</s>	<s>eklerimde</s>	<s>eklerimde</s>
<s>getirdi</s>	<s>getirmiyorsun</s>	<s>getirmiyorsun</s>
<s>aldınız</s>	<s>aldım</s>	<s>aldım</s>
<s>ısıları</s>	<s>ısılarına</s>	<s>ısılarına</s>
<s>hunimde</s>	<s>hunilerinin</s>	<s>hunilerinin</s>
<s>dakikam</s>	<s>dakikaların</s>	<s>dakikaların</s>
<s>gondolu</s>	<s>gondolumuzda</s>	<s>gondolumuzda</s>
<s>tütmedi</s>	<s>tütmem</s>	<s>tütmem</s>
<s>öykümüz</s>	<s>öykünüzü</s>	<s>öykünüzü</s>
<s>yolcuna</s>	<s>yolcularını</s>	<s>yolcularını</s>
<s>mazgala</s>	<s>mazgallarımızın</s>	<s>mazgallarımızın</s>
<s>uğrattı</s>	<s>uğratıyor</s>	<s>uğratıyor</s>
<s>saksocu</s>	<s>saksocuymuşlar</s>	<s>saksocuymuşlar</s>
<s>sağımda</s>	<s>sağıydık</s>	<s>sağdık</s>
<s>dışımın</s>	<s>dışlarda</s>	<s>dışlarda</s>
<s>gelişir</s>	<s>gelişmeyeceksin</s>	<s>gelişmeyeceksin</s>
<s>rotorda</s>	<s>rotorlarımızdan</s>	<s>rotorlarımızdan</s>
<s>yürümez</s>	<s>yürümediniz</s>	<s>yürümediniz</s>
<s>çığımın</s>	<s>çığınız</s>	<s>çığınız</s>
<s>kocamın</s>	<s>kocaydık</s>	<s>kocaydık</s>
<s>çilimin</s>	<s>çili</s>	<s>çili</s>
<s>fahişen</s>	<s>fahişelermiş</s>	<s>fahişelermiş</s>
<s>dalgada</s>	<s>dalgamızın</s>	<s>dalgamızın</s>
<s>müezzin</s>	<s>müezzin</s>	<s>müezzinin</s>
<s>âlimler</s>	<s>âlimlersiniz</s>	<s>âlimlersiniz</s>
<s>harcına</s>	<s>harçlarından</s>	<s>harçlarından</s>
<s>çubukta</s>	<s>çubuklarıma</s>	<s>çubuklarıma</s>
<s>çalgısı</s>	<s>çalgılarmışsınız</s>	<s>çalgılarmışsınız</s>
<s>hazcını</s>	<s>hazcıların</s>	<s>hazcıların</s>
<s>balkana</s>	<s>balkamıza</s>	<s>balkanımıza</s>
<s>alışmam</s>	<s>alışmadı</s>	<s>alışmadı</s>
<s>pornomu</s>	<s>pornoma</s>	<s>pornoma</s>
<s>kedimin</s>	<s>kedimize</s>	<s>kedimize</s>
<s>canının</s>	<s>canlarımızı</s>	<s>canlarımızı</s>
<s>belimde</s>	<s>bellerimizi</s>	<s>bellerimizi</s>
<s>üremden</s>	<s>ürenizde</s>	<s>ürenizde</s>
<s>dışının</s>	<s>dışınızın</s>	<s>dışınızın</s>
<s>kalpağa</s>	<s>kalpağın</s>	<s>kalpağın</s>
<s>kümeden</s>	<s>kümeyi</s>	<s>kümeyi</s>
<s>minarem</s>	<s>minarelerinden</s>	<s>minarelerinden</s>
<s>doğumda</s>	<s>doğumuna</s>	<s>doğumuna</s>
<s>rimelim</s>	<s>rimelinden</s>	<s>rimelinden</s>
<s>teklifi</s>	<s>tekliflerine</s>	<s>tekliflerine</s>
<s>belleğe</s>	<s>belleğine</s>	<s>belleğine</s>
<s>taşağın</s>	<s>taşaklarının</s>	<s>taşaklarının</s>
<s>finişte</s>	<s>finişine</s>	<s>finişine</s>
<s>uyumadı</s>	<s>uyuyacaklar</s>	<s>uyuyacaklar</s>
<s>zaferiz</s>	<s>zaferimize</s>	<s>zaferimize</s>
<s>mantiyi</s>	<s>mantisi</s>	<s>mantisi</s>
<s>biçimim</s>	<s>biçimine</s>	<s>biçimine</s>
<s>kobraya</s>	<s>kobradan</s>	<s>kobradan</s>
<s>bastılar</s>	<s>basıyordu</s>	<s>basıyordu</s>
<s>badanayı</s>	<s>badanalarda</s>	<s>badanalarda</s>
<s>masamdan</s>	<s>masalarımızı</s>	<s>masalarımızı</s>
<s>simidime</s>	<s>simitlerim</s>	<s>simitlerim</s>
<s>masanızı</s>	<s>masanda</s>	<s>masanda</s>
<s>yeniliği</s>	<s>yeniliği</s>	<s>yeniliği</s>
<s>delmedik</s>	<s>delmiyorum</s>	<s>delmiyorum</s>
<s>ongenler</s>	<s>ongeci</s>	<s>ongen</s>
<s>lokmanın</s>	<s>lokmasında</s>	<s>lokmasında</s>
<s>boğazıma</s>	<s>boğazlarıma</s>	<s>boğazlarıma</s>
<s>askısını</s>	<s>askıları</s>	<s>askıları</s>
<s>tanıttın</s>	<s>tanıtmıyorsunuz</s>	<s>tanıtmıyorsunuz</s>
<s>hüzününü</s>	<s>hüzünlerinde</s>	<s>hüzünlerinde</s>
<s>eğiliriz</s>	<s>eğilmeyeceksin</s>	<s>eğilmeyeceksin</s>
<s>muzlarım</s>	<s>muzlarımdan</s>	<s>muzlarımdan</s>
<s>keleğime</s>	<s>keleğinizden</s>	<s>keleğinizden</s>
<s>eksenime</s>	<s>eksenlerine</s>	<s>eksenlerine</s>
<s>abiyenin</s>	<s>abiyelere</s>	<s>abiyelere</s>
<s>çıkarmam</s>	<s>çıkardım</s>	<s>çıkardım</s>
<s>canlandı</s>	<s>canlanıyordunuz</s>	<s>canlanıyordunuz</s>
<s>silahına</s>	<s>silahınızın</s>	<s>silahınızın</s>
<s>bipimizi</s>	<s>bipini</s>	<s>bipini</s>
<s>emmezler</s>	<s>emmiyordum</s>	<s>emmiyordum</s>
<s>kupürüme</s>	<s>kupürümden</s>	<s>kupürümden</s>
<s>alnımıza</s>	<s>alnada</s>	<s>alında</s>
<s>kozanıza</s>	<s>kozalarınıza</s>	<s>kozalarınıza</s>
<s>düşünmez</s>	<s>düşünüyorsun</s>	<s>düşünüyorsun</s>
<s>yangınız</s>	<s>yangıymışız</s>	<s>yangınmışız</s>
<s>tıklamaz</s>	<s>tıklamadım</s>	<s>tıklamadım</s>
<s>kesernız</s>	<s>kesermızda</s>	<s>kesermızda</s>
<s>kapınızı</s>	<s>kapımıza</s>	<s>kapımıza</s>
<s>ilâçları</s>	<s>ilâçlarını</s>	<s>ilâçlarını</s>
<s>ürenizde</s>	<s>üreniz</s>	<s>üreniz</s>
<s>gazetede</s>	<s>gazeteni</s>	<s>gazeteni</s>
<s>kozdunuz</s>	<s>kozuz</s>	<s>kozuz</s>
<s>mügesine</s>	<s>mügelerini</s>	<s>mügelerini</s>
<s>rakamımı</s>	<s>rakamlar</s>	<s>rakamlar</s>
<s>embriyom</s>	<s>embriyolarının</s>	<s>embriyolarının</s>
<s>alıyordu</s>	<s>alıyorsun</s>	<s>alıyorsun</s>
<s>balıkçım</s>	<s>balıkçılarından</s>	<s>balıkçılarından</s>
<s>asetonum</s>	<s>asetonunun</s>	<s>asetonunun</s>
<s>ayakkabı</s>	<s>ayakkabının</s>	<s>ayakkabının</s>
<s>kadındık</s>	<s>kadınlarımız</s>	<s>kadınlarımız</s>
<s>otocudan</s>	<s>otocularından</s>	<s>otocularından</s>
<s>şamisene</s>	<s>şamiseni</s>	<s>şamisenini</s>
<s>ittirmez</s>	<s>ittirmiyorsunuz</s>	<s>ittirmiyorsunuz</s>
<s>takıydık</s>	<s>takımızın</s>	<s>takımızın</s>
<s>kuzuyduk</s>	<s>kuzularınızda</s>	<s>kuzularınızda</s>
<s>düzelmez</s>	<s>düzelmedin</s>	<s>düzelmedin</s>
<s>menümüzü</s>	<s>menülerine</s>	<s>menülerine</s>
<s>kabuktan</s>	<s>kabuklardan</s>	<s>kabuklardan</s>
<s>iletinin</s>	<s>iletiye</s>	<s>iletiye</s>
<s>bugünler</s>	<s>bugünümüzden</s>	<s>bugünümüzden</s>
<s>aramadım</s>	<s>aramayacağım</s>	<s>aramayacağım</s>
<s>hanımlar</s>	<s>hanımlarsınız</s>	<s>hanımlarsınız</s>
<s>ağdacısı</s>	<s>ağdacılarmışız</s>	<s>ağdacılarmışız</s>
<s>limonunu</s>	<s>limonları</s>	<s>limonları</s>
<s>söğütler</s>	<s>söğütlerine</s>	<s>söğütlerine</s>
<s>bitirmez</s>	<s>bitirmediniz</s>	<s>bitirmediniz</s>
<s>bacandan</s>	<s>bacalarınızda</s>	<s>bacalarınızda</s>
<s>haritayı</s>	<s>haritalarında</s>	<s>haritalarında</s>
<s>bacınıza</s>	<s>bacıları</s>	<s>bacıları</s>
<s>bikinide</s>	<s>bikinilerime</s>	<s>bikinilerime</s>
<s>sonuçtuk</s>	<s>sonuçlarında</s>	<s>sonuçlarında</s>
<s>plağımın</s>	<s>plağımızın</s>	<s>plağımızın</s>
<s>menisine</s>	<s>menüsünü</s>	<s>menisini</s>
<s>destanda</s>	<s>destanların</s>	<s>destanların</s>
<s>tozların</s>	<s>tozlarına</s>	<s>tozlarına</s>
<s>başkente</s>	<s>başkentinizin</s>	<s>başkentinizin</s>
<s>sülükler</s>	<s>sülük</s>	<s>sülük</s>
<s>cadılığı</s>	<s>cadılıkta</s>	<s>cadılıkta</s>
<s>kokladın</s>	<s>kokluyordu</s>	<s>kokluyordu</s>
<s>akdoğanı</s>	<s>akdoğan</s>	<s>akdoğan</s>
<s>dolaptan</s>	<s>dolaplarını</s>	<s>dolaplarını</s>
<s>aklımdan</s>	<s>aklımızda</s>	<s>aklımızda</s>
<s>öldürdün</s>	<s>öldürmedik</s>	<s>öldürmedik</s>
<s>tozlarız</s>	<s>tozlarından</s>	<s>tozlarından</s>
<s>krizimde</s>	<s>krizinizi</s>	<s>krizinizi</s>
<s>beyindik</s>	<s>beyinler</s>	<s>beyinler</s>
<s>işiyoruz</s>	<s>işemediler</s>	<s>işemediler</s>
<s>sistemim</s>	<s>sisteminde</s>	<s>sisteminde</s>
<s>aksanlar</s>	<s>aksan</s>	<s>aksan</s>
<s>cepheniz</s>	<s>cephesine</s>	<s>cephesine</s>
<s>sarısını</s>	<s>sarısında</s>	<s>sarısında</s>
<s>turşunun</s>	<s>turşunda</s>	<s>turşusunda</s>
<s>göçümüzü</s>	<s>göçün</s>	<s>göçün</s>
<s>keçisine</s>	<s>keçilerinizde</s>	<s>keçilerinizde</s>
<s>incirini</s>	<s>inciriniz</s>	<s>inciriniz</s>
<s>salatamı</s>	<s>salatamızda</s>	<s>salatamızda</s>
<s>çiçenizi</s>	<s>çiçelermiş</s>	<s>çiçelermiş</s>
<s>kokulara</s>	<s>kokularının</s>	<s>kokularının</s>
<s>çalışmaz</s>	<s>çalışmıyordu</s>	<s>çalışmıyordu</s>
<s>ölçüşmez</s>	<s>ölçüşmezler</s>	<s>ölçüşmezler</s>
<s>arıyorum</s>	<s>aramıyorum</s>	<s>aramıyorum</s>
<s>kalamara</s>	<s>kalamarımızda</s>	<s>kalamarımızda</s>
<s>eylülünü</s>	<s>eylüllerinin</s>	<s>eylüllerinin</s>
<s>piyanoda</s>	<s>piyanolarına</s>	<s>piyanolarına</s>
<s>uzuneşek</s>	<s>uzuneşeğe</s>	<s>uzuneşeğe</s>
<s>yazmadan</s>	<s>yazmalarımızdan</s>	<s>yazmalarımızdan</s>
<s>çizginde</s>	<s>çizgimizin</s>	<s>çizgimizin</s>
<s>çillerde</s>	<s>çilim</s>	<s>çilim</s>
<s>kurallar</s>	<s>kurallar</s>	<s>kurallar</s>
<s>kesmedin</s>	<s>kesti</s>	<s>kesti</s>
<s>balıktan</s>	<s>balığında</s>	<s>balığında</s>
<s>bandajım</s>	<s>bandajları</s>	<s>bandajları</s>
<s>mumyalar</s>	<s>mumyalarımızdan</s>	<s>mumyalarımızdan</s>
<s>günümüzü</s>	<s>gününden</s>	<s>gününden</s>
<s>çedardık</s>	<s>çedarlarını</s>	<s>çedarlarını</s>
<s>dizileri</s>	<s>diziler</s>	<s>diziler</s>
<s>lordunda</s>	<s>lordumuza</s>	<s>lordumuza</s>
<s>oyumuzda</s>	<s>oyunuzun</s>	<s>oyunuzun</s>
<s>çıpanızı</s>	<s>çıpaya</s>	<s>çıpaya</s>
<s>aynalara</s>	<s>aynalar</s>	<s>aynalar</s>
<s>kaderimi</s>	<s>kaderlere</s>	<s>kaderlere</s>
<s>iblisime</s>	<s>iblisinin</s>	<s>iblisinin</s>
<s>otogarım</s>	<s>otogarlarımdan</s>	<s>otogarlarımdan</s>
<s>çapımdan</s>	<s>çaplarınızdan</s>	<s>çaplarınızdan</s>
<s>tabanını</s>	<s>tabanlarımızdan</s>	<s>tabanlarımızdan</s>
<s>kutuları</s>	<s>kutumuz</s>	<s>kutumuz</s>
<s>itiyordu</s>	<s>itiyorlardı</s>	<s>itiyorlardı</s>
<s>atmaacak</s>	<s>atmamıyorsunuz</s>	<s>atmamıyorsunuz</s>
<s>bokumdan</s>	<s>bokunun</s>	<s>bokunun</s>
<s>aşkınızı</s>	<s>aşkla</s>	<s>aşka</s>
<s>marmelat</s>	<s>mahzenlerin</s>	<s>marmelatların</s>
<s>haberimi</s>	<s>haberleriniz</s>	<s>haberleriniz</s>
<s>reçelden</s>	<s>reçeller</s>	<s>reçeller</s>
<s>pipisine</s>	<s>pipimi</s>	<s>pipimi</s>
<s>konuşuruz</s>	<s>konuşmuyordun</s>	<s>konuşmuyordun</s>
<s>tacınızda</s>	<s>taçlarınızdan</s>	<s>taçlarınızdan</s>
<s>ittirtmem</s>	<s>ittirtiyorlardı</s>	<s>ittirtiyorlardı</s>
<s>kargaları</s>	<s>karga</s>	<s>karga</s>
<s>tatlılara</s>	<s>tatlıları</s>	<s>tatlıları</s>
<s>pazılarda</s>	<s>pazı</s>	<s>pazı</s>
<s>baharatın</s>	<s>baharatlarım</s>	<s>baharatlarım</s>
<s>gözlemden</s>	<s>gözlem</s>	<s>gözlem</s>
<s>şeylerdik</s>	<s>şeylerimizi</s>	<s>şeylerimizi</s>
<s>bitirmedi</s>	<s>bitirirler</s>	<s>bitirirler</s>
<s>modelinin</s>	<s>modelimiz</s>	<s>modelimiz</s>
<s>tulumunuz</s>	<s>tulumunun</s>	<s>tulumunun</s>
<s>masamızda</s>	<s>masanızın</s>	<s>masanızın</s>
<s>kıbleleri</s>	<s>kıblelerinizi</s>	<s>kıblelerinizi</s>
<s>abadinden</s>	<s>abadimizi</s>	<s>abadimizi</s>
<s>sendromda</s>	<s>sendromu</s>	<s>sendromu</s>
<s>tayfasına</s>	<s>tayfamızdan</s>	<s>tayfamızdan</s>
<s>ebediliğe</s>	<s>ebediliğinizin</s>	<s>ebediliğinizin</s>
<s>gazelleri</s>	<s>gazellerimizden</s>	<s>gazellerimizden</s>
<s>masanızda</s>	<s>masa</s>	<s>masa</s>
<s>ağladılar</s>	<s>ağlamam</s>	<s>ağlamam</s>
<s>deneyimde</s>	<s>deneyimi</s>	<s>deneyimi</s>
<s>nosyonunu</s>	<s>nosyonu</s>	<s>nosyonu</s>
<s>cezeryeme</s>	<s>cezeryelerinden</s>	<s>cezeryelerinden</s>
<s>otogarlar</s>	<s>otogarı</s>	<s>otogarı</s>
<s>erkeceyin</s>	<s>erkeceylerinizi</s>	<s>erkeceylerinizi</s>
<s>karpuzunu</s>	<s>karpuzlarında</s>	<s>karpuzlarında</s>
<s>duyuyordu</s>	<s>duymayacaklar</s>	<s>duymayacaklar</s>
<s>içeceğine</s>	<s>içecekler</s>	<s>içecekler</s>
<s>gafınızın</s>	<s>gaflarını</s>	<s>gaflarını</s>
<s>oyalamadı</s>	<s>oyalamayacağız</s>	<s>oyalamayacağız</s>
<s>eksikliğe</s>	<s>eksikliklerimizden</s>	<s>eksikliklerimizden</s>
<s>menekşede</s>	<s>menekşelerdik</s>	<s>menekşelerdik</s>
<s>şaşıyoruz</s>	<s>şaşıyorlar</s>	<s>şaşıyorlar</s>
<s>ehemmiyet</s>	<s>ehemmiyetlerinde</s>	<s>ehemmiyetlerinde</s>
<s>hecenizde</s>	<s>hecelerimizde</s>	<s>hecelerimizde</s>
<s>ayılarmış</s>	<s>ayılardan</s>	<s>ayılardan</s>
<s>büzüğünde</s>	<s>büzüklerinde</s>	<s>büzüklerinde</s>
<s>asalarına</s>	<s>asalarım</s>	<s>asalarım</s>
<s>aktörleri</s>	<s>aktörleriniz</s>	<s>aktörleriniz</s>
<s>alıcımdan</s>	<s>alıçlarını</s>	<s>alıçlarını</s>
<s>odacılara</s>	<s>odacılarmış</s>	<s>odacılarmış</s>
<s>kurumunda</s>	<s>kurumlarımızı</s>	<s>kurumlarımızı</s>
<s>sınırımın</s>	<s>sınırımıza</s>	<s>sınırımıza</s>
<s>dilberine</s>	<s>dilberlere</s>	<s>dilberlere</s>
<s>eklerimin</s>	<s>ekleriz</s>	<s>ekleriz</s>
<s>meninizin</s>	<s>menilerinden</s>	<s>menilerinden</s>
<s>kılımızın</s>	<s>kıllarımızı</s>	<s>kıllarımızı</s>
<s>eziyetine</s>	<s>eziyetinize</s>	<s>eziyetinize</s>
<s>krakerini</s>	<s>krakerlerimizden</s>	<s>krakerlerimizden</s>
<s>çözeltime</s>	<s>çözelti</s>	<s>çözelti</s>
<s>integrale</s>	<s>integralimizin</s>	<s>integralimizin</s>
<s>ettirttik</s>	<s>ettirteceksin</s>	<s>ettirteceksin</s>
<s>gözlemeye</s>	<s>gözlemelerinde</s>	<s>gözlemelerinde</s>
<s>nohutları</s>	<s>nohutları</s>	<s>nohutları</s>
<s>laçolardı</s>	<s>laçolarınızın</s>	<s>laçolarınızın</s>
<s>menekşede</s>	<s>menekşemiz</s>	<s>menekşemiz</s>
<s>proxyleri</s>	<s>proxyde</s>	<s>proxyde</s>
<s>tecrübeyi</s>	<s>tecrübelerini</s>	<s>tecrübelerini</s>
<s>uyuyordun</s>	<s>uymazlar</s>	<s>uyumazlar</s>
<s>gelinliği</s>	<s>gelinliği</s>	<s>gelinliği</s>
<s>öğretmedi</s>	<s>öğretmeyeceğim</s>	<s>öğretmeyeceğim</s>
<s>sağımızda</s>	<s>sağlar</s>	<s>sağlar</s>
<s>sonuçları</s>	<s>sonucundan</s>	<s>sonucundan</s>
<s>filimizde</s>	<s>filime</s>	<s>filime</s>
<s>asetonumu</s>	<s>asetonlarında</s>	<s>asetonlarında</s>
<s>sözümüzde</s>	<s>sözümün</s>	<s>sözümün</s>
<s>içlerinde</s>	<s>içimin</s>	<s>içimin</s>
<s>kelliğine</s>	<s>kelliğimizin</s>	<s>kelliğimizin</s>
<s>sayfanızı</s>	<s>sayfasınız</s>	<s>sayfasınız</s>
<s>bitimizde</s>	<s>bitiydik</s>	<s>bittik</s>
<s>âlemimizi</s>	<s>âlemlerinden</s>	<s>âlemlerinden</s>
<s>popoların</s>	<s>poponun</s>	<s>poponun</s>
<s>sisimizde</s>	<s>sislerinizde</s>	<s>sislerinizde</s>
<s>şaşırmadı</s>	<s>şaşıracağım</s>	<s>şaşıracağım</s>
<s>yapmasına</s>	<s>yapmaların</s>	<s>yapmaların</s>
<s>kılıfımın</s>	<s>kılıflarımızı</s>	<s>kılıflarımızı</s>
<s>korsanına</s>	<s>korsanında</s>	<s>korsanında</s>
<s>aksanımda</s>	<s>aksan</s>	<s>aksan</s>
<s>beyazımın</s>	<s>beyazınıza</s>	<s>beyazınıza</s>
<s>kaçağında</s>	<s>kaçaklardan</s>	<s>kaçaklardan</s>
<s>akşamımız</s>	<s>akşamlarımıza</s>	<s>akşamlarımıza</s>
<s>çaplarmış</s>	<s>çaplar</s>	<s>çaplar</s>
<s>çiziyordu</s>	<s>çizdik</s>	<s>çizdik</s>
<s>ekimizden</s>	<s>eklerinden</s>	<s>eklerinden</s>
<s>rubainize</s>	<s>rubailerinin</s>	<s>rubailerinin</s>
<s>hunilerim</s>	<s>hunilerimizden</s>	<s>hunilerimizden</s>
<s>dişleğime</s>	<s>dişleklerde</s>	<s>dişleklerde</s>
<s>tapacağız</s>	<s>tapmıyorum</s>	<s>tapmıyorum</s>
<s>uyanırsın</s>	<s>uyanmazlar</s>	<s>uyanmazlar</s>
<s>baykuşlar</s>	<s>baykuşumuzdan</s>	<s>baykuşumuzdan</s>
<s>sürücünüz</s>	<s>sürücümüzü</s>	<s>sürücümüzü</s>
<s>kaşarının</s>	<s>kaşarlarımızı</s>	<s>kaşarlarımızı</s>
<s>sebepleri</s>	<s>sebeplerinin</s>	<s>sebeplerinin</s>
<s>lezzetler</s>	<s>lezzetlerini</s>	<s>lezzetlerini</s>
<s>istemcini</s>	<s>istemciye</s>	<s>istemciye</s>
<s>oyalamadı</s>	<s>oyalamadık</s>	<s>oyalamadık</s>
<s>nisanının</s>	<s>nisanlarımı</s>	<s>nisanlarımı</s>
<s>tenlerini</s>	<s>tenimi</s>	<s>tenimi</s>
<s>elmasının</s>	<s>elmanın</s>	<s>elmasın</s>
<s>çemberini</s>	<s>çemberlerimizi</s>	<s>çemberlerimizi</s>
<s>kızanlara</s>	<s>kızanından</s>	<s>kızanından</s>
<s>ayılarmış</s>	<s>ayılarınıza</s>	<s>ayılarınıza</s>
<s>eşiklerde</s>	<s>eşiklerinde</s>	<s>eşiklerinde</s>
<s>laleleriz</s>	<s>lalemizden</s>	<s>lalemizden</s>
<s>odasından</s>	<s>odalarımızda</s>	<s>odalarımızda</s>
<s>çaplarımı</s>	<s>çaplarsınız</s>	<s>çapsınız</s>
<s>körlerdik</s>	<s>körlermişiz</s>	<s>körlermişiz</s>
<s>biçiminiz</s>	<s>biçimlerinden</s>	<s>biçimlerinden</s>
<s>sunağımız</s>	<s>sunağının</s>	<s>sunağının</s>
<s>büküyoruz</s>	<s>bükmüyordu</s>	<s>bükmüyordu</s>
<s>garajında</s>	<s>garaj</s>	<s>garaj</s>
<s>ilerimizi</s>	<s>ilerin</s>	<s>ilerin</s>
<s>şampiyona</s>	<s>şampiyonlarından</s>	<s>şampiyonlarından</s>
<s>çıktısına</s>	<s>çıktılar</s>	<s>çıktılar</s>
<s>abartırız</s>	<s>abartıyorlardı</s>	<s>abartıyorlardı</s>
<s>kararıyor</s>	<s>kararmam</s>	<s>kararmam</s>
<s>dalgıcıma</s>	<s>dalgıçlarına</s>	<s>dalgıçlarına</s>
<s>olayların</s>	<s>olayının</s>	<s>olayının</s>
<s>dönemlere</s>	<s>dönemler</s>	<s>dönemler</s>
<s>boşanacak</s>	<s>boşandılar</s>	<s>boşandılar</s>
<s>ağdacıdan</s>	<s>ağdacılarımızda</s>	<s>ağdacılarımızda</s>
<s>yalancısı</s>	<s>yalancımızı</s>	<s>yalancımızı</s>
<s>destanını</s>	<s>destanlarımıza</s>	<s>destanlarımıza</s>
<s>terliğine</s>	<s>terliğinizde</s>	<s>terliğinizde</s>
<s>dişlisini</s>	<s>dişlilerini</s>	<s>dişlilerini</s>
<s>kulübemiz</s>	<s>kulübemden</s>	<s>kulübemden</s>
<s>bluzumdan</s>	<s>bluzunun</s>	<s>bluzunun</s>
<s>şatomuzun</s>	<s>şatolarımızdan</s>	<s>şatolarımızdan</s>
<s>amcamızda</s>	<s>amcaya</s>	<s>amcaya</s>
<s>kunduzlar</s>	<s>kunduzu</s>	<s>kunduzu</s>
<s>şuurlarda</s>	<s>şuurlarımıza</s>	<s>şuurlarımıza</s>
<s>gübrenize</s>	<s>gübreyi</s>	<s>gübreyi</s>
<s>tulumunun</s>	<s>tulumları</s>	<s>tulumları</s>
<s>elçimizin</s>	<s>elçin</s>	<s>elçin</s>
<s>destanımı</s>	<s>destanın</s>	<s>destanın</s>
<s>donmanıza</s>	<s>donmanda</s>	<s>donmanda</s>
<s>haberinin</s>	<s>haberime</s>	<s>haberime</s>
<s>tarçından</s>	<s>tarçlarda</s>	<s>tarçınlarda</s>
<s>eğlencesi</s>	<s>eğlenceydiler</s>	<s>eğlenceydiler</s>
<s>boklarımı</s>	<s>boku</s>	<s>boku</s>
<s>mantilere</s>	<s>mantiniz</s>	<s>mantiniz</s>
<s>yayasınız</s>	<s>yayalardı</s>	<s>yayalardı</s>
<s>şubatlara</s>	<s>şubatınızı</s>	<s>şubatınızı</s>
<s>arabalara</s>	<s>arabalarımızın</s>	<s>arabalarımızın</s>
<s>pijamanda</s>	<s>pijamalarımızda</s>	<s>pijamalarımızda</s>
<s>kalemizin</s>	<s>kalene</s>	<s>kalene</s>
<s>bilinçler</s>	<s>bilincimizin</s>	<s>bilincimizin</s>
<s>akışkanın</s>	<s>akışkanlardan</s>	<s>akışkanlardan</s>
<s>filizinin</s>	<s>filizlerinizden</s>	<s>filizlerinizden</s>
<s>kitabemde</s>	<s>kitabelerinden</s>	<s>kitabelerinden</s>
<s>bakmanızı</s>	<s>bakmayı</s>	<s>bakmayı</s>
<s>meşalemin</s>	<s>meşalesiniz</s>	<s>meşalesiniz</s>
<s>leşlerden</s>	<s>leşlerinde</s>	<s>leşlerinde</s>
<s>ağlamıyor</s>	<s>ağlayacak</s>	<s>ağlayacak</s>
<s>göğsümüze</s>	<s>göğüsleri</s>	<s>göğüsleri</s>
<s>utlarımız</s>	<s>utumuzun</s>	<s>udumuzun</s>
<s>haşefeden</s>	<s>haşefelerimden</s>	<s>haşefelerimden</s>
<s>büzlerime</s>	<s>büzünde</s>	<s>büzünde</s>
<s>çantaları</s>	<s>çantası</s>	<s>çantası</s>
<s>kartaldan</s>	<s>kartallarından</s>	<s>kartallarından</s>
<s>çıpalarda</s>	<s>çıpalar</s>	<s>çıpalar</s>
<s>sapanımda</s>	<s>sapanımızdan</s>	<s>sapanımızdan</s>
<s>balkanıma</s>	<s>balkanlardık</s>	<s>balkanlardık</s>
<s>geyşamıza</s>	<s>geyşanızı</s>	<s>geyşanızı</s>
<s>otlarında</s>	<s>otlarınıza</s>	<s>otlarınıza</s>
<s>perimizin</s>	<s>perilerinde</s>	<s>perilerinde</s>
<s>madalyaya</s>	<s>madalyaları</s>	<s>madalyaları</s>
<s>sakızınız</s>	<s>sakızına</s>	<s>sakızına</s>
<s>göğsümüzü</s>	<s>göğse</s>	<s>göğse</s>
<s>içeceğini</s>	<s>içeceklerim</s>	<s>içeceklerim</s>
<s>içermedik</s>	<s>içermezsin</s>	<s>içermezsin</s>
<s>objelerde</s>	<s>objeler</s>	<s>objeler</s>
<s>mananızın</s>	<s>mananız</s>	<s>mananız</s>
<s>sapıklarım</s>	<s>sapığı</s>	<s>sapığı</s>
<s>haberinize</s>	<s>haberde</s>	<s>haberde</s>
<s>yaratından</s>	<s>yaratılarmış</s>	<s>yaratılarmış</s>
<s>keleğinden</s>	<s>keleğinizi</s>	<s>keleğinizi</s>
<s>tahtımızda</s>	<s>tahtlarımızda</s>	<s>tahtlarımızda</s>
<s>adamlarına</s>	<s>adamlarımızda</s>	<s>adamlarımızda</s>
<s>çekiçlerde</s>	<s>çekicimizden</s>	<s>çekicimizden</s>
<s>yolcularım</s>	<s>yolcularına</s>	<s>yolcularına</s>
<s>yedirmedim</s>	<s>yedirmeyeceksiniz</s>	<s>yedirmeyeceksiniz</s>
<s>patronunda</s>	<s>patronlardır</s>	<s>patronlardır</s>
<s>bükmememiz</s>	<s>bükmemenin</s>	<s>bükmemenin</s>
<s>fokumuzdan</s>	<s>fokla</s>	<s>foka</s>
<s>seslerimde</s>	<s>sesler</s>	<s>sesler</s>
<s>filminizin</s>	<s>filmlerimizden</s>	<s>filmlerimizden</s>
<s>zeytinlere</s>	<s>zeytin</s>	<s>zeytin</s>
<s>tutkunuzda</s>	<s>tutkunuzu</s>	<s>tutkunuzu</s>
<s>spamlarımı</s>	<s>spamlarına</s>	<s>spamlarına</s>
<s>sağlarımın</s>	<s>sağlarım</s>	<s>sağlarım</s>
<s>soygazımız</s>	<s>soygazlarında</s>	<s>soygazlarında</s>
<s>jeolojiden</s>	<s>jeolojinin</s>	<s>jeolojinin</s>
<s>başkentime</s>	<s>başkentimi</s>	<s>başkentimi</s>
<s>misketimin</s>	<s>misketlerden</s>	<s>misketlerden</s>
<s>buluyorduk</s>	<s>buldunuz</s>	<s>buladınız</s>
<s>yörelerine</s>	<s>yöremden</s>	<s>yöremden</s>
<s>fişeğinizi</s>	<s>fişeklerini</s>	<s>fişeklerini</s>
<s>kunduzumuz</s>	<s>kunduzlardık</s>	<s>kunduzlardık</s>
<s>gözlerinin</s>	<s>gözlerine</s>	<s>gözlerine</s>
<s>insanımsım</s>	<s>insanımsının</s>	<s>insanımsının</s>
<s>seçmesinin</s>	<s>seçmelerden</s>	<s>seçmelerden</s>
<s>yaratısına</s>	<s>yaratılarına</s>	<s>yaratılarına</s>
<s>kümbetiniz</s>	<s>kümbetimden</s>	<s>kümbetimden</s>
<s>tenisçinin</s>	<s>tenisçilerinden</s>	<s>tenisçilerinden</s>
<s>yıldızında</s>	<s>yıldızına</s>	<s>yıldızına</s>
<s>konuyordum</s>	<s>konmayacaksınız</s>	<s>konmayacaksınız</s>
<s>çapalarıma</s>	<s>çapamda</s>	<s>çapamda</s>
<s>neneydiniz</s>	<s>neneyi</s>	<s>neneyi</s>
<s>iyeliklere</s>	<s>iyeliklerimiz</s>	<s>iyeliklerimiz</s>
<s>hükûmetine</s>	<s>hükûmetinde</s>	<s>hükûmetinde</s>
<s>önerimizde</s>	<s>önerilerine</s>	<s>önerilerine</s>
<s>daldırtmaz</s>	<s>daldırttık</s>	<s>daldırtdık</s>
<s>demircimin</s>	<s>demirciniz</s>	<s>demirciniz</s>
<s>sapıksınız</s>	<s>sapığını</s>	<s>sapığını</s>
<s>güreşlerde</s>	<s>güreşinizde</s>	<s>güreşinizde</s>
<s>ölümünüzde</s>	<s>ölümümüzde</s>	<s>ölümümüzde</s>
<s>dondurmanı</s>	<s>dondurmanızın</s>	<s>dondurmanızın</s>
<s>mantisinin</s>	<s>mantimden</s>	<s>mantimden</s>
<s>sıpamızdan</s>	<s>sıpalarımda</s>	<s>sıpalarımda</s>
<s>cimcimeler</s>	<s>cimcimelerdir</s>	<s>cimcimelerdir</s>
<s>bakandılar</s>	<s>bakanınızdan</s>	<s>bakanınızdan</s>
<s>yemişlerin</s>	<s>yemişini</s>	<s>yemişini</s>
<s>bölgenizde</s>	<s>bölgelerinden</s>	<s>bölgelerinden</s>
<s>bölüyorlar</s>	<s>bölüyorlardı</s>	<s>bölüyorlardı</s>
<s>kasığınıza</s>	<s>kasıklarında</s>	<s>kasıklarında</s>
<s>sakızlarda</s>	<s>sakızından</s>	<s>sakızından</s>
<s>büstlerimi</s>	<s>büstlerinde</s>	<s>büstlerinde</s>
<s>kaçmıyordu</s>	<s>kaçmayacaklar</s>	<s>kaçmayacaklar</s>
<s>amacımızda</s>	<s>amaçlarımda</s>	<s>amaçlarımda</s>
<s>iffetmişiz</s>	<s>iffetinizi</s>	<s>iffetinizi</s>
<s>kasabımdan</s>	<s>kasaplarından</s>	<s>kasaplarından</s>
<s>ortağımdan</s>	<s>ortaklardı</s>	<s>ortaklardı</s>
<s>kadınından</s>	<s>kadınlarınızın</s>	<s>kadınlarınızın</s>
<s>sormuyorum</s>	<s>soruyordunuz</s>	<s>soruyordunuz</s>
<s>haritamdan</s>	<s>haritaların</s>	<s>haritaların</s>
<s>jonglörden</s>	<s>jonglörlerimize</s>	<s>jonglörlerimize</s>
<s>kimliğimiz</s>	<s>kimliklerine</s>	<s>kimliklerine</s>
<s>ihtiyaçtan</s>	<s>ihtiyaçlarından</s>	<s>ihtiyaçlarından</s>
<s>rüzgârımın</s>	<s>rüzgârlarımdan</s>	<s>rüzgârlarımdan</s>
<s>pornonuzda</s>	<s>pornomda</s>	<s>pornomda</s>
<s>otoculukta</s>	<s>otoculuğunuza</s>	<s>otoculuğunuza</s>
<s>yağlıyorum</s>	<s>yağlarsınız</s>	<s>yağlarsınız</s>
<s>acıkıyorum</s>	<s>acıtır</s>	<s>acıkır</s>
<s>yüzeylerim</s>	<s>yüzeyler</s>	<s>yüzeyler</s>
<s>anlatırsın</s>	<s>anlatmayız</s>	<s>anlatmayız</s>
<s>kuşunuzdan</s>	<s>kuşunu</s>	<s>kuşunu</s>
<s>dalıyorsun</s>	<s>daldınız</s>	<s>daldınız</s>
<s>ocaklarımı</s>	<s>ocaklarınıza</s>	<s>ocaklarınıza</s>
<s>bitişinizi</s>	<s>bitişlerine</s>	<s>bitişlerine</s>
<s>beyitlerde</s>	<s>beyitlerinizi</s>	<s>beyitlerinizi</s>
<s>deleceksin</s>	<s>delmem</s>	<s>delmem</s>
<s>yaratından</s>	<s>yaratını</s>	<s>yaratını</s>
<s>izleyiciye</s>	<s>izleyicisiniz</s>	<s>izleyicisiniz</s>
<s>finalimizi</s>	<s>finallerini</s>	<s>finallerini</s>
<s>gondolumuz</s>	<s>gondollarımın</s>	<s>gondollarımın</s>
<s>körfezlere</s>	<s>körfezlerine</s>	<s>körfezlerine</s>
<s>yeşimlerin</s>	<s>yeşimlerin</s>	<s>yeşimlerin</s>
<s>kıromuzdan</s>	<s>kıroyu</s>	<s>kıroyu</s>
<s>alametinin</s>	<s>alametlerinin</s>	<s>alametlerinin</s>
<s>mumyalarım</s>	<s>mumyalarda</s>	<s>mumyalarda</s>
<s>destanımın</s>	<s>destanlarını</s>	<s>destanlarını</s>
<s>semerimize</s>	<s>semerlerin</s>	<s>semerlerin</s>
<s>ürelerimde</s>	<s>üreyi</s>	<s>üreyi</s>
<s>emmiydiniz</s>	<s>emmime</s>	<s>emmime</s>
<s>yeleğinizi</s>	<s>yeleğimizin</s>	<s>yeleğimizin</s>
<s>lisanımıza</s>	<s>lisan</s>	<s>lisan</s>
<s>kümesinizi</s>	<s>kümeslerimizi</s>	<s>kümeslerimizi</s>
<s>istisnadan</s>	<s>istisnaya</s>	<s>istisnaya</s>
<s>mandalımın</s>	<s>mandallarımızı</s>	<s>mandallarımızı</s>
<s>geyşamızda</s>	<s>geyşanızı</s>	<s>geyşanızı</s>
<s>tundramıza</s>	<s>tundraydılar</s>	<s>tundraydılar</s>
<s>yutmadılar</s>	<s>yutuyorsun</s>	<s>yutuyorsun</s>
<s>hastasının</s>	<s>hastalarına</s>	<s>hastalarına</s>
<s>yoldaşları</s>	<s>yoldaşlarımızdan</s>	<s>yoldaşlarımızdan</s>
<s>yakıyordum</s>	<s>yakmadın</s>	<s>yakmadın</s>
<s>özgürlüğün</s>	<s>özgürlüklerimizden</s>	<s>özgürlüklerimizden</s>
<s>zırtgelini</s>	<s>zırtgelde</s>	<s>zırtgelde</s>
<s>madalyanın</s>	<s>madalyalara</s>	<s>madalyalara</s>
<s>programlar</s>	<s>programımız</s>	<s>programımız</s>
<s>ustalarına</s>	<s>ustalar</s>	<s>ustalar</s>
<s>boşanırsın</s>	<s>boşanmayız</s>	<s>boşanmayız</s>
<s>kışkırttık</s>	<s>kışkırtmıyordu</s>	<s>kışkırtmıyordu</s>
<s>bebeklerin</s>	<s>bebeğimi</s>	<s>bebeğimi</s>
<s>krakerleri</s>	<s>krakerlerine</s>	<s>krakerlerine</s>
<s>delmiyorum</s>	<s>deliyordu</s>	<s>deliyordu</s>
<s>yatağımızı</s>	<s>yatağa</s>	<s>yatağa</s>
<s>fasıklardı</s>	<s>fasığımda</s>	<s>fasığımda</s>
<s>aygıtçığın</s>	<s>aygıtçığınız</s>	<s>aygıtçığınız</s>
<s>kelepçende</s>	<s>kelepçelerimden</s>	<s>kelepçelerimden</s>
<s>tanıtırlar</s>	<s>tanıtırsınız</s>	<s>tanıtırsınız</s>
<s>şeklimizde</s>	<s>şeklisini</s>	<s>şeklini</s>
<s>gündöndümü</s>	<s>gündöndülerin</s>	<s>gündöndülerin</s>
<s>köylümüzde</s>	<s>köylülerim</s>	<s>köylülerim</s>
<s>heykelciğe</s>	<s>heykelciğini</s>	<s>heykelciğini</s>
<s>kardeşliğe</s>	<s>karaciğerlerde</s>	<s>kardeşliklerde</s>
<s>yeşimlerin</s>	<s>yeşimlerinin</s>	<s>yeşimlerinin</s>
<s>doğarsınız</s>	<s>doğuyorlardı</s>	<s>doğuyorlardı</s>
<s>büstlerine</s>	<s>büstünden</s>	<s>büstünden</s>
<s>acıkmazlar</s>	<s>acıkacaklar</s>	<s>acıkacaklar</s>
<s>kılıfınıza</s>	<s>kılıfında</s>	<s>kılıfında</s>
<s>sesçilerdi</s>	<s>sesçileriniz</s>	<s>sesçileriniz</s>
<s>kuzgununuz</s>	<s>kuzgununun</s>	<s>kuzgununun</s>
<s>ninnimizde</s>	<s>ninnilermiş</s>	<s>ninnilermiş</s>
<s>seslerimiz</s>	<s>sesinden</s>	<s>sesinden</s>
<s>çıktısında</s>	<s>çıktılarından</s>	<s>çıktılarından</s>
<s>umurunuzun</s>	<s>umurlarına</s>	<s>umurlarına</s>
<s>basıyorduk</s>	<s>basıyorsunuz</s>	<s>basıyorsunuz</s>
<s>sağrınızın</s>	<s>sağrında</s>	<s>sağrında</s>
<s>parıltıyız</s>	<s>parıltılar</s>	<s>parıltılar</s>
<s>çalmıyoruz</s>	<s>çalacak</s>	<s>çalacak</s>
<s>umurlarına</s>	<s>umurlarından</s>	<s>umurlarından</s>
<s>âlimimizde</s>	<s>âlimlerde</s>	<s>âlimlerde</s>
<s>önerisinde</s>	<s>önerileriniz</s>	<s>önerileriniz</s>
<s>tenisçiniz</s>	<s>tenisçilerini</s>	<s>tenisçilerini</s>
<s>çedarlarız</s>	<s>çedarlar</s>	<s>çedarlar</s>
<s>abarttılar</s>	<s>abartmazlar</s>	<s>abartmazlar</s>
<s>şallarında</s>	<s>şalında</s>	<s>şalında</s>
<s>jölelerine</s>	<s>jölelerden</s>	<s>jölelerden</s>
<s>atomlarını</s>	<s>atomlarımızı</s>	<s>atomlarımızı</s>
<s>buluyordun</s>	<s>bulmuyordum</s>	<s>bulmuyordum</s>
<s>sağlayıcın</s>	<s>sağlayıcılarımızın</s>	<s>sağlayıcılarımızın</s>
<s>zibildiler</s>	<s>zibilleri</s>	<s>zibilleri</s>
<s>kamusların</s>	<s>kamuslarının</s>	<s>kamuslarının</s>
<s>buharlaştı</s>	<s>buharlaşıyorsun</s>	<s>buharlaşıyorsun</s>
<s>pastamızda</s>	<s>pastalarında</s>	<s>pastalarında</s>
<s>barışmıyor</s>	<s>barışıyor</s>	<s>barışıyor</s>
<s>protestona</s>	<s>protestondan</s>	<s>protestondan</s>
<s>gitmemizin</s>	<s>gitmenizin</s>	<s>gitmenizin</s>
<s>kabaklarız</s>	<s>kabağı</s>	<s>kabağı</s>
<s>gösterimin</s>	<s>gösteriyi</s>	<s>gösteriyi</s>
<s>sözleşmesi</s>	<s>sözleşmeler</s>	<s>sözleşmeler</s>
<s>anafazlara</s>	<s>anafazlarım</s>	<s>anafazlarım</s>
<s>fakültemde</s>	<s>fakültesinin</s>	<s>fakültesinin</s>
<s>nutuklarda</s>	<s>nutuklarımı</s>	<s>nutuklarımı</s>
<s>gözlüğünün</s>	<s>gözlüklerinizin</s>	<s>gözlüklerinizin</s>
<s>kümeslerin</s>	<s>kümeslere</s>	<s>kümeslere</s>
<s>aldatmadık</s>	<s>aldattınız</s>	<s>aldattınız</s>
<s>ummanımıza</s>	<s>ummanlardı</s>	<s>ummanlardı</s>
<s>dinletinin</s>	<s>dinletinden</s>	<s>dinletisinden</s>
<s>kalfaların</s>	<s>kalfalarınızda</s>	<s>kalfalarınızda</s>
<s>doğumumuzu</s>	<s>doğumlarıma</s>	<s>doğumlarıma</s>
<s>ortamsınız</s>	<s>ortaktınız</s>	<s>ortamdınız</s>
<s>büküyordun</s>	<s>bükmüyorlar</s>	<s>bükmüyorlar</s>
<s>gecelerimi</s>	<s>gecenize</s>	<s>gecenize</s>
<s>ketçabında</s>	<s>ketçabımda</s>	<s>ketçabımda</s>
<s>eniştelere</s>	<s>eniştelerimiz</s>	<s>eniştelerimiz</s>
<s>diskomuzda</s>	<s>diskosunu</s>	<s>diskosunu</s>
<s>başçığımız</s>	<s>başçığınız</s>	<s>başçığınız</s>
<s>attırdılar</s>	<s>attırdınız</s>	<s>attırdınız</s>
<s>nallarımın</s>	<s>nalımıza</s>	<s>nalımıza</s>
<s>rakamından</s>	<s>rakamlarımızın</s>	<s>rakamlarımızın</s>
<s>kesermızın</s>	<s>keserlarımızı</s>	<s>keserlarımızı</s>
<s>dengesinde</s>	<s>dengemize</s>	<s>dengemize</s>
<s>öksürürler</s>	<s>öksürüyorlar</s>	<s>öksürüyorlar</s>
<s>gerzeğinin</s>	<s>gerzeklersiniz</s>	<s>gerzeklersiniz</s>
<s>işletmemde</s>	<s>işletmeden</s>	<s>işletmeden</s>
<s>takatlarda</s>	<s>takatınızın</s>	<s>takatınızın</s>
<s>asteroidim</s>	<s>asteroidimizin</s>	<s>asteroidimizin</s>
<s>hemşiremize</s>	<s>hemşirelerinden</s>	<s>hemşirelerinden</s>
<s>hindilerime</s>	<s>hindilermişiz</s>	<s>hindilermişiz</s>
<s>idarelerini</s>	<s>idarelerini</s>	<s>idarelerini</s>
<s>yalıtımımın</s>	<s>yalıtımı</s>	<s>yalıtımı</s>
<s>koymuyordum</s>	<s>koydu</s>	<s>koydu</s>
<s>böreklerime</s>	<s>böreğimizden</s>	<s>böreğimizden</s>
<s>alfabelerin</s>	<s>alametin</s>	<s>alfabenin</s>
<s>gösterimize</s>	<s>gösterilerinde</s>	<s>gösterilerinde</s>
<s>çizgilerime</s>	<s>çizgilerden</s>	<s>çizgilerden</s>
<s>ölçtürmeyiz</s>	<s>ölçtürüyorum</s>	<s>ölçtürüyorum</s>
<s>gözlükçümüz</s>	<s>gözlükçüyü</s>	<s>gözlükçüyü</s>
<s>bilyelerdir</s>	<s>bilyeleri</s>	<s>bilyeleri</s>
<s>blogcularız</s>	<s>blogcularmış</s>	<s>blogcularmış</s>
<s>açılıyordum</s>	<s>açılmadınız</s>	<s>açılmadınız</s>
<s>boşalmamıza</s>	<s>boşalmayı</s>	<s>boşalmayı</s>
<s>akılarınıza</s>	<s>akılarının</s>	<s>akılarının</s>
<s>gelişiyoruz</s>	<s>gelişmedim</s>	<s>gelişmedim</s>
<s>bölümünüzde</s>	<s>bölümlerinde</s>	<s>bölümlerinde</s>
<s>meşrubatımı</s>	<s>meşrubatlarına</s>	<s>meşrubatlarına</s>
<s>elmalarımda</s>	<s>elmalara</s>	<s>elmalara</s>
<s>yaratmamdan</s>	<s>yaratmayı</s>	<s>yaratmayı</s>
<s>gösterileri</s>	<s>gösterilerinden</s>	<s>gösterilerinden</s>
<s>ayılarınıza</s>	<s>ayılarım</s>	<s>ayılarım</s>
<s>değiştirdim</s>	<s>değiştirirsiniz</s>	<s>değiştirirsiniz</s>
<s>sosluklarda</s>	<s>sosluklarını</s>	<s>sosluklarını</s>
<s>röntgenimde</s>	<s>röntgenler</s>	<s>röntgenler</s>
<s>anafazlarda</s>	<s>anafazları</s>	<s>anafazları</s>
<s>startlarıma</s>	<s>startlardan</s>	<s>startlardan</s>
<s>kızlığımızı</s>	<s>kızlıklarınızdan</s>	<s>kızlıklarınızdan</s>
<s>oyalıyorsun</s>	<s>oyalmayacaksın</s>	<s>oyalamayacaksın</s>
<s>elipsinizin</s>	<s>elipsine</s>	<s>elipsine</s>
<s>fillerimizi</s>	<s>fillerinde</s>	<s>fillerinde</s>
<s>cikletinize</s>	<s>cikletine</s>	<s>cikletine</s>
<s>titrettiniz</s>	<s>titriyordunuz</s>	<s>titretiyordunuz</s>
<s>yolcularıma</s>	<s>yolcuları</s>	<s>yolcuları</s>
<s>ucubelerine</s>	<s>ucubelermişsiniz</s>	<s>ucubelermişsiniz</s>
<s>paskalyanın</s>	<s>paskalyaların</s>	<s>paskalyaların</s>
<s>yarınınızın</s>	<s>yarınlarımız</s>	<s>yarınlarımız</s>
<s>korsenizden</s>	<s>korselerinin</s>	<s>korselerinin</s>
<s>tütsüymüşüz</s>	<s>tütsünüzden</s>	<s>tütsünüzden</s>
<s>ördeklerine</s>	<s>ördeklerinde</s>	<s>ördeklerinde</s>
<s>kanamıyordu</s>	<s>kanamayacaksınız</s>	<s>kanamayacaksınız</s>
<s>karadulumun</s>	<s>karadullarından</s>	<s>karadullarından</s>
<s>gelişeceğiz</s>	<s>gelişmiyorsunuz</s>	<s>gelişmiyorsunuz</s>
<s>metreslerde</s>	<s>metrese</s>	<s>metrese</s>
<s>gözlükçünde</s>	<s>gözlükçülerimizde</s>	<s>gözlükçülerimizde</s>
<s>bağcığından</s>	<s>bağcıklarını</s>	<s>bağcıklarını</s>
<s>kesyaplarda</s>	<s>kesyapımız</s>	<s>kesyapımız</s>
<s>kılıfımızda</s>	<s>kılıflarından</s>	<s>kılıflarından</s>
<s>ofisimizden</s>	<s>ofislerinin</s>	<s>ofislerinin</s>
<s>düldüllerde</s>	<s>düldüllerinde</s>	<s>düldüllerinde</s>
<s>korsandılar</s>	<s>korsanlarına</s>	<s>korsanlarına</s>
<s>sultanımdan</s>	<s>sultanım</s>	<s>sultanım</s>
<s>paylaşırsın</s>	<s>paylaşmam</s>	<s>paylaşmam</s>
<s>eziyetçiniz</s>	<s>eziyetçilerimiz</s>	<s>eziyetçilerimiz</s>
<s>maktalardan</s>	<s>maktam</s>	<s>maktam</s>
<s>sislerinize</s>	<s>sislerinin</s>	<s>sislerinin</s>
<s>düzeleceğim</s>	<s>düzelmiyorsunuz</s>	<s>düzelmiyorsunuz</s>
<s>gürgenlerde</s>	<s>gürgenlerden</s>	<s>gürgenlerden</s>
<s>kastanyetim</s>	<s>kastanyet</s>	<s>kastanyet</s>
<s>gecikiyorum</s>	<s>gecikiyoruz</s>	<s>gecikiyoruz</s>
<s>köylümüzden</s>	<s>köylülerinizden</s>	<s>köylülerinizden</s>
<s>kırdırmadın</s>	<s>kırdıracak</s>	<s>kırdıracak</s>
<s>gizlenmedin</s>	<s>gizlenirsiniz</s>	<s>gizlenirsiniz</s>
<s>papazınızda</s>	<s>papazlarınızda</s>	<s>papazlarınızda</s>
<s>balamozunun</s>	<s>balamozlarının</s>	<s>balamozlarının</s>
<s>smileyimden</s>	<s>smileyin</s>	<s>smileyin</s>
<s>gitarlardan</s>	<s>gitarların</s>	<s>gitarların</s>
<s>atlarınızda</s>	<s>atlardan</s>	<s>atlardan</s>
<s>madamımızda</s>	<s>madamlarını</s>	<s>madamlarını</s>
<s>mihrabımıza</s>	<s>mihraplarınızdan</s>	<s>mihraplarınızdan</s>
<s>fizikçisini</s>	<s>fizikçilerini</s>	<s>fizikçilerini</s>
<s>fizikçinize</s>	<s>fizikçilerim</s>	<s>fizikçilerim</s>
<s>hurilerimiz</s>	<s>hurilerdiniz</s>	<s>hurilerdiniz</s>
<s>hastalandım</s>	<s>hastalanmaz</s>	<s>hastalanmaz</s>
<s>dedikodumda</s>	<s>dedikoduları</s>	<s>dedikoduları</s>
<s>hırsızlarız</s>	<s>hırsızlarımıza</s>	<s>hırsızlarımıza</s>
<s>acıkıyorsun</s>	<s>acıktık</s>	<s>acıktık</s>
<s>dildomuzdan</s>	<s>dildolarına</s>	<s>dildolarına</s>
<s>sunaklarımı</s>	<s>sunaklarında</s>	<s>sunaklarında</s>
<s>yaratmamdan</s>	<s>yaratma</s>	<s>yaratma</s>
<s>ilerilerine</s>	<s>ilerim</s>	<s>ilerim</s>
<s>ölüyordunuz</s>	<s>ölmüyorduk</s>	<s>ölmüyorduk</s>
<s>eşiklerimiz</s>	<s>eşikmişler</s>	<s>eşikmişler</s>
<s>aldıracağız</s>	<s>aldırıyordum</s>	<s>aldırıyordum</s>
<s>bloglarının</s>	<s>blogunuzdan</s>	<s>blogunuzdan</s>
<s>bakireliğin</s>	<s>bakirliğe</s>	<s>bakireliğe</s>
<s>onarmıyoruz</s>	<s>onarmıyordular</s>	<s>onarmıyordular</s>
<s>sayımlarımı</s>	<s>sayımınızdan</s>	<s>sayımınızdan</s>
<s>seçmesinden</s>	<s>seçmelerimizden</s>	<s>seçmelerimizden</s>
<s>horlarsınız</s>	<s>horluyordunuz</s>	<s>horluyordunuz</s>
<s>aksanımızın</s>	<s>aksanımıza</s>	<s>aksanımıza</s>
<s>karakolumuz</s>	<s>karakolun</s>	<s>karakolun</s>
<s>fıstığından</s>	<s>fıstığının</s>	<s>fıstığının</s>
<s>ağdacısının</s>	<s>ağdacılarınızı</s>	<s>ağdacılarınızı</s>
<s>antioksidan</s>	<s>antioksidanlarda</s>	<s>antioksidanlarda</s>
<s>sıfatınızın</s>	<s>sıfatınızdan</s>	<s>sıfatınızdan</s>
<s>yetişiyoruz</s>	<s>yetişmiyorum</s>	<s>yetişmiyorum</s>
<s>palmiyemizi</s>	<s>palmiyelerime</s>	<s>palmiyelerime</s>
<s>cinmişsiniz</s>	<s>cinimde</s>	<s>cinimde</s>
<s>rakılarınız</s>	<s>rakılarından</s>	<s>rakılarından</s>
<s>patenlerine</s>	<s>patenlere</s>	<s>patenlere</s>
<s>kapatıyorum</s>	<s>kapatıyorlar</s>	<s>kapatıyorlar</s>
<s>günlerinizi</s>	<s>gününe</s>	<s>gününe</s>
<s>ortaklarmış</s>	<s>ortaklarımın</s>	<s>ortaklarımın</s>
<s>aldatmazsın</s>	<s>aldatmadın</s>	<s>aldatmadın</s>
<s>aldırtmatın</s>	<s>aldırtmayacağız</s>	<s>aldırtmaacağız</s>
<s>çedarınızda</s>	<s>çedarında</s>	<s>çedarında</s>
<s>üşenmiyoruz</s>	<s>üşenirsiniz</s>	<s>üşenirsiniz</s>
<s>emlakçımıza</s>	<s>emlakçılar</s>	<s>emlakçılar</s>
<s>laçoymuşlar</s>	<s>laçomuz</s>	<s>laçomuz</s>
<s>çökerticiye</s>	<s>çökerticilerimiz</s>	<s>çökerticilerimiz</s>
<s>mağaraların</s>	<s>mağaramızın</s>	<s>mağaramızın</s>
<s>erkekliğini</s>	<s>erkekliğin</s>	<s>erkekliğin</s>
<s>okullarınız</s>	<s>okullarından</s>	<s>okullarından</s>
<s>gençliğinin</s>	<s>gençliklerinizi</s>	<s>gençliklerinizi</s>
<s>döndürmedim</s>	<s>döndürmüyorsun</s>	<s>döndürmüyorsun</s>
<s>dondurmuyor</s>	<s>dondurmayız</s>	<s>dondurmayız</s>
<s>klatratımın</s>	<s>klatratlarından</s>	<s>klatratlarından</s>
<s>giysilerime</s>	<s>giyside</s>	<s>giyside</s>
<s>pozisyonuma</s>	<s>pozisyonumun</s>	<s>pozisyonumun</s>
<s>dişlilerimi</s>	<s>dişlilerimizden</s>	<s>dişlilerimizden</s>
<s>aktörlerine</s>	<s>aktörleri</s>	<s>aktörleri</s>
<s>hemşirenden</s>	<s>hemşiresinin</s>	<s>hemşiresinin</s>
<s>ucubelerdik</s>	<s>ucubelerimizde</s>	<s>ucubelerimizde</s>
<s>fırçasından</s>	<s>fırçamızın</s>	<s>fırçamızın</s>
<s>dizelerinde</s>	<s>dizeyi</s>	<s>dizeyi</s>
<s>çarmıhınızı</s>	<s>çarmıhlarına</s>	<s>çarmıhlarına</s>
<s>tabancalara</s>	<s>tabancaları</s>	<s>tabancaları</s>
<s>kibutzından</s>	<s>kibutzın</s>	<s>kibutzın</s>
<s>aktörünüzün</s>	<s>aktörlere</s>	<s>aktörlere</s>
<s>indiriminde</s>	<s>indirimleriniz</s>	<s>indirimleriniz</s>
<s>saksocusuna</s>	<s>saksocusundan</s>	<s>saksocusundan</s>
<s>bileşiğinde</s>	<s>bileşiklerimizin</s>	<s>bileşiklerimizin</s>
<s>doymuyorduk</s>	<s>doyarsın</s>	<s>doyarsın</s>
<s>yağmurların</s>	<s>yağmurlarımız</s>	<s>yağmurlarımız</s>
<s>yarınınızın</s>	<s>yarını</s>	<s>yarını</s>
<s>canlarınızı</s>	<s>canlarımıza</s>	<s>canlarımıza</s>
<s>raporunuzun</s>	<s>rapora</s>	<s>rapora</s>
<s>bakanlardan</s>	<s>bakanınız</s>	<s>bakanınız</s>
<s>tetrafobide</s>	<s>tetrafobilere</s>	<s>tetrafobilere</s>
<s>dirimimizin</s>	<s>diriminize</s>	<s>diriminize</s>
<s>hastaydılar</s>	<s>hastalar</s>	<s>hastalar</s>
<s>haritalarım</s>	<s>haritalarımızı</s>	<s>haritalarımızı</s>
<s>çürümeyecek</s>	<s>çürümedim</s>	<s>çürümedim</s>
<s>zulümlerime</s>	<s>zulmün</s>	<s>zulmün</s>
<s>ıspanağımın</s>	<s>ıspanaklarınızda</s>	<s>ıspanaklarınızda</s>
<s>fasıklarıma</s>	<s>fasığından</s>	<s>fasığından</s>
<s>çağanozları</s>	<s>çağanozlarımız</s>	<s>çağanozlarımız</s>
<s>iffetlerdir</s>	<s>iffetimden</s>	<s>iffetimden</s>
<s>kızlarımdan</s>	<s>kızlardınız</s>	<s>kızlardınız</s>
<s>fortladınız</s>	<s>fortmıyorsun</s>	<s>fortlamıyorsun</s>
<s>tekrarınıza</s>	<s>tekrarlarımızdan</s>	<s>tekrarlarımızdan</s>
<s>burunlardan</s>	<s>burunumuzu</s>	<s>burnumuzu</s>
<s>laternanıza</s>	<s>laternalarınızı</s>	<s>laternalarınızı</s>
<s>topiklerimi</s>	<s>topiklerimde</s>	<s>topiklerimde</s>
<s>cümleydiniz</s>	<s>cümlelerinden</s>	<s>cümlelerinden</s>
<s>hapislerden</s>	<s>hapsimin</s>	<s>hapsimin</s>
<s>kaltaklarda</s>	<s>kaltaklarımızı</s>	<s>kaltaklarımızı</s>
<s>kurtçuğumun</s>	<s>kurtçuğuma</s>	<s>kurtçuğuma</s>
<s>kütüğünüzün</s>	<s>kütüğümde</s>	<s>kütüğümde</s>
<s>öpücüklerde</s>	<s>öpücükleriniz</s>	<s>öpücükleriniz</s>
<s>bükmemesine</s>	<s>bükmemelerden</s>	<s>bükmemelerden</s>
<s>söğüdünüzde</s>	<s>söğüdün</s>	<s>söğüdün</s>
<s>silgilerimi</s>	<s>silgiyi</s>	<s>silgiyi</s>
<s>yemişimizin</s>	<s>yemişimize</s>	<s>yemişimize</s>
<s>çöllerinizi</s>	<s>çöllerinde</s>	<s>çöllerinde</s>
<s>eziyetçiler</s>	<s>eziyetçilerinde</s>	<s>eziyetçilerinde</s>
<s>düdüklerime</s>	<s>düdüğüm</s>	<s>düdüğüm</s>
<s>ısılarından</s>	<s>ısıları</s>	<s>ısıları</s>
<s>yongalarını</s>	<s>yongana</s>	<s>yongana</s>
<s>sillenizden</s>	<s>sillelerinin</s>	<s>sillelerinin</s>
<s>dildolarına</s>	<s>dildolarından</s>	<s>dildolarından</s>
<s>boklarınıza</s>	<s>boklarını</s>	<s>boklarını</s>
<s>borçlarınız</s>	<s>borcumu</s>	<s>borcumu</s>
<s>sikişeceğim</s>	<s>sikişeceksin</s>	<s>sikişeceksin</s>
<s>wikilerinde</s>	<s>wikilerinin</s>	<s>wikilerinin</s>
<s>kumandamdan</s>	<s>kumandasının</s>	<s>kumandasının</s>
<s>maktalarıma</s>	<s>maktalarımızda</s>	<s>maktalarımızda</s>
<s>fındığınızı</s>	<s>fındıklarınızı</s>	<s>fındıklarınızı</s>
<s>büküleceğiz</s>	<s>bükülürsin</s>	<s>bükülürsin</s>
<s>işlemcimden</s>	<s>işlemciler</s>	<s>işlemciler</s>
<s>bardağımıza</s>	<s>bardağıma</s>	<s>bardağıma</s>
<s>önemlerinde</s>	<s>önemleri</s>	<s>önemleri</s>
<s>pipilerinde</s>	<s>pipilerine</s>	<s>pipilerine</s>
<s>integralimi</s>	<s>integrallerinizi</s>	<s>integrallerinizi</s>
<s>hareketimin</s>	<s>hareketlerimizde</s>	<s>hareketlerimizde</s>
<s>şahlarımdan</s>	<s>şahlarının</s>	<s>şahlarının</s>
<s>telofazının</s>	<s>telofazlarının</s>	<s>telofazlarının</s>
<s>önbilgimizi</s>	<s>önbilgilerinde</s>	<s>önbilgilerinde</s>
<s>albümlerden</s>	<s>albümümü</s>	<s>albümümü</s>
<s>biletlerini</s>	<s>biletlerimin</s>	<s>biletlerimin</s>
<s>metrdotelde</s>	<s>metrdotelleriniz</s>	<s>metrdotelleriniz</s>
<s>ecelerimize</s>	<s>eceleriz</s>	<s>eceyiz</s>
<s>sesteşimizi</s>	<s>sesteşlerini</s>	<s>sesteşlerini</s>
<s>paparazinde</s>	<s>paparazisine</s>	<s>paparazisine</s>
<s>elipsimizde</s>	<s>elipslerimde</s>	<s>elipslerimde</s>
<s>porsuğumuzda</s>	<s>porsuğumuzun</s>	<s>porsuğumuzun</s>
<s>gerinirsiniz</s>	<s>geriniyorlardı</s>	<s>geriniyorlardı</s>
<s>karamellerin</s>	<s>karamelini</s>	<s>karamelini</s>
<s>yörelerinizi</s>	<s>yöremizin</s>	<s>yöremizin</s>
<s>yolunuyorlar</s>	<s>yolunacağız</s>	<s>yolunacağız</s>
<s>startlarının</s>	<s>startlarım</s>	<s>startlarım</s>
<s>çiftliklerim</s>	<s>çiftliğimiz</s>	<s>çiftliğimiz</s>
<s>krakerlerime</s>	<s>krakerlerin</s>	<s>krakerlerin</s>
<s>cenubunuzdan</s>	<s>cenubumuzun</s>	<s>cenubumuzun</s>
<s>adalelerimin</s>	<s>adalelerine</s>	<s>adalelerine</s>
<s>kaplanlarını</s>	<s>kaplanları</s>	<s>kaplanları</s>
<s>integraliniz</s>	<s>integrallerim</s>	<s>integrallerim</s>
<s>kutularınıza</s>	<s>kutularımıza</s>	<s>kutularımıza</s>
<s>böğürtlenime</s>	<s>böğürtleni</s>	<s>böğürtleni</s>
<s>çaydanlıktan</s>	<s>çaydanlığı</s>	<s>çaydanlığı</s>
<s>pastalarında</s>	<s>pastasına</s>	<s>pastasına</s>
<s>şubatlarımın</s>	<s>şubatında</s>	<s>şubatında</s>
<s>sıçacaksınız</s>	<s>sıçarım</s>	<s>sıçarım</s>
<s>boşalmayacak</s>	<s>boşalarsınız</s>	<s>boşalırsınız</s>
<s>sütyenlerime</s>	<s>sütyenlerinizden</s>	<s>sütyenlerinizden</s>
<s>mısralarında</s>	<s>mısranızdan</s>	<s>mısranızdan</s>
<s>gücenmeyecek</s>	<s>güceniyoruz</s>	<s>güceniyoruz</s>
<s>striptizleri</s>	<s>striptizlerini</s>	<s>striptizlerini</s>
<s>sagalarımdan</s>	<s>sagalarına</s>	<s>sagalarına</s>
<s>dalgınlıklar</s>	<s>dalgınlığı</s>	<s>dalgınlığı</s>
<s>jokeyinizden</s>	<s>jokeyimize</s>	<s>jokeyimize</s>
<s>maydanozunuz</s>	<s>maydanozlarımız</s>	<s>maydanozlarımız</s>
<s>çözeltinizde</s>	<s>çözeltiden</s>	<s>çözeltiden</s>
<s>lezzetinizde</s>	<s>lezzetlerimi</s>	<s>lezzetlerimi</s>
<s>parçacığında</s>	<s>parçacıklarının</s>	<s>parçacıklarının</s>
<s>ışınlarımıza</s>	<s>ışınsınız</s>	<s>ışınsınız</s>
<s>şerbetimizde</s>	<s>şerbetime</s>	<s>şerbetime</s>
<s>çeçlerinizde</s>	<s>çeçinizi</s>	<s>çeçinizi</s>
<s>figüranınıza</s>	<s>figüranının</s>	<s>figüranının</s>
<s>hallerimizin</s>	<s>hal</s>	<s>hal</s>
<s>yalımıyorsun</s>	<s>yalıyacaklar</s>	<s>yalıyacaklar</s>
<s>tanıyordunuz</s>	<s>tanacaksınız</s>	<s>tanıyacaksınız</s>
<s>odacılarımız</s>	<s>odacılarınızı</s>	<s>odacılarınızı</s>
<s>ellemiyorsun</s>	<s>ellemeyecek</s>	<s>ellemeyecek</s>
<s>maydanozları</s>	<s>maydanozlara</s>	<s>maydanozlara</s>
<s>aşmıyordular</s>	<s>aşadık</s>	<s>aştık</s>
<s>attırıyorsun</s>	<s>attırırsınız</s>	<s>atırırsınız</s>
<s>mucizenizden</s>	<s>mucizeni</s>	<s>mucizeni</s>
<s>tercihlerimi</s>	<s>tercihimi</s>	<s>tercihimi</s>
<s>yüzüncümüşüz</s>	<s>yüzüncülerinizin</s>	<s>yüzüncülerinizin</s>
<s>düzeliyordum</s>	<s>düzelmiyor</s>	<s>düzelmiyor</s>
<s>yutuyorlardı</s>	<s>yutursunuz</s>	<s>yutarsınız</s>
<s>kapatmayacak</s>	<s>kapatmadı</s>	<s>kapatmadı</s>
<s>utandırmadın</s>	<s>utandırmazsınız</s>	<s>utandırmazsınız</s>
<s>jölelerinden</s>	<s>jölelerini</s>	<s>jölelerini</s>
<s>şirketlerden</s>	<s>şirkette</s>	<s>şirkette</s>
<s>şarkıcılardı</s>	<s>şarkıcısına</s>	<s>şarkıcısına</s>
<s>jelatinlerin</s>	<s>jelatinlerimi</s>	<s>jelatinlerimi</s>
<s>yumuşağınızı</s>	<s>yumuşaklarda</s>	<s>yumuşaklarda</s>
<s>bitiyorsunuz</s>	<s>bitmiyorlar</s>	<s>bitmiyorlar</s>
<s>başçığınızda</s>	<s>başçıklarınızı</s>	<s>başçıklarınızı</s>
<s>aldırıyordun</s>	<s>aldırmazsınız</s>	<s>aldırmazsınız</s>
<s>haçlarınızda</s>	<s>haçlarımızın</s>	<s>haçlarımızın</s>
<s>teşhirimizin</s>	<s>teşhirlerimize</s>	<s>teşhirlerimize</s>
<s>köpürmeyecek</s>	<s>köpürmedin</s>	<s>köpürmedin</s>
<s>alındırmadın</s>	<s>alındırmazsın</s>	<s>alındırmazsın</s>
<s>diskolarında</s>	<s>diskolarında</s>	<s>diskolarında</s>
<s>balalaykanız</s>	<s>balalaykamızda</s>	<s>balalaykamızda</s>
<s>tuzlarınızda</s>	<s>tuzumuz</s>	<s>tuzumuz</s>
<s>yolculukları</s>	<s>yolculuğu</s>	<s>yolculuğu</s>
<s>gollerinizin</s>	<s>golünden</s>	<s>golünden</s>
<s>tulumlarında</s>	<s>tulumumuzun</s>	<s>tulumumuzun</s>
<s>mikroplarımı</s>	<s>mikroplarında</s>	<s>mikroplarında</s>
<s>kataloğumuza</s>	<s>katalogları</s>	<s>katalogları</s>
<s>sesteşimizin</s>	<s>sesteşlerinden</s>	<s>sesteşlerinden</s>
<s>süngerlerimi</s>	<s>süngeri</s>	<s>süngeri</s>
<s>babasızlardı</s>	<s>babasızımız</s>	<s>babasızımız</s>
<s>aşıklarımızı</s>	<s>aşıklarında</s>	<s>aşıklarında</s>
<s>mutluluğunuz</s>	<s>mutluluğunuza</s>	<s>mutluluğunuza</s>
<s>salıncaklara</s>	<s>salıncaklarına</s>	<s>salıncaklarına</s>
<s>kapakçıklara</s>	<s>kapakçıktan</s>	<s>kapakçıktan</s>
<s>sarılarınıza</s>	<s>sarılardan</s>	<s>sarılardan</s>
<s>şafaklarının</s>	<s>şafaklarımızda</s>	<s>şafaklarımızda</s>
<s>sağlayıcıyız</s>	<s>sağlayıcıymışsınız</s>	<s>sağlayıcıymışsınız</s>
<s>dalgıçlardan</s>	<s>dalgıcımızın</s>	<s>dalgıcımızın</s>
<s>gelinciğiniz</s>	<s>gelinciğimin</s>	<s>gelinciğimin</s>
<s>çürümüyorlar</s>	<s>çürüyor</s>	<s>çürüyor</s>
<s>mısralarınız</s>	<s>mısraları</s>	<s>mısraları</s>
<s>ahudutlarını</s>	<s>ahudutu</s>	<s>ahududunu</s>
<s>sinekliğinde</s>	<s>sinekliklerine</s>	<s>sinekliklerine</s>
<s>pırasalarımı</s>	<s>pırasasında</s>	<s>pırasasında</s>
<s>seçileceksin</s>	<s>seçileceğim</s>	<s>seçileceğim</s>
<s>oğullarımdan</s>	<s>oğuldular</s>	<s>oğuldular</s>
<s>külahlarında</s>	<s>külahlarının</s>	<s>külahlarının</s>
<s>nisanlarınız</s>	<s>nisanlarıma</s>	<s>nisanlarıma</s>
<s>müzikalinize</s>	<s>müzikalinizde</s>	<s>müzikalinizde</s>
<s>ayakkabımızı</s>	<s>ayakkabısınız</s>	<s>ayakkabısınız</s>
<s>nutuklarımın</s>	<s>nutuğunuzu</s>	<s>nutkunuzu</s>
<s>patlamıyorum</s>	<s>patlayacak</s>	<s>patlayacak</s>
<s>şamisenlerim</s>	<s>şamisenlerinin</s>	<s>şamisenlerinin</s>
<s>istemcilerin</s>	<s>istemciye</s>	<s>istemciye</s>
<s>tohumlarında</s>	<s>tohum</s>	<s>tohum</s>
<s>maskaramızda</s>	<s>maskaralarınızı</s>	<s>maskaralarınızı</s>
<s>tebeşirlerde</s>	<s>teşhirler</s>	<s>tebeşirler</s>
<s>taklitçilere</s>	<s>taklitçiler</s>	<s>taklitçiler</s>
<s>bağcıklarına</s>	<s>bağcığımda</s>	<s>bağcığımda</s>
<s>portakalınız</s>	<s>portakalını</s>	<s>portakalını</s>
<s>aldırıyordum</s>	<s>aldırmıyordular</s>	<s>aldırmıyordular</s>
<s>pedlerinizin</s>	<s>pedinin</s>	<s>pedin</s>
<s>kaderlerimiz</s>	<s>kaderi</s>	<s>kaderi</s>
<s>emlakçılarda</s>	<s>emlakçısında</s>	<s>emlakçısında</s>
<s>ilişkilerimi</s>	<s>ilişkilerinden</s>	<s>ilişkilerinden</s>
<s>deneylerimde</s>	<s>deney</s>	<s>deney</s>
<s>keçilerdiniz</s>	<s>keçimize</s>	<s>keçimize</s>
<s>papyonlardan</s>	<s>papyonunu</s>	<s>papyonunu</s>
<s>semerleriniz</s>	<s>semerini</s>	<s>semerini</s>
<s>patenimizden</s>	<s>patenlerinin</s>	<s>patenlerinin</s>
<s>manitalarıma</s>	<s>manitaymışlar</s>	<s>manitaymışlar</s>
<s>sürtüğünüzde</s>	<s>sürtüklere</s>	<s>sürtüklere</s>
<s>huzurlarınız</s>	<s>huzurlarında</s>	<s>huzurlarında</s>
<s>lolipopumuza</s>	<s>lolipoplarda</s>	<s>lolipoplarda</s>
<s>kartlarımıza</s>	<s>kartım</s>	<s>kartım</s>
<s>yanıyordunuz</s>	<s>yanmıyor</s>	<s>yanmıyor</s>
<s>pusulamızdan</s>	<s>pusulaymışlar</s>	<s>pusulaymışlar</s>
<s>donmalarımda</s>	<s>donmalarıma</s>	<s>donmalarıma</s>
<s>hafriyatlara</s>	<s>hafriyatların</s>	<s>hafriyatların</s>
<s>balamozsunuz</s>	<s>balamozlara</s>	<s>balamozlara</s>
<s>efsunlarımda</s>	<s>efsununuza</s>	<s>efsununuza</s>
<s>objelerdiniz</s>	<s>objeler</s>	<s>objeler</s>
<s>laternanızın</s>	<s>laternalarını</s>	<s>laternalarını</s>
<s>smileylerimi</s>	<s>smileylerinin</s>	<s>smileylerinin</s>
<s>böcekleriniz</s>	<s>böceği</s>	<s>böceği</s>
<s>şamiseninizi</s>	<s>şamisenlerin</s>	<s>şamisenlerin</s>
<s>otogarımızda</s>	<s>otogarları</s>	<s>otogarları</s>
<s>tabansızları</s>	<s>tabansız</s>	<s>tabansız</s>
<s>ritimlerinin</s>	<s>ritmlerinde</s>	<s>ritimlerinde</s>
<s>papağanların</s>	<s>papağandan</s>	<s>papağandan</s>
<s>hâllerimizin</s>	<s>hâlinde</s>	<s>hâlinde</s>
<s>şarklarımdan</s>	<s>şarkı</s>	<s>şarkı</s>
<s>gecelerimize</s>	<s>gecemi</s>	<s>gecemi</s>
<s>kaltaklarıma</s>	<s>kaltaklarında</s>	<s>kaltaklarında</s>
<s>kunduzlarmış</s>	<s>kunduzuz</s>	<s>kunduzuz</s>
<s>teşhislerime</s>	<s>teşhisler</s>	<s>teşhisler</s>
<s>abartıyorlar</s>	<s>abarttınız</s>	<s>abarttınız</s>
<s>dağıtımlarım</s>	<s>dağıtımlarımız</s>	<s>dağıtımlarımız</s>
<s>yollarınızda</s>	<s>yollarını</s>	<s>yollarını</s>
<s>çadırınızdan</s>	<s>çadırlardan</s>	<s>çadırlardan</s>
<s>kullanılacak</s>	<s>kullanılmadın</s>	<s>kullanılmadın</s>
<s>doğumlarınız</s>	<s>doğumlardan</s>	<s>doğumlardan</s>
<s>şaşılmayacak</s>	<s>şaşılıyordu</s>	<s>şaşılıyordu</s>
<s>boşalmıyoruz</s>	<s>boşalıyorsun</s>	<s>boşalıyorsun</s>
<s>bilyelerinin</s>	<s>bilyemiz</s>	<s>bilyemiz</s>
<s>kırılıyordum</s>	<s>kırılmazlar</s>	<s>kırılmazlar</s>
<s>peruklarında</s>	<s>peruklarına</s>	<s>peruklarına</s>
<s>radyolarının</s>	<s>radyolarımızı</s>	<s>radyolarımızı</s>
<s>dakikasından</s>	<s>dakikalar</s>	<s>dakikalar</s>
<s>meşalelermiş</s>	<s>meşalelerimden</s>	<s>meşalelerimden</s>
<s>temsilcisini</s>	<s>temsilcileriz</s>	<s>temsilcileriz</s>
<s>alındırtacak</s>	<s>alındırtmıyorum</s>	<s>alındırtmıyorum</s>
<s>uçurtmasınız</s>	<s>uçurtmalarınız</s>	<s>uçurtmalarınız</s>
<s>karlarınızın</s>	<s>karısınız</s>	<s>karsınız</s>
<s>özgürlüğümüz</s>	<s>özgürlüklerimde</s>	<s>özgürlüklerimde</s>
<s>cihazlarımız</s>	<s>cihazlarına</s>	<s>cihazlarına</s>
<s>dişilerinize</s>	<s>dişini</s>	<s>dişini</s>
<s>onguncumuzda</s>	<s>onguncusunun</s>	<s>onguncusunun</s>
<s>masallarımda</s>	<s>masalda</s>	<s>masalda</s>
<s>doğuruyorlar</s>	<s>doğuruyorsunuz</s>	<s>doğuruyorsunuz</s>
<s>salaklarımız</s>	<s>salağımın</s>	<s>salağımın</s>
<s>hindilerimde</s>	<s>hindilerinde</s>	<s>hindilerinde</s>
<s>magmalarımız</s>	<s>magmam</s>	<s>magmam</s>
<s>aktrislerimi</s>	<s>aktrislerden</s>	<s>aktrislerden</s>
<s>sayılarımızı</s>	<s>sayısına</s>	<s>sayısına</s>
<s>masalarından</s>	<s>masan</s>	<s>masan</s>
<s>dudaklarımda</s>	<s>dudaklar</s>	<s>dudaklar</s>
<s>startlarımda</s>	<s>startımız</s>	<s>startımız</s>
<s>hareketlerin</s>	<s>hareketlerinin</s>	<s>hareketlerinin</s>
<s>erkeneklerim</s>	<s>erkeneklermiş</s>	<s>erkeneklermiş</s>
<s>mezarlığının</s>	<s>mezarlıklarda</s>	<s>mezarlıklarda</s>
<s>ısılarımızda</s>	<s>ısısı</s>	<s>ısısı</s>
<s>kalemtıraşın</s>	<s>kalemtıraşım</s>	<s>kalemtıraşım</s>
<s>sunmayacağız</s>	<s>sunmuyorlar</s>	<s>sunmuyorlar</s>
<s>nişanlılarda</s>	<s>nişanlılarından</s>	<s>nişanlılarından</s>
<s>kasımlarınız</s>	<s>kasımlarımızın</s>	<s>kasımlarımızın</s>
<s>tutkuymuşlar</s>	<s>tutkunuzun</s>	<s>tutkunuzun</s>
<s>bulmayacağız</s>	<s>buluyordunuz</s>	<s>buluyordunuz</s>
<s>rüzgârımızda</s>	<s>rüzgârınıza</s>	<s>rüzgârınıza</s>
<s>kulübelerden</s>	<s>kulübelerim</s>	<s>kulübelerim</s>
<s>mayonezinizi</s>	<s>mayonezimizde</s>	<s>mayonezimizde</s>
<s>dirilmemedim</s>	<s>dirilmemediniz</s>	<s>dirilmemediniz</s>
<s>yalancısında</s>	<s>yalancılarımda</s>	<s>yalancılarımda</s>
<s>kesyapımızın</s>	<s>kesyapımız</s>	<s>kesyapımız</s>
<s>uzaklarımıza</s>	<s>uzaklardı</s>	<s>uzaklardı</s>
<s>skrotumumdan</s>	<s>skrotumundan</s>	<s>skrotumundan</s>
<s>giriyorlardı</s>	<s>girer</s>	<s>girer</s>
<s>kasıklarınız</s>	<s>kasığımıza</s>	<s>kasığımıza</s>
<s>tuğralarımda</s>	<s>tuğrasını</s>	<s>tuğrasını</s>
<s>yaratmasının</s>	<s>yaratmalarımdan</s>	<s>yaratmalarımdan</s>
<s>sesteşinizde</s>	<s>sesteşlerinden</s>	<s>sesteşlerinden</s>
<s>derecelerini</s>	<s>derecemde</s>	<s>derecemde</s>
<s>jiletlerinde</s>	<s>jiletlerinizi</s>	<s>jiletlerinizi</s>
<s>iftitahlarda</s>	<s>iftitahımızın</s>	<s>iftitahımızın</s>
<s>yolculuğumuz</s>	<s>yolculuktan</s>	<s>yolculuktan</s>
<s>kitaplıkları</s>	<s>kitaplıktan</s>	<s>kitaplıktan</s>
<s>harçlarımızı</s>	<s>harcı</s>	<s>harcı</s>
<s>bıyıklarınız</s>	<s>bıyıklara</s>	<s>bıyıklara</s>
<s>anafazınızda</s>	<s>anafazlarımızın</s>	<s>anafazlarımızın</s>
<s>jonglörünüzü</s>	<s>jonglörünü</s>	<s>jonglörünü</s>
<s>sürümlerinde</s>	<s>sürümlerimizi</s>	<s>sürümlerimizi</s>
<s>attıracaklar</s>	<s>attırmadım</s>	<s>attırmadım</s>
<s>ağlatıyordun</s>	<s>ağlattınız</s>	<s>ağlattın</s>
<s>yoldurtmadık</s>	<s>yoldurttu</s>	<s>yoldurttu</s>
<s>gözlerimizde</s>	<s>gözlerinin</s>	<s>gözlerinin</s>
<s>sinekliğimde</s>	<s>sinekliklerde</s>	<s>sinekliklerde</s>
<s>birleşmenizi</s>	<s>birleşmemiz</s>	<s>birleşmemiz</s>
<s>kromozomunuza</s>	<s>kromozomu</s>	<s>kromozomu</s>
<s>iğnelerimizde</s>	<s>iğnelerimize</s>	<s>iğnelerimize</s>
<s>satışlarınıza</s>	<s>satışlarından</s>	<s>satışlarından</s>
<s>üzümlerinizin</s>	<s>üzümüne</s>	<s>üzümüne</s>
<s>yaşamlarmışız</s>	<s>yaşamının</s>	<s>yaşamının</s>
<s>efsunlarımızı</s>	<s>efsunlarımızda</s>	<s>efsunlarımızda</s>
<s>dillerimizden</s>	<s>dillerimizde</s>	<s>dillerimizde</s>
<s>sıcaklıkların</s>	<s>sıcaklığı</s>	<s>sıcaklığı</s>
<s>zulümlerinden</s>	<s>zulümlerinin</s>	<s>zulümlerinin</s>
<s>emlaklarımızı</s>	<s>emlağınızda</s>	<s>emlağınızda</s>
<s>ikilemlerimde</s>	<s>ikilemin</s>	<s>ikilemin</s>
<s>bisikletimize</s>	<s>bisiklet</s>	<s>bisiklet</s>
<s>akılarımızdan</s>	<s>akılarına</s>	<s>akılarına</s>
<s>dinamitinizin</s>	<s>dinamit</s>	<s>dinamit</s>
<s>oyuncularımın</s>	<s>oyuncusundan</s>	<s>oyuncusundan</s>
<s>büktürülürler</s>	<s>büktürülmezler</s>	<s>büktürülmezler</s>
<s>yollarınızdan</s>	<s>yol</s>	<s>yol</s>
<s>beyazlarından</s>	<s>beyazlarıma</s>	<s>beyazlarıma</s>
<s>tekrarınızdan</s>	<s>tekrarlarınızda</s>	<s>tekrarlarınızda</s>
<s>aşurelerinize</s>	<s>aşureniz</s>	<s>aşureniz</s>
<s>bükmemelerden</s>	<s>bükmemesini</s>	<s>bükmemesini</s>
<s>kaçırmazsınız</s>	<s>kaçırmıyoruz</s>	<s>kaçırmıyoruz</s>
<s>hıçkırıkların</s>	<s>hıçkırığınızı</s>	<s>hıçkırığınızı</s>
<s>yaratmamızdan</s>	<s>yaratmalarımızda</s>	<s>yaratmalarımızda</s>
<s>yolundurturum</s>	<s>yolundurtuyoruz</s>	<s>yolundurtuyoruz</s>
<s>semercilerimi</s>	<s>semercilerinizi</s>	<s>semercilerinizi</s>
<s>magmalarınıza</s>	<s>magmalarımız</s>	<s>magmalarımız</s>
<s>futbolcumuzda</s>	<s>futbolcusunu</s>	<s>futbolcusunu</s>
<s>sıralamanızda</s>	<s>sıralamalarında</s>	<s>sıralamalarında</s>
<s>kumandalarını</s>	<s>kumandalarından</s>	<s>kumandalarından</s>
<s>lüferlerimden</s>	<s>lüferi</s>	<s>lüferi</s>
<s>asteroidimizi</s>	<s>asteroitlerimi</s>	<s>asteroitlerimi</s>
<s>kurşunlarımın</s>	<s>kurşununu</s>	<s>kurşununu</s>
<s>tekfurlarımız</s>	<s>tekfurlarımızdan</s>	<s>tekfurlarımızdan</s>
<s>turşularsınız</s>	<s>turşularınızdan</s>	<s>turşularınızdan</s>
<s>kısalığınızın</s>	<s>kısalıklarına</s>	<s>kısalıklarına</s>
<s>zaferlerimden</s>	<s>zaferinizi</s>	<s>zaferinizi</s>
<s>hüzünlerimizi</s>	<s>hüzünlerinizin</s>	<s>hüzünlerinizin</s>
<s>erneklerimizi</s>	<s>erneğimden</s>	<s>erneğimden</s>
<s>taşlarınızdan</s>	<s>taşlarınız</s>	<s>taşlarınız</s>
<s>kızlarınızdan</s>	<s>kızlarmışsınız</s>	<s>kızlarmışsınız</s>
<s>seyahatinizde</s>	<s>seyahatlerine</s>	<s>seyahatlerine</s>
<s>gülüşlerinizi</s>	<s>gülüşlerini</s>	<s>gülüşlerini</s>
<s>hançerlerimiz</s>	<s>hançerini</s>	<s>hançerini</s>
<s>taksilerinizi</s>	<s>taksilerim</s>	<s>taksilerim</s>
<s>külfetlerimin</s>	<s>külfetlerimiz</s>	<s>külfetlerimiz</s>
<s>figüranlardır</s>	<s>figüranlarımızın</s>	<s>figüranlarımızın</s>
<s>ittirtmediniz</s>	<s>ittirtiyordunuz</s>	<s>ittirtiyordunuz</s>
<s>söylemiyordun</s>	<s>söyledik</s>	<s>söyledik</s>
<s>cüzzamlarınız</s>	<s>cüzzamınız</s>	<s>cüzzamınız</s>
<s>eklermişsiniz</s>	<s>eklersiniz</s>	<s>eksiniz</s>
<s>erkeceylerine</s>	<s>erkeceyini</s>	<s>erkeceyini</s>
<s>topluluktular</s>	<s>topluluğunun</s>	<s>topluluğunun</s>
<s>yolundurmadın</s>	<s>yolunduruyordum</s>	<s>yolunduruyordum</s>
<s>ücretliliğini</s>	<s>ücretliliğimizden</s>	<s>ücretliliğimizden</s>
<s>oyalamıyorduk</s>	<s>oyalayacaksın</s>	<s>oyalayacaksın</s>
<s>saydırmıyoruz</s>	<s>sayıyoruz</s>	<s>saydırıyoruz</s>
<s>gidilmiyorlar</s>	<s>gidileceksiniz</s>	<s>gidileceksiniz</s>
<s>damatlarınıza</s>	<s>damatımızı</s>	<s>damadımızı</s>
<s>büktürteceğim</s>	<s>büktürtmeyecekler</s>	<s>büktürtmeyecekler</s>
<s>mumyalarımdan</s>	<s>mumyaydınız</s>	<s>mumyaydınız</s>
<s>alkışlarınızı</s>	<s>alkışlarını</s>	<s>alkışlarını</s>
<s>pırasalarımız</s>	<s>pırasalarınızda</s>	<s>pırasalarınızda</s>
<s>sürüngenimizi</s>	<s>sürüngeni</s>	<s>sürüngeni</s>
<s>sattırırsınız</s>	<s>sattırırmadılar</s>	<s>satırtmadılar</s>
<s>yoğurtçusunda</s>	<s>yoğurtçuymuşuz</s>	<s>yoğurtçuymuşuz</s>
<s>itiliyorlardı</s>	<s>itiliyorsunuz</s>	<s>itiliyorsunuz</s>
<s>atlılarınızda</s>	<s>atlınıza</s>	<s>atlınıza</s>
<s>ittirilmezsin</s>	<s>ittirilmiyordu</s>	<s>ittirilmiyordu</s>
<s>karıncasından</s>	<s>karıncamızdan</s>	<s>karıncamızdan</s>
<s>lepistesimden</s>	<s>lepistesimi</s>	<s>lepistesimi</s>
<s>yaşammışsınız</s>	<s>yaşamlarsınız</s>	<s>yaşamlarsınız</s>
<s>kümeslerdiniz</s>	<s>kümeslerde</s>	<s>kümeslerde</s>
<s>iskenderimizi</s>	<s>iskenderine</s>	<s>iskenderine</s>
<s>gecelerimizin</s>	<s>geceyi</s>	<s>geceyi</s>
<s>taklitçileriz</s>	<s>taklitçilerinin</s>	<s>taklitçilerinin</s>
<s>yengecinizden</s>	<s>yengeçlerinizin</s>	<s>yengeçlerinizin</s>
<s>kalfalardınız</s>	<s>kalfamızı</s>	<s>kalfamızı</s>
<s>defterleriniz</s>	<s>defterimizde</s>	<s>defterimizde</s>
<s>perestroikanı</s>	<s>perestroikalarının</s>	<s>perestroikalarının</s>
<s>kâinatımızdan</s>	<s>kâinatları</s>	<s>kâinatları</s>
<s>gebermiyordun</s>	<s>gebermezler</s>	<s>gebermezler</s>
<s>bozunumumuzun</s>	<s>bozunumunuzdan</s>	<s>bozunumunuzdan</s>
<s>pastırmasında</s>	<s>pastırmalarından</s>	<s>pastırmalarından</s>
<s>objelerimizde</s>	<s>objenden</s>	<s>objenden</s>
<s>sabanlarımıza</s>	<s>sabanlarının</s>	<s>sabanlarının</s>
<s>akciğerlerine</s>	<s>akciğerin</s>	<s>akciğerin</s>
<s>fizikçilerdir</s>	<s>fizikçilerdik</s>	<s>fizikçilerdik</s>
<s>deneyiminizin</s>	<s>deneyimleriniz</s>	<s>deneyimleriniz</s>
<s>asteroitlerde</s>	<s>asteroitleri</s>	<s>asteroitleri</s>
<s>külotlarımıza</s>	<s>külodum</s>	<s>külodum</s>
<s>zibidiymişler</s>	<s>zibidilerin</s>	<s>zibidilerin</s>
<s>ittirmiyordun</s>	<s>ittirmez</s>	<s>ittirmez</s>
<s>kaçamağınızda</s>	<s>kaçamağımıza</s>	<s>kaçamağımıza</s>
<s>istirahatımın</s>	<s>istirahatını</s>	<s>istirahatını</s>
<s>ücretsizlikte</s>	<s>ücretsizliğine</s>	<s>ücretsizliğine</s>
<s>atıştırıyordu</s>	<s>atıştırmıyordum</s>	<s>atıştırmıyordum</s>
<s>duymamalarıma</s>	<s>duymamaları</s>	<s>duymamaları</s>
<s>kolonyaymışız</s>	<s>kolonyanızdan</s>	<s>kolonyanızdan</s>
<s>rahiplerinize</s>	<s>rahibinden</s>	<s>rahibinden</s>
<s>şarapçımızdan</s>	<s>şarapçıları</s>	<s>şarapçıları</s>
<s>jaluzileriniz</s>	<s>jaluzilerinizin</s>	<s>jaluzilerinizin</s>
<s>kamuslarınızı</s>	<s>kamusmuşuz</s>	<s>kamusmuşuz</s>
<s>taraflarından</s>	<s>taraflarınızın</s>	<s>taraflarınızın</s>
<s>hastanelerine</s>	<s>hastanenize</s>	<s>hastanenize</s>
<s>mazlumlarımda</s>	<s>mazlumumda</s>	<s>mazlumumda</s>
<s>pastalarımdan</s>	<s>pastalara</s>	<s>pastalara</s>
<s>bıçaklıyorsun</s>	<s>bıçaklamadım</s>	<s>bıçaklamadım</s>
<s>ofislerinizde</s>	<s>ofis</s>	<s>ofis</s>
<s>soygazlarının</s>	<s>soygazını</s>	<s>soygazını</s>
<s>yarınlarınıza</s>	<s>yarınınızı</s>	<s>yarınınızı</s>
<s>kahramanınızı</s>	<s>kahramanlarını</s>	<s>kahramanlarını</s>
<s>palikaryandan</s>	<s>palikaryanda</s>	<s>palikaryanda</s>
<s>ettirtmiyordu</s>	<s>ettirtmiyorlar</s>	<s>ettirtmiyorlar</s>
<s>gelinmiyordum</s>	<s>gelinecek</s>	<s>gelinecek</s>
<s>barajlarımızı</s>	<s>barajlara</s>	<s>barajlara</s>
<s>iblislerimizi</s>	<s>iblislerinden</s>	<s>iblislerinden</s>
<s>kapaklarınızı</s>	<s>kapakmışsınız</s>	<s>kapakmışsınız</s>
<s>gübrelerinize</s>	<s>gübreler</s>	<s>gübreler</s>
<s>topluluklarız</s>	<s>topluluklar</s>	<s>topluluklar</s>
<s>tuzlarınızdan</s>	<s>tuzuma</s>	<s>tuzuma</s>
<s>kaybolmuyoruz</s>	<s>kaybolmayız</s>	<s>kaybolmayız</s>
<s>göstermediler</s>	<s>gösterdim</s>	<s>gösterdim</s>
<s>börülcelerime</s>	<s>börülcenden</s>	<s>börülcenden</s>
<s>ağlattırırsın</s>	<s>ağlattırıyorsun</s>	<s>ağlattırıyorsun</s>
<s>başkanlarımın</s>	<s>başkanlarımızdan</s>	<s>başkanlarımızdan</s>
<s>çişlerimizden</s>	<s>çişlerini</s>	<s>çişlerini</s>
<s>demlemiyorduk</s>	<s>demliyorduk</s>	<s>demliyorduk</s>
<s>yıpratmıyorum</s>	<s>yıprattık</s>	<s>yıprattık</s>
<s>toplulukların</s>	<s>topluluklar</s>	<s>topluluklar</s>
<s>tanıtmıyorsun</s>	<s>tanıtmıyorduk</s>	<s>tanıtmıyorduk</s>
<s>kombinasyonun</s>	<s>kombinasyon</s>	<s>kombinasyon</s>
<s>aseksüelmişiz</s>	<s>aseksüellerinden</s>	<s>aseksüellerinden</s>
<s>maskarasından</s>	<s>maskaralarmışız</s>	<s>maskaralarmışız</s>
<s>anjiyolarımın</s>	<s>anjiyolarına</s>	<s>anjiyolarına</s>
<s>sindiriminize</s>	<s>sindirimleri</s>	<s>sindirimleri</s>
<s>parçalarından</s>	<s>parçası</s>	<s>parçası</s>
<s>dirilmeiyorum</s>	<s>dirilmiyordun</s>	<s>dirilmeiyordun</s>
<s>atılmayacağım</s>	<s>atılırlar</s>	<s>atılırlar</s>
<s>yangınlarımın</s>	<s>yangınlarında</s>	<s>yangınlarında</s>
<s>taslaklarınız</s>	<s>taslağı</s>	<s>taslağı</s>
<s>balıklarımızı</s>	<s>balıklara</s>	<s>balıklara</s>
<s>mühimliğinize</s>	<s>mühimlikleriniz</s>	<s>mühimlikleriniz</s>
<s>arkadaşlarımı</s>	<s>arkadaşın</s>	<s>arkadaşın</s>
<s>hinterlandına</s>	<s>hinterlandını</s>	<s>hinterlandını</s>
<s>çalgıcılardır</s>	<s>çalgıcılarını</s>	<s>çalgıcılarını</s>
<s>bandajlarında</s>	<s>bandajlarını</s>	<s>bandajlarını</s>
<s>şortlarınızda</s>	<s>şortların</s>	<s>şortların</s>
<s>tütüncülerimi</s>	<s>tütünce</s>	<s>tütüncüye</s>
<s>marangozlardı</s>	<s>marangozlarınızı</s>	<s>marangozlarınızı</s>
<s>kirişlerimden</s>	<s>kirişlerinde</s>	<s>kirişlerinde</s>
<s>üşeneceksiniz</s>	<s>üşenmeyeceğim</s>	<s>üşenmeyeceğim</s>
<s>doğruyordunuz</s>	<s>doğramam</s>	<s>doğramam</s>
<s>daldırıyordum</s>	<s>daldırmazsın</s>	<s>daldırmazsın</s>
<s>yumurtalıkları</s>	<s>yumurtalığınıza</s>	<s>yumurtalığınıza</s>
<s>bulunmayacağız</s>	<s>bulunmayacaklar</s>	<s>bulunmayacaklar</s>
<s>heykelciklerim</s>	<s>heykelciğinizin</s>	<s>heykelciğinizin</s>
<s>otomobillerdir</s>	<s>otomobili</s>	<s>otomobili</s>
<s>yoğurtçularını</s>	<s>yoğurtçunda</s>	<s>yoğurtçunda</s>
<s>çiftliklerimin</s>	<s>çiftlikleri</s>	<s>çiftlikleri</s>
<s>iskenderlerini</s>	<s>iskenderi</s>	<s>iskenderi</s>
<s>izleyicilerdik</s>	<s>izleyicim</s>	<s>izleyicim</s>
<s>eşcinselmişler</s>	<s>eşcinsellerinde</s>	<s>eşcinsellerinde</s>
<s>ücretliliğinin</s>	<s>ücretliliklerimin</s>	<s>ücretliliklerimin</s>
<s>mazlumlarımıza</s>	<s>mazlumunuzun</s>	<s>mazlumunuzun</s>
<s>ortaklığımızın</s>	<s>ortaklıklarınız</s>	<s>ortaklıklarınız</s>
<s>smileylerimize</s>	<s>smileylerinden</s>	<s>smileylerinden</s>
<s>tatbiklerimden</s>	<s>tatbiklerimin</s>	<s>tatbiklerimin</s>
<s>kataloğunuzdan</s>	<s>kataloğumuzun</s>	<s>kataloğumuzun</s>
<s>kasaplarınızın</s>	<s>kasaplarına</s>	<s>kasaplarına</s>
<s>futbolcularmış</s>	<s>futbolcunu</s>	<s>futbolcunu</s>
<s>ittirtilmezsin</s>	<s>ittirtilmiyordun</s>	<s>ittirtilmiyordun</s>
<s>programlanıyor</s>	<s>programlanmadın</s>	<s>programlanmadın</s>
<s>bulgurlarımıza</s>	<s>bulgurunu</s>	<s>bulgurunu</s>
<s>aldırtmaıyorum</s>	<s>aldırtmamı</s>	<s>aldırtmamam</s>
<s>gözlükçümüzden</s>	<s>gözlükçülerini</s>	<s>gözlükçülerini</s>
<s>satırtmazsınız</s>	<s>satırtmam</s>	<s>satırtmam</s>
<s>bitiriyordunuz</s>	<s>bitirmedin</s>	<s>bitirmedin</s>
<s>otoculuğunuzda</s>	<s>otoculuklarımızda</s>	<s>otoculuklarımızda</s>
<s>zağarlarınızda</s>	<s>zağarlardık</s>	<s>zağarlardık</s>
<s>malumatınızdan</s>	<s>malumatlarının</s>	<s>malumatlarının</s>
<s>yedeklerimizin</s>	<s>yedeğinize</s>	<s>yedeğinize</s>
<s>düşmanlarınıza</s>	<s>düşmanından</s>	<s>düşmanından</s>
<s>iribaşlarımdan</s>	<s>iribaşımda</s>	<s>iribaşımda</s>
<s>sınıflarımızın</s>	<s>sınıflarında</s>	<s>sınıflarında</s>
<s>kaldırımlarıma</s>	<s>kaldırımlarımıza</s>	<s>kaldırımlarımıza</s>
<s>fortlayacaksın</s>	<s>fortlamazlar</s>	<s>fortlamazlar</s>
<s>ülkelerimizden</s>	<s>ülkelere</s>	<s>ülkelere</s>
<s>aygıtçığımızda</s>	<s>aygıtçığımızın</s>	<s>aygıtçığımızın</s>
<s>otellerimizden</s>	<s>otellerimde</s>	<s>otellerimde</s>
<s>ketçaplarınıza</s>	<s>ketçaplara</s>	<s>ketçaplara</s>
<s>gondollarımıza</s>	<s>gondolun</s>	<s>gondolun</s>
<s>şirketlerimden</s>	<s>şirketinizi</s>	<s>şirketinizi</s>
<s>jaluzilerimize</s>	<s>jaluzilerimizden</s>	<s>jaluzilerimizden</s>
<s>yeniliğinizden</s>	<s>yeniliklerinde</s>	<s>yeniliklerinde</s>
<s>dürbünlerimden</s>	<s>dürbünlerim</s>	<s>dürbünlerim</s>
<s>duymalarınızın</s>	<s>duymamızı</s>	<s>duymamızı</s>
<s>hükûmetleriniz</s>	<s>hükûmetlerinin</s>	<s>hükûmetlerinin</s>
<s>permütasyonumu</s>	<s>permütasyonlarımı</s>	<s>permütasyonlarımı</s>
<s>söğütlerimizin</s>	<s>söğütlerinin</s>	<s>söğütlerinin</s>
<s>masumiyettiniz</s>	<s>masumiyetlerinde</s>	<s>masumiyetlerinde</s>
<s>acıtmayacaksın</s>	<s>acıtmayız</s>	<s>acıtmayız</s>
<s>bileşiğimizden</s>	<s>bileşiği</s>	<s>bileşiği</s>
<s>gençliklerimin</s>	<s>gençlikte</s>	<s>gençlikte</s>
<s>altdillerinizi</s>	<s>altdilinin</s>	<s>altdilinin</s>
<s>çekmecelerimin</s>	<s>çekmeceden</s>	<s>çekmeceden</s>
<s>geciktirmezsin</s>	<s>geciktirmedim</s>	<s>geciktirmedim</s>
<s>mısırlarınızda</s>	<s>mısırlarımı</s>	<s>mısırlarımı</s>
<s>disleksilerden</s>	<s>disleksilerimiz</s>	<s>disleksilerimiz</s>
<s>kuyumcularımız</s>	<s>kuyumcularının</s>	<s>kuyumcularının</s>
<s>birleştirdiler</s>	<s>birleştirdin</s>	<s>birleştirdin</s>
<s>frizbilerinizi</s>	<s>frizbinizin</s>	<s>frizbinizin</s>
<s>baldızlarsınız</s>	<s>baldızlardır</s>	<s>baldızlardır</s>
<s>gitarlarınızda</s>	<s>gitarlar</s>	<s>gitarlar</s>
<s>erimelerimizde</s>	<s>erimemize</s>	<s>erimemize</s>
<s>zürriyetlerimi</s>	<s>zürriyetlerini</s>	<s>zürriyetlerini</s>
<s>biletlerimizin</s>	<s>biletlerimizi</s>	<s>biletlerimizi</s>
<s>canlanmıyorduk</s>	<s>canlanır</s>	<s>canlanır</s>
<s>onarmayacaklar</s>	<s>onarmazsın</s>	<s>onarmazsın</s>
<s>derlemelerimde</s>	<s>derlemelerinin</s>	<s>derlemelerinin</s>
<s>marangozunuzun</s>	<s>marangozlardı</s>	<s>marangozlardı</s>
<s>kardeleninizde</s>	<s>kardelenlerinden</s>	<s>kardelenlerinden</s>
<s>ocaklarınızdan</s>	<s>ocaklarımın</s>	<s>ocaklarımın</s>
<s>bebeklerimizde</s>	<s>bebeğinizi</s>	<s>bebeğinizi</s>
<s>keserlarınızın</s>	<s>keserlarını</s>	<s>keserlarını</s>
<s>makinelerimize</s>	<s>makinelerimiz</s>	<s>makinelerimiz</s>
<s>namazlarınızın</s>	<s>namazlarımın</s>	<s>namazlarımın</s>
<s>karakollarımız</s>	<s>karakol</s>	<s>karakol</s>
<s>külfetlerinizi</s>	<s>külfetimize</s>	<s>külfetimize</s>
<s>sinagoglarınız</s>	<s>sinagoglarıma</s>	<s>sinagoglarıma</s>
<s>onguncularında</s>	<s>onguncunuzu</s>	<s>onguncunuzu</s>
<s>gidileceksiniz</s>	<s>gidilir</s>	<s>gidilir</s>
<s>seyretmiyordun</s>	<s>seyretmeyecek</s>	<s>seyretmeyecek</s>
<s>çubuklarınızda</s>	<s>çubuklarının</s>	<s>çubuklarının</s>
<s>diskoteklerimi</s>	<s>diskoteğimde</s>	<s>diskoteğimde</s>
<s>çimkelerinizde</s>	<s>çimkelerinden</s>	<s>çimkelerinden</s>
<s>metrdotelleriz</s>	<s>metrdoteline</s>	<s>metrdoteline</s>
<s>lügatçelerinin</s>	<s>lügatçemizin</s>	<s>lügatçemizin</s>
<s>dernekmişsiniz</s>	<s>dernek</s>	<s>dernek</s>
<s>kaydedicimizin</s>	<s>kaydedicimizi</s>	<s>kaydedicimizi</s>
<s>fotoğrafçısına</s>	<s>fotoğrafçıyız</s>	<s>fotoğrafçıyız</s>
<s>desenlerinizin</s>	<s>deseninin</s>	<s>deseninin</s>
<s>tamlananlardan</s>	<s>tamlananlarda</s>	<s>tamlananlarda</s>
<s>kaplanlarımdan</s>	<s>kaplanımızda</s>	<s>kaplanımızda</s>
<s>filozoflarınız</s>	<s>filozofumdan</s>	<s>filozofumdan</s>
<s>cisimlerinizin</s>	<s>cisimlerimizden</s>	<s>cisimlerimizden</s>
<s>dilsizliğinize</s>	<s>dilsizliklerimin</s>	<s>dilsizliklerimin</s>
<s>kötülerimizden</s>	<s>kötünden</s>	<s>kötünden</s>
<s>ebediliklerini</s>	<s>ebediliklere</s>	<s>ebediliklere</s>
<s>üreticilerimde</s>	<s>üreticilerimize</s>	<s>üreticilerimize</s>
<s>yoğurtçularmış</s>	<s>yoğurtçularında</s>	<s>yoğurtçularında</s>
<s>çekmecelerinin</s>	<s>çekmecemizde</s>	<s>çekmecemizde</s>
<s>pamuklarınızın</s>	<s>pamuklarının</s>	<s>pamuklarının</s>
<s>filizlerinizde</s>	<s>filizlerinde</s>	<s>filizlerinde</s>
<s>haşefelerimizi</s>	<s>haşefelerimizden</s>	<s>haşefelerimizden</s>
<s>kızlıklarımıza</s>	<s>kızlıklara</s>	<s>kızlıklara</s>
<s>kıyafetlerimiz</s>	<s>kıyafetimiz</s>	<s>kıyafetimiz</s>
<s>yoğurtçularını</s>	<s>yoğurtçulardık</s>	<s>yoğurtçulardık</s>
<s>sineklerimizde</s>	<s>sinekleri</s>	<s>sinekleri</s>
<s>yontulmuyorduk</s>	<s>yontulurlar</s>	<s>yontulurlar</s>
<s>benzerlerimizi</s>	<s>benzerlerinden</s>	<s>benzerlerinden</s>
<s>kloroplastınız</s>	<s>kloroplastında</s>	<s>kloroplastında</s>
<s>yoğurtlarınızı</s>	<s>yoğurdumu</s>	<s>yoğurdumu</s>
<s>sürünmeyeceğiz</s>	<s>sürünüyorduk</s>	<s>sürünüyorduk</s>
<s>balıkçılarınız</s>	<s>balıkçılarınızı</s>	<s>balıkçılarınızı</s>
<s>tecritlerinize</s>	<s>tecritlerinde</s>	<s>tecritlerinde</s>
<s>deniliyordunuz</s>	<s>denilmezsiniz</s>	<s>denilmezsiniz</s>
<s>kibritlerinize</s>	<s>kibritine</s>	<s>kibritine</s>
<s>piyanolarımıza</s>	<s>piyanolarda</s>	<s>piyanolarda</s>
<s>hastanelerinde</s>	<s>hastaneye</s>	<s>hastaneye</s>
<s>yayımcılığımda</s>	<s>yayımcılığım</s>	<s>yayımcılığım</s>
<s>smileylerinden</s>	<s>smileyimizde</s>	<s>smileyimizde</s>
<s>portakallarını</s>	<s>portakallarında</s>	<s>portakallarında</s>
<s>eksikliğimizde</s>	<s>eksikliklerin</s>	<s>eksikliklerin</s>
<s>müelliflerimiz</s>	<s>müelliflerine</s>	<s>müelliflerine</s>
<s>oğlanlarınızın</s>	<s>oğlanlar</s>	<s>oğlanlar</s>
<s>geciktirtirsin</s>	<s>geciktirtecek</s>	<s>geciktirtecek</s>
<s>dinletilerimiz</s>	<s>dinletiler</s>	<s>dinletiler</s>
<s>başarıyorsunuz</s>	<s>başarırsınız</s>	<s>başarırsınız</s>
<s>seçmelerimizin</s>	<s>seçmeme</s>	<s>seçmeme</s>
<s>dalgınlıklarda</s>	<s>dalgınlıklardan</s>	<s>dalgınlıklardan</s>
<s>tütüncülerimiz</s>	<s>tütüncümüz</s>	<s>tütüncümüz</s>
<s>şatolarınızdan</s>	<s>şatomu</s>	<s>şatomu</s>
<s>sorularınızdan</s>	<s>sorusu</s>	<s>sorusu</s>
<s>cezeryelerimin</s>	<s>cezeryeden</s>	<s>cezeryeden</s>
<s>canlandırmadın</s>	<s>canlandırmazlar</s>	<s>canlandırmazlar</s>
<s>otostoplarınız</s>	<s>otostobuyu</s>	<s>otostobu</s>
<s>koşturtuyorsun</s>	<s>koşturtmayız</s>	<s>koşturtmayız</s>
<s>çökerticilerde</s>	<s>çökerticiler</s>	<s>çökerticiler</s>
<s>kütüklerinizde</s>	<s>kütüklerinde</s>	<s>kütüklerinde</s>
<s>onarmayacaklar</s>	<s>onardınız</s>	<s>onardınız</s>
<s>fulyalarınızın</s>	<s>fulyamıza</s>	<s>fulyamıza</s>
<s>albatrosumuzun</s>	<s>albatrosunu</s>	<s>albatrosunu</s>
<s>kunduzlarınızda</s>	<s>kunduzumu</s>	<s>kunduzumu</s>
<s>kulübelerimizde</s>	<s>kulübelerinizi</s>	<s>kulübelerinizi</s>
<s>yaptırmayacağım</s>	<s>yaptırmıyorsunuz</s>	<s>yaptırmıyorsunuz</s>
<s>yeterlilikmişiz</s>	<s>yeterliliklerinizi</s>	<s>yeterliliklerinizi</s>
<s>laternalarınıza</s>	<s>laternanız</s>	<s>laternanız</s>
<s>ittirilmiyorlar</s>	<s>ittirildi</s>	<s>ittirildi</s>
<s>ittirtilmediniz</s>	<s>ittirtileceksiniz</s>	<s>ittirtileceksiniz</s>
<s>çökermeyeceksin</s>	<s>çökeriyorsunuz</s>	<s>çökeriyorsunuz</s>
<s>ehemmiyetlerimi</s>	<s>ehemmiyetlerime</s>	<s>ehemmiyetlerime</s>
<s>psikiyatrlardan</s>	<s>psikiyatrları</s>	<s>psikiyatrları</s>
<s>izleyicilerimin</s>	<s>izleyicini</s>	<s>izleyicini</s>
<s>üreticilerdiniz</s>	<s>üreticilermişiz</s>	<s>üreticilermişiz</s>
<s>pozisyonlarımın</s>	<s>pozisyonlarımıza</s>	<s>pozisyonlarımıza</s>
<s>öksürmüyordular</s>	<s>öksürmedik</s>	<s>öksürmedik</s>
<s>kurtarıyorlardı</s>	<s>kurtarmam</s>	<s>kurtarmam</s>
<s>şapkacılarsınız</s>	<s>şapkacısından</s>	<s>şapkacısından</s>
<s>enfeksiyonumdan</s>	<s>enfeksiyonlarınıza</s>	<s>enfeksiyonlarınıza</s>
<s>çökelekmişsiniz</s>	<s>çökelekleriniz</s>	<s>çökelekleriniz</s>
<s>doktorlarınızın</s>	<s>doktorunu</s>	<s>doktorunu</s>
<s>kötüleştirmedik</s>	<s>kötüleştiriyorum</s>	<s>kötüleştiriyorum</s>
<s>totemcilermişiz</s>	<s>totemci</s>	<s>totemci</s>
<s>süründürüyorsun</s>	<s>süründüm</s>	<s>süründürdüm</s>
<s>hemşirelerdiniz</s>	<s>hemşireyiz</s>	<s>hemşireyiz</s>
<s>öğrencilermişiz</s>	<s>öğrencinde</s>	<s>öğrencinde</s>
<s>sistemlerimizin</s>	<s>sistemler</s>	<s>sistemler</s>
<s>şerbetçiliğimde</s>	<s>şerbetçiliğinize</s>	<s>şerbetçiliğinize</s>
<s>similyalarınızı</s>	<s>similyayı</s>	<s>similyayı</s>
<s>başlangıcınızın</s>	<s>başlangıcından</s>	<s>başlangıcından</s>
<s>cikletlerimizde</s>	<s>cikletlerimi</s>	<s>cikletlerimi</s>
<s>satışlarınızdan</s>	<s>satışlarından</s>	<s>satışlarından</s>
<s>yapbozlarımızın</s>	<s>yapbozlarından</s>	<s>yapbozlarından</s>
<s>sağrılarınızdan</s>	<s>sağrıma</s>	<s>sağrıma</s>
<s>tarabalarınızın</s>	<s>tarabamın</s>	<s>tarabamın</s>
<s>terzilerimizden</s>	<s>terziyiz</s>	<s>terziyiz</s>
<s>orangutanlarını</s>	<s>orangutana</s>	<s>orangutana</s>
<s>çantalarımızdan</s>	<s>çantanızda</s>	<s>çantanızda</s>
<s>bükülmüyorsunuz</s>	<s>büküleceğiz</s>	<s>büküleceğiz</s>
<s>cezalandırmadın</s>	<s>cezalandırmıyoruz</s>	<s>cezalandırmıyoruz</s>
<s>dedikoducuların</s>	<s>dedikoducularınıza</s>	<s>dedikoducularınıza</s>
<s>lunaparkınızdan</s>	<s>lunaparklarımın</s>	<s>lunaparklarımın</s>
<s>haberleşeceksin</s>	<s>haberleşirim</s>	<s>haberleşirim</s>
<s>derlemelerinize</s>	<s>derlemelerinizi</s>	<s>derlemelerinizi</s>
<s>topluluklarınız</s>	<s>topluluklarını</s>	<s>topluluklarını</s>
<s>marangozlarımda</s>	<s>marangozumun</s>	<s>marangozumun</s>
<s>silmeyeceksiniz</s>	<s>sileceksin</s>	<s>sileceksin</s>
<s>patronlarınızın</s>	<s>patronlarımı</s>	<s>patronlarımı</s>
<s>öfkelendirdiniz</s>	<s>öfkelendirmiyordun</s>	<s>öfkelendirmiyordun</s>
<s>ombudsmanınızın</s>	<s>ombudsmanda</s>	<s>ombudsmanda</s>
<s>ketçaplarınızda</s>	<s>ketçaplara</s>	<s>ketçaplara</s>
<s>söyleşilerimizi</s>	<s>söyleşisine</s>	<s>söyleşisine</s>
<s>beyinlerimizden</s>	<s>beyindik</s>	<s>beyindik</s>
<s>yontuluyorsunuz</s>	<s>yontuldu</s>	<s>yontuldu</s>
<s>disleksileriniz</s>	<s>disleksinden</s>	<s>disleksinden</s>
<s>sihirbazlarının</s>	<s>sihirbazların</s>	<s>sihirbazların</s>
<s>düzinelerinizin</s>	<s>düzineyi</s>	<s>düzineyi</s>
<s>masallarınızdan</s>	<s>masallarının</s>	<s>masallarının</s>
<s>geğirmiyorsunuz</s>	<s>geğirmediler</s>	<s>geğirmediler</s>
<s>guakamolelerine</s>	<s>guakamolelerini</s>	<s>guakamolelerini</s>
<s>yeşimlerimizden</s>	<s>yeşimlerimizi</s>	<s>yeşimlerimizi</s>
<s>çalgıcılarsınız</s>	<s>çalgıca</s>	<s>çalgıcıya</s>
<s>cumhuriyetinizi</s>	<s>cumhuriyetinizden</s>	<s>cumhuriyetinizden</s>
<s>kâğıtlarınızdan</s>	<s>kâğıtlarınızı</s>	<s>kâğıtlarınızı</s>
<s>tariflerinizden</s>	<s>tarifinde</s>	<s>tarifinde</s>
<s>polinomlarımızı</s>	<s>polinomlara</s>	<s>polinomlara</s>
<s>mezuniyetinizin</s>	<s>mezuniyetiniz</s>	<s>mezuniyetiniz</s>
<s>tepkimelerinize</s>	<s>tepkimelerimizi</s>	<s>tepkimelerimizi</s>
<s>seçmenlerinizin</s>	<s>seçmenlerdir</s>	<s>seçmenlerdir</s>
<s>meşalelerinizde</s>	<s>meşalelerinizi</s>	<s>meşalelerinizi</s>
<s>çapalarmışsınız</s>	<s>çapalardan</s>	<s>çapalardan</s>
<s>paralelkenarlar</s>	<s>paralelkenarları</s>	<s>paralelkenarları</s>
<s>dilsizliklerden</s>	<s>dilsizliğinin</s>	<s>dilsizliğinin</s>
<s>kaldırımlarımız</s>	<s>kaldırımlarına</s>	<s>kaldırımlarına</s>
<s>zangoçlarınızın</s>	<s>zangocunuza</s>	<s>zangocunuza</s>
<s>satrançlarından</s>	<s>satrançlarından</s>	<s>satrançlarından</s>
<s>önceliklerimizi</s>	<s>önceliğinizde</s>	<s>önceliğinizde</s>
<s>dağılmalarımıza</s>	<s>dağılmalarınızı</s>	<s>dağılmalarınızı</s>
<s>demircilerinizi</s>	<s>demircilerimde</s>	<s>demircilerimde</s>
<s>müsellesinizden</s>	<s>müsellesleriniz</s>	<s>müsellesleriniz</s>
<s>tulumlarınızdan</s>	<s>tulumlarının</s>	<s>tulumlarının</s>
<s>sindiriyordunuz</s>	<s>sindirdi</s>	<s>sindirdi</s>
<s>metafazlarından</s>	<s>metafazlarına</s>	<s>metafazlarına</s>
<s>gösterilerinden</s>	<s>gösterinden</s>	<s>gösterinden</s>
<s>kerpetenleriniz</s>	<s>kerpetenlerini</s>	<s>kerpetenlerini</s>
<s>taslaklarınızın</s>	<s>taslaklarında</s>	<s>taslaklarında</s>
<s>nergislerimizin</s>	<s>nergisleri</s>	<s>nergisleri</s>
<s>objelermişsiniz</s>	<s>objelerimizden</s>	<s>objelerimizden</s>
<s>erkeceylerinizi</s>	<s>erkeceylerimde</s>	<s>erkeceylerimde</s>
<s>yastıklarımızda</s>	<s>yastıklarınız</s>	<s>yastıklarınız</s>
<s>dokunmuyorsunuz</s>	<s>dokunuyor</s>	<s>dokunuyor</s>
<s>söylemiyordular</s>	<s>söylerim</s>	<s>söylerim</s>
<s>yetiştirmediler</s>	<s>yetiştiriyorlardı</s>	<s>yetiştiriyorlardı</s>
<s>kaçaklarımızdan</s>	<s>kaçağınızı</s>	<s>kaçağınızı</s>
<s>istisnalardınız</s>	<s>istisnalarımızın</s>	<s>istisnalarımızın</s>
<s>bileşiklerinize</s>	<s>bileşiğinden</s>	<s>bileşiğinden</s>
<s>hiperbollerimiz</s>	<s>hiperbollerinden</s>	<s>hiperbollerinden</s>
<s>ölümsüzlüklerde</s>	<s>ölümsüzlüklerden</s>	<s>ölümsüzlüklerden</s>
<s>dikdörtgenlerim</s>	<s>dikdörtgenlerinizin</s>	<s>dikdörtgenlerinizin</s>
<s>yörekentleriniz</s>	<s>yörekentlerine</s>	<s>yörekentlerine</s>
<s>günahkârlarınız</s>	<s>günahkârlarını</s>	<s>günahkârlarını</s>
<s>askerlerimizden</s>	<s>askerlerini</s>	<s>askerlerini</s>
<s>kardelenlerinde</s>	<s>kardelene</s>	<s>kardelene</s>
<s>otomobilcimizin</s>	<s>otomobilcilerini</s>	<s>otomobilcilerini</s>
<s>yönetimlerimizde</s>	<s>yönetimlerinin</s>	<s>yönetimlerinin</s>
<s>başlangıçlarında</s>	<s>başlangıçlarının</s>	<s>başlangıçlarının</s>
<s>katamaranlarımız</s>	<s>katamaranı</s>	<s>katamaranı</s>
<s>değişkenlerinizi</s>	<s>değişkenlerimin</s>	<s>değişkenlerimin</s>
<s>cumhuriyetlerimi</s>	<s>cumhuriyetimize</s>	<s>cumhuriyetimize</s>
<s>dedikoducunuzdan</s>	<s>dedikoducuymuşlar</s>	<s>dedikoducuymuşlar</s>
<s>ebediyetlerimize</s>	<s>ebediyetlerinizin</s>	<s>ebediyetlerinizin</s>
<s>doğruculuklardan</s>	<s>doğruculuğunu</s>	<s>doğruculuğunu</s>
<s>müselleslerinizi</s>	<s>müsellesinden</s>	<s>müsellesinden</s>
<s>kardelenlerinize</s>	<s>kardelenlerime</s>	<s>kardelenlerime</s>
<s>heteroseksüeline</s>	<s>heteroseksüeller</s>	<s>heteroseksüeller</s>
<s>müşteriymişsiniz</s>	<s>müşterim</s>	<s>müşterim</s>
<s>lepisteslerimizi</s>	<s>lepistesimize</s>	<s>lepistesimize</s>
<s>kuşkonmazlarımda</s>	<s>kuşkonmazlar</s>	<s>kuşkonmazlar</s>
<s>iyileşmeyecekler</s>	<s>iyileşmiyordular</s>	<s>iyileşmiyordular</s>
<s>lügatçelerimizin</s>	<s>lügatçelerini</s>	<s>lügatçelerini</s>
<s>cumhuriyetinizin</s>	<s>cumhuriyetlerimizde</s>	<s>cumhuriyetlerimizde</s>
<s>beneklermişsiniz</s>	<s>beneği</s>	<s>beneği</s>
<s>eşcinsellermişiz</s>	<s>eşcinselini</s>	<s>eşcinselini</s>
<s>sindirimlerimizi</s>	<s>sindirimeme</s>	<s>sindirimime</s>
<s>uzunluklarınızda</s>	<s>uzunlukları</s>	<s>uzunlukları</s>
<s>zürriyetlerinizi</s>	<s>zürriyetlerinde</s>	<s>zürriyetlerinde</s>
<s>daldırmıyordular</s>	<s>daldırıyorlar</s>	<s>daldırıyorlar</s>
<s>ücretsizliğimden</s>	<s>ücretsizliğinde</s>	<s>ücretsizliğinde</s>
<s>çığırtkanlarının</s>	<s>çığırtkanımdan</s>	<s>çığırtkanımdan</s>
<s>sendromlarınızın</s>	<s>sendromlarında</s>	<s>sendromlarında</s>
<s>yetmezliklerinde</s>	<s>yetmezlikmişiz</s>	<s>yetmezlikmişiz</s>
<s>dikkatlerimizden</s>	<s>dikkatlerin</s>	<s>dikkatlerin</s>
<s>karakterlerinden</s>	<s>karakterlerinizden</s>	<s>karakterlerinizden</s>
<s>yağlayıcılarınız</s>	<s>yağlayıcılarını</s>	<s>yağlayıcılarını</s>
<s>yağlayıcılarımda</s>	<s>yağlayıcıları</s>	<s>yağlayıcıları</s>
<s>sağduyularımızın</s>	<s>sağduyularınızı</s>	<s>sağduyularınızı</s>
<s>çikolatalarından</s>	<s>çikolatalarınız</s>	<s>çikolatalarınız</s>
<s>otostopçularımın</s>	<s>otostopçularının</s>	<s>otostopçularının</s>
<s>striptizlerimize</s>	<s>striptiziniz</s>	<s>striptiziniz</s>
<s>öğrencilerinizin</s>	<s>öğrenci</s>	<s>öğrenci</s>
<s>ehemmiyetsizliğe</s>	<s>ehemmiyetsizliklerinizden</s>	<s>ehemmiyetsizliklerinizden</s>
<s>diyapazonlarınız</s>	<s>diyapazonları</s>	<s>diyapazonları</s>
<s>eşcinsellerimize</s>	<s>eşcinsellerimiz</s>	<s>eşcinsellerimiz</s>
<s>gereksinimimizde</s>	<s>gereksinimlerinde</s>	<s>gereksinimlerinde</s>
<s>mustatillerimize</s>	<s>mustatillerime</s>	<s>mustatillerime</s>
<s>taşeronlarımızda</s>	<s>taşeronları</s>	<s>taşeronları</s>
<s>maydanozlarınızı</s>	<s>maydanozlarında</s>	<s>maydanozlarında</s>
<s>dedikoduculardan</s>	<s>dedikoducularınızdan</s>	<s>dedikoducularınızdan</s>
<s>sinekliklerinize</s>	<s>sinekliğimizden</s>	<s>sinekliğimizden</s>
<s>interfazlarınıza</s>	<s>interfazlarında</s>	<s>interfazlarında</s>
<s>kıyametlerimizde</s>	<s>kıyametlerde</s>	<s>kıyametlerde</s>
<s>iyileştirmiyordu</s>	<s>iyileştirecekler</s>	<s>iyileştirecekler</s>
<s>anahtarlığınızda</s>	<s>anahtarlıklarınızda</s>	<s>anahtarlıklarınızda</s>
<s>planetlerinizden</s>	<s>planeti</s>	<s>planeti</s>
<s>fakirleştirmedik</s>	<s>fakirleştiriyordu</s>	<s>fakirleştiriyordu</s>
<s>intiharlarımızda</s>	<s>intiharların</s>	<s>intiharların</s>
<s>bitirttiriyordum</s>	<s>bitirttirirler</s>	<s>bitirttirirler</s>
<s>cibiliyetimizden</s>	<s>cibiliyetleriniz</s>	<s>cibiliyetleriniz</s>
<s>röportajlarımdan</s>	<s>röportajım</s>	<s>röportajım</s>
<s>onarmayacaksınız</s>	<s>onarmadınız</s>	<s>onarmadınız</s>
<s>sözleşmelerinize</s>	<s>sözleşmelerimizi</s>	<s>sözleşmelerimizi</s>
<s>hedonistlerinizi</s>	<s>hedonistimin</s>	<s>hedonistimin</s>
<s>canlanmamıyorduk</s>	<s>canlanmamayacaksınız</s>	<s>canlanmamayacaksınız</s>
<s>yetiştirmezsiniz</s>	<s>yetiştirirsiniz</s>	<s>yetiştirirsiniz</s>
<s>penisilinimizden</s>	<s>penisilinlerinin</s>	<s>penisilinlerinin</s>
<s>dikdörtgenlerden</s>	<s>dikdörtgenleri</s>	<s>dikdörtgenleri</s>
<s>bitirtmeyecekler</s>	<s>bitirtmiyorlar</s>	<s>bitirtmiyorlar</s>
<s>maratonlarınızda</s>	<s>maratonuna</s>	<s>maratonuna</s>
<s>yaklaşmıyorsunuz</s>	<s>yaklaşıyordun</s>	<s>yaklaşıyordun</s>
<s>dezenfektanımdan</s>	<s>dezenfektanım</s>	<s>dezenfektanım</s>
<s>prototiplemenizin</s>	<s>prototipleme</s>	<s>prototipleme</s>
<s>noktürnlerimizden</s>	<s>noktürnünde</s>	<s>noktürnünde</s>
<s>ücretliliklerimin</s>	<s>ücretliliğine</s>	<s>ücretliliğine</s>
<s>ayarlattırmıyoruz</s>	<s>ayarlattırmadılar</s>	<s>ayarlattırmadılar</s>
<s>katılmayacaksınız</s>	<s>katılacaksın</s>	<s>katılacaksın</s>
<s>birleştirtiyordun</s>	<s>birleştirtdiniz</s>	<s>birleştirtdiniz</s>
<s>şampiyonluklarına</s>	<s>şampiyonluklarına</s>	<s>şampiyonluklarına</s>
<s>ayarlattırmadılar</s>	<s>ayarlattıracağım</s>	<s>ayarlattıracağım</s>
<s>değiştiriyorsunuz</s>	<s>değiştireceksiniz</s>	<s>değiştireceksiniz</s>
<s>eziyetçiliklerini</s>	<s>eziyetçiliğimizi</s>	<s>eziyetçiliğimizi</s>
<s>muhalefetlerimize</s>	<s>muhalefetlerin</s>	<s>muhalefetlerin</s>
<s>anahtarlıklarımda</s>	<s>anahtarlığı</s>	<s>anahtarlığı</s>
<s>haberleşmeyeceğim</s>	<s>haberleşiyorlardı</s>	<s>haberleşiyorlardı</s>
<s>sinematografımdan</s>	<s>sinematograf</s>	<s>sinematograf</s>
<s>şarapçılarınızdan</s>	<s>şarapçılarını</s>	<s>şarapçılarını</s>
<s>sindirimlerinizin</s>	<s>sindirimlerin</s>	<s>sindirimlerin</s>
<s>canlanmaıyorlardı</s>	<s>canlanmamaz</s>	<s>canlanmamaz</s>
<s>kullanışlarınızda</s>	<s>kullanışlarının</s>	<s>kullanışlarının</s>
<s>dağılmalarımızdan</s>	<s>dağılmalarının</s>	<s>dağılmalarının</s>
<s>sattırtırmıyorduk</s>	<s>sattırtırmazsın</s>	<s>sattırtırmazsın</s>
<s>aseksüellerimizde</s>	<s>aseksüelinizde</s>	<s>aseksüelinizde</s>
<s>kırdırtmayacaksın</s>	<s>kırdırtacaklar</s>	<s>kırdırtacaklar</s>
<s>yumuşaklarınızdan</s>	<s>yumuşaklarında</s>	<s>yumuşaklarında</s>
<s>eziyetçilerinizde</s>	<s>eziyetçisiniz</s>	<s>eziyetçisiniz</s>
<s>oyuncularmışsınız</s>	<s>oyuncularında</s>	<s>oyuncularında</s>
<s>gözlemeyeceksiniz</s>	<s>gözlemiyordum</s>	<s>gözlemiyordum</s>
<s>totemciliğinizden</s>	<s>totemciliğinde</s>	<s>totemciliğinde</s>
<s>lolipoplarımızdan</s>	<s>lolipoplarından</s>	<s>lolipoplarından</s>
<s>mikroişlemcilerde</s>	<s>mikroişlemcilerin</s>	<s>mikroişlemcilerin</s>
<s>ücretliliklerimiz</s>	<s>ücretliliğini</s>	<s>ücretliliğini</s>
<s>kaynaştırılmazlar</s>	<s>kaynaştırılmıyordu</s>	<s>kaynaştırılmıyordu</s>
<s>balalaykalarınızı</s>	<s>balalaykalarımdan</s>	<s>balalaykalarımdan</s>
<s>birleştirmezsiniz</s>	<s>birleştirmiyor</s>	<s>birleştirmiyor</s>
<s>hareketsizliğinin</s>	<s>hareketsizliğimde</s>	<s>hareketsizliğimde</s>
<s>homonimlerimizden</s>	<s>homonimlerim</s>	<s>homonimlerim</s>
<s>kullanışlarınızda</s>	<s>kullanış</s>	<s>kullanış</s>
<s>birlikteliklerime</s>	<s>birlikteliğinizi</s>	<s>birlikteliğinizi</s>
<s>canlandırılıyoruz</s>	<s>canlandırılacağız</s>	<s>canlandırılacağız</s>
<s>tecrübelerinizden</s>	<s>tecrüben</s>	<s>tecrüben</s>
<s>fotoğraflarınızın</s>	<s>fotoğrafında</s>	<s>fotoğrafında</s>
<s>karıştırmıyordular</s>	<s>karıştırmadın</s>	<s>karıştırmadın</s>
<s>yardımcılıklarınız</s>	<s>yardımcılıklarımın</s>	<s>yardımcılıklarımın</s>
<s>dalgalanmıyordular</s>	<s>dalgalanıyordum</s>	<s>dalgalanıyordum</s>
<s>işkencecilerimizin</s>	<s>işkencecilerine</s>	<s>işkencecilerine</s>
<s>psikoterapileriniz</s>	<s>psikoterapilerinden</s>	<s>psikoterapilerinden</s>
<s>süperpozisyonumuzu</s>	<s>süperpozisyonlarınızda</s>	<s>süperpozisyonlarınızda</s>
<s>alındırtmıyordular</s>	<s>alındırtırsınız</s>	<s>alındırtırsınız</s>
<s>ejderhalarmışsınız</s>	<s>ejderhalarının</s>	<s>ejderhalarının</s>
<s>ayrımcılıklarmışız</s>	<s>ayrımcılıklarınızda</s>	<s>ayrımcılıklarınızda</s>
<s>fortlamayacaksınız</s>	<s>fortlamadılar</s>	<s>fortlamadılar</s>
<s>yağlayıcılarımızın</s>	<s>yağlayıcısına</s>	<s>yağlayıcısına</s>
<s>kaynaştıracaksınız</s>	<s>kaynaştırır</s>	<s>kaynaştırır</s>
<s>animasyonlarımızın</s>	<s>animasyonunuzun</s>	<s>animasyonunuzun</s>
<s>tipografyalarından</s>	<s>tipografyamız</s>	<s>tipografyamız</s>
<s>heteroseksüelmişiz</s>	<s>heteroseksüeller</s>	<s>heteroseksüeller</s>
<s>çöpçatanlıklarının</s>	<s>çöpçatanlığına</s>	<s>çöpçatanlığına</s>
<s>acıktırtmıyordular</s>	<s>acıktırtıyorum</s>	<s>acıktırtıyorum</s>
<s>permütasyonlarımda</s>	<s>permütasyonumuzu</s>	<s>permütasyonumuzu</s>
<s>sonsuzluklarınızda</s>	<s>sonsuzluğumuzda</s>	<s>sonsuzluğumuzda</s>
<s>heyecanlanmıyorduk</s>	<s>heyecanlanıyorum</s>	<s>heyecanlanıyorum</s>
<s>dalgalandırmadılar</s>	<s>dalgalandırıyoruz</s>	<s>dalgalandırıyoruz</s>
<s>ölümsüzleştirmeyiz</s>	<s>ölümsüzleştirmiyorsun</s>	<s>ölümsüzleştirmiyorsun</s>
<s>palindromlarımızdan</s>	<s>palindromların</s>	<s>palindromların</s>
<s>homoseksüelmişsiniz</s>	<s>homoseksüelimizden</s>	<s>homoseksüelimizden</s>
<s>canlandırtılacaksın</s>	<s>canlandırtılmıyordu</s>	<s>canlandırtılmıyordu</s>
<s>süründürtmüyordular</s>	<s>süründürtmeyeceksin</s>	<s>süründürtmeyeceksin</s>
<s>alındırmayacaksınız</s>	<s>alındırırsın</s>	<s>alındırırsın</s>
<s>ağaçkakanlarımızdan</s>	<s>ağaçkakanınızı</s>	<s>ağaçkakanınızı</s>
<s>buruşukluklarınızın</s>	<s>buruşukluk</s>	<s>buruşukluk</s>
<s>şampiyonluklarınızı</s>	<s>şampiyonluğumun</s>	<s>şampiyonluğumun</s>
<s>programlattırmadınız</s>	<s>programlattırıyordu</s>	<s>programlattırıyordu</s>
<s>ayarlattırmıyordular</s>	<s>ayarlattıracaksınız</s>	<s>ayarlattıracaksınız</s>
<s>köygöçürenlerimizden</s>	<s>köygöçürenimizi</s>	<s>köygöçürenimizi</s>
<s>heyecanlandırmıyordun</s>	<s>heyecanlandıracağım</s>	<s>heyecanlandıracağım</s>
<s>sürdürebilirliklerden</s>	<s>sürdürülebilirliklere</s>	<s>sürdürebilirliklere</s>
<s>canlandırtılıyorlardı</s>	<s>canlandırtıltın</s>	<s>canlandırtıltın</s>
<s>yetersizliklerimizden</s>	<s>yetersizliklerinizde</s>	<s>yetersizliklerinizde</s>
<s>prototiplemelerinizden</s>	<s>prototiplemeleri</s>	<s>prototiplemeleri</s>
<s>mesuliyetsizliklerinize</s>	<s>mesuliyetsizlikleri</s>	<s>mesuliyetsizlikleri</s>
<s>kaynaştırtılmayacaksınız</s>	<s>kaynaştırtılmıyorum</s>	<s>kaynaştırtılmıyorum</s>
<s>düzenlenebilirliklerinizin</s>	<s>düzenlenebilirliklerden</s>	<s>düzenlenebilirliklerden</s>
