hafta	hafta+Noun+A3sg+Pnon+Nom
kısa	kısa+Adj
avans	avans+Noun+A3sg+Pnon+Nom
trilyon	trilyon+Num+Card
geri	geri+Adverb
ödeme	ödeme+Noun+A3sg+Pnon+Nom
döviz	döviz+Noun+A3sg+Pnon+Nom
milyon	milyon+Num+Card
bu	bu+Pron+Demons+A3sg+Pnon+Nom
da	da+Conj
lira	lira+Noun+A3sg+Pnon+Nom
bir	bir+Det
iç	iç+Adj
ile	ile+Conj
birlikte	birlikte+Adverb
rezerv	rezerv+Noun+A3sg+Pnon+Nom
para	para+Noun+A3sg+Pnon+Nom
ve	ve+Conj
piyasa	piyasa+Noun+A3sg+Pnon+Nom
emisyon	emisyon+Noun+A3sg+Pnon+Nom
milyar	milyar+Num+Card
dolar	dolar+Noun+A3sg+Pnon+Nom
borç	borç+Noun+A3sg+Pnon+Nom
ilk	ilk+Adverb
diğer	diğer+Adj
kamu	kamu+Noun+A3sg+Pnon+Nom
ait	ait+Postp+PCDat
yıl	yıl+Noun+A3sg+Pnon+Nom
dış	dış+Adj
boru	boru+Noun+A3sg+Pnon+Nom
petrol	petrol+Noun+A3sg+Pnon+Nom
aksine	aksine+Adverb
neden	neden+Noun+A3sg+Pnon+Nom
değil	değil+Conj
için	için+Postp+PCGen
bazı	bazı+Det
iptal	iptal+Noun+A3sg+Pnon+Nom
karşı	karşı+Adj
altı	altı+Num+Card
ay	ay+Noun+A3sg+Pnon+Nom
izin	izin+Noun+A3sg+Pnon+Nom
kadar	kadar+Postp+PCDat
sözleşme	sözleşme+Noun+A3sg+Pnon+Nom
birkaç	birkaç+Det
başta	başta+Adverb
üzere	üzere+Postp+PCNom
üye	üye+Noun+A3sg+Pnon+Nom
aylık	aylık+Noun+A3sg+Pnon+Nom
süre	süre+Noun+A3sg+Pnon+Nom
bile	bile+Adverb
un	un+Noun+A3sg+Pnon+Nom
dünya	dünya+Noun+A3sg+Pnon+Nom
pek	pek+Adverb
çok	çok+Adj
şirket	şirket+Noun+A3sg+Pnon+Nom
yarı	yarı+Adj
daha	daha+Adverb
az	az+Postp+PCAbl
etki	etki+Noun+A3sg+Pnon+Nom
suç	suç+Noun+A3sg+Pnon+Nom
hakaret	hakaret+Noun+A3sg+Pnon+Nom
ifade	ifade+Noun+A3sg+Pnon+Nom
eski	eski+Adj
sendikacı	sendikacı+Noun+A3sg+Pnon+Nom
dolayı	dolayı+Postp+PCAbl
dost	dost+Noun+A3sg+Pnon+Nom
tazminat	tazminat+Noun+A3sg+Pnon+Nom
boy	boy+Noun+A3sg+Pnon+Nom
kriz	kriz+Noun+A3sg+Pnon+Nom
rapor	rapor+Noun+A3sg+Pnon+Nom
yalnızca	yalnızca+Adverb
türban	türban+Noun+A3sg+Pnon+Nom
hedef	hedef+Noun+A3sg+Pnon+Nom
öğretim	öğretim+Noun+A3sg+Pnon+Nom
ekonomik	ekonomik+Adj
sosyal	sosyal+Adj
gençlik	gençlik+Noun+A3sg+Pnon+Nom
en	en+Adverb
fazla	fazla+Adverb
sahip	sahip+Noun+A3sg+Pnon+Nom
dikkat	dikkat+Noun+A3sg+Pnon+Nom
gün	gün+Noun+A3sg+Pnon+Nom
sonra	sonra+Adverb
mutlaka	mutlaka+Adverb
serbest	serbest+Adj
büyük	büyük+Adj
tepki	tepki+Noun+A3sg+Pnon+Nom
dün	dün+Noun+A3sg+Pnon+Nom
yönelik	yönelik+Postp+PCDat
insan	insan+Noun+A3sg+Pnon+Nom
somut	somut+Adj
kıyafet	kıyafet+Noun+A3sg+Pnon+Nom
aykırı	aykırı+Adj
oysa	oysa+Conj
öyle	öyle+Adverb
nefret	nefret+Noun+A3sg+Pnon+Nom
dolu	dolu+Adj
ki	ki+Conj
on	on+Num+Card
diye	diye+Postp+PCNom
cevap	cevap+Noun+A3sg+Pnon+Nom
delikanlı	delikanlı+Noun+A3sg+Pnon+Nom
ne	ne+Conj
yardım	yardım+Noun+A3sg+Pnon+Nom
nasıl	nasıl+Adverb
şimdi	şimdi+Adverb
her	her+Det
eskiden	eskiden+Adverb
düşkün	düşkün+Adj
şu	şu+Pron+Demons+A3sg+Pnon+Nom
aptal	aptal+Adj
ah	ah+Interj
muazzam	muazzam+Adj
artık	artık+Adverb
asla	asla+Adverb
zarar	zarar+Noun+A3sg+Pnon+Nom
mi	mi+Ques+Pres+A3sg
evet	evet+Adverb
o	o+Pron+Demons+A3sg+Pnon+Nom
ebediyen	ebediyen+Adverb
kız	kız+Noun+A3sg+Pnon+Nom
sadece	sadece+Adverb
oğlan	oğlan+Noun+A3sg+Pnon+Nom
önce	önce+Adverb
saat	saat+Noun+A3sg+Pnon+Nom
istirahat	istirahat+Noun+A3sg+Pnon+Nom
ısrar	ısrar+Noun+A3sg+Pnon+Nom
biraz	biraz+Adverb
kalıp	kalıp+Noun+A3sg+Pnon+Nom
sahne	sahne+Noun+A3sg+Pnon+Nom
çünkü	çünkü+Conj
tür	tür+Noun+A3sg+Pnon+Nom
sanki	sanki+Adverb
nebze	nebze+Noun+A3sg+Pnon+Nom
gerçek	gerçek+Adj
yaş	yaş+Adj
kadın	kadın+Noun+A3sg+Pnon+Nom
hiç	hiç+Adverb
dakik	dakik+Adj
şikayet	şikayet+Noun+A3sg+Pnon+Nom
de	de+Conj
zengin	zengin+Adj
tek	tek+Adj
binek	binek+Noun+A3sg+Pnon+Nom
zaman	zaman+Noun+A3sg+Pnon+Nom
durum	durum+Noun+A3sg+Pnon+Nom
şüphe	şüphe+Noun+A3sg+Pnon+Nom
haber	haber+Noun+A3sg+Pnon+Nom
karışık	karışık+Adj
gibi	gibi+Postp+PCGen
pırtık	pırtık+Noun+A3sg+Pnon+Nom
dantel	dantel+Noun+A3sg+Pnon+Nom
merhamet	merhamet+Noun+A3sg+Pnon+Nom
var	var+Adj
söyle	söyle+Verb+Pos+Imp+A2sg
evli	evli+Adj
derin	derin+Adj
berbat	berbat+Adj
an	an+Noun+A3sg+Pnon+Nom
boyunca	boyunca+Postp+PCNom
dakika	dakika+Noun+A3sg+Pnon+Nom
sonunda	sonunda+Adverb
rağmen	rağmen+Postp+PCDat
korku	korku+Noun+A3sg+Pnon+Nom
hüsran	hüsran+Noun+A3sg+Pnon+Nom
aynı	aynı+Adj
açık	açık+Adverb
vaziyet	vaziyet+Noun+A3sg+Pnon+Nom
peyderpey	peyderpey+Adverb
peyda	peyda+Adj
kötü	kötü+Adj
sert	sert+Adj
acı	acı+Verb+Pos+Imp+A2sg
hayret	hayret+Noun+A3sg+Pnon+Nom
yanıt	yanıt+Noun+A3sg+Pnon+Nom
alçak	alçak+Adj
temin	temin+Noun+A3sg+Pnon+Nom
küfür	küfür+Noun+A3sg+Pnon+Nom
fakat	fakat+Conj
adam	adam+Noun+A3sg+Pnon+Nom
centilmen	centilmen+Noun+A3sg+Pnon+Nom
mu	mu+Ques+Pres+A3sg
yüksek	yüksek+Adj
mensup	mensup+Noun+A3sg+Pnon+Nom
iğrenç	iğrenç+Adj
utanç	utanç+Noun+A3sg+Pnon+Nom
doğru	doğru+Postp+PCDat
kal	kal+Verb+Pos+Imp+A2sg
inan	inan+Noun+A3sg+Pnon+Nom
eğer	eğer+Conj
kim	kim+Pron+Ques+A3sg+Pnon+Nom
köpek	köpek+Noun+A3sg+Pnon+Nom
mübalağa	mübalağa+Noun+A3sg+Pnon+Nom
çılgın	çılgın+Noun+A3sg+Pnon+Nom
canlı	canlı+Noun+A3sg+Pnon+Nom
soluk	soluk+Noun+A3sg+Pnon+Nom
kez	kez+Noun+A3sg+Pnon+Nom
gerçekten	gerçekten+Adverb
takdir	takdir+Noun+A3sg+Pnon+Nom
duygusal	duygusal+Adj
devam	devam+Noun+A3sg+Pnon+Nom
memnun	memnun+Adj
kontrol	kontrol+Noun+A3sg+Pnon+Nom
aşağı	aşağı+Noun+A3sg+Pnon+Dat
yukarı	yukarı+Adj
yeniden	yeniden+Adverb
hayal	hayal+Noun+A3sg+Pnon+Nom
ziyan	ziyan+Noun+A3sg+Pnon+Nom
yalnız	yalnız+Adverb
kendi	kendi+Pron+Reflex+A3sg+P3sg+Nom
teselli	teselli+Noun+A3sg+Pnon+Nom
söz	söz+Noun+A3sg+Pnon+Nom
dramatik	dramatik+Adj
sonradan	sonradan+Adverb
hep	hep+Adverb
beraber	beraber+Postp+PCIns
küçük	küçük+Adj
şahsi	şahsi+Adj
üç	üç+Num+Card
kişi	kişi+Noun+A3sg+Pnon+Nom
akşam	akşam+Noun+A3sg+Pnon+Nom
yeni	yeni+Adj
sanatçı	sanatçı+Noun+A3sg+Pnon+Nom
resmi	resmi+Adj
değer	değer+Noun+A3sg+Pnon+Nom
zor	zor+Adj
ufak	ufak+Adj
pekala	pekala+Adverb
iyi	iyi+Adj
mı	mı+Ques+Pres+A3sg
ya	ya+Conj
şey	şey+Noun+A3sg+Pnon+Nom
ara	ara+Adj
sıra	sıra+Noun+A3sg+Pnon+Nom
sevgili	sevgili+Adj
hariç	hariç+Noun+A3sg+Pnon+Nom
fark	fark+Noun+A3sg+Pnon+Nom
hala	hala+Adverb
dair	dair+Postp+PCDat
hiçbir	hiçbir+Det
yok	yok+Adverb
düşün	düşün+Verb+Pos+Imp+A2sg
saçma	saçma+Adj
yeterli	yeterli+Adj
büsbütün	büsbütün+Adverb
daima	daima+Adverb
asil	asil+Adj
ileri	ileri+Adj
ifsat	ifsat+Noun+A3sg+Pnon+Nom
bayağı	bayağı+Adverb
vermut	vermut+Noun+A3sg+Pnon+Nom
portakal	portakal+Noun+A3sg+Pnon+Nom
öte	öte+Postp+PCAbl
güzel	güzel+Adj
çeşit	çeşit+Noun+A3sg+Pnon+Nom
portre	portre+Noun+A3sg+Pnon+Nom
gece	gece+Noun+A3sg+Pnon+Nom
ciddi	ciddi+Adj
sen	sen+Pron+Pers+A2sg+Pnon+Nom
mümkün	mümkün+Adj
aşk	aşk+Noun+A3sg+Pnon+Nom
herhangi	herhangi+Adj
yahut	yahut+Conj
tutum	tutum+Noun+A3sg+Pnon+Nom
ahlaki	ahlaki+Adj
şahsiyet	şahsiyet+Noun+A3sg+Pnon+Nom
tercih	tercih+Noun+A3sg+Pnon+Nom
hayat	hayat+Noun+A3sg+Pnon+Nom
teklif	teklif+Noun+A3sg+Pnon+Nom
ilginç	ilginç+Adj
asıl	asıl+Adj
cömert	cömert+Adj
evlilik	evlilik+Noun+A3sg+Pnon+Nom
karmaşık	karmaşık+Adj
organize	organize+Adj
varoluş	varoluş+Noun+A3sg+Pnon+Nom
ancak	ancak+Conj
bütün	bütün+Adj
birdenbire	birdenbire+Adverb
biri	biri+Pron+Quant+A3sg+P3sg+Nom
muhteşem	muhteşem+Adj
deneyim	deneyim+Noun+A3sg+Pnon+Nom
aslında	aslında+Adverb
safi	safi+Adj
alicenap	alicenap+Adj
muhtemelen	muhtemelen+Adverb
fayda	fayda+Noun+A3sg+Pnon+Nom
aşağılık	aşağılık+Adj
şekil	şekil+Noun+A3sg+Pnon+Nom
elbette	elbette+Adverb
başka	başka+Postp+PCAbl
teşvik	teşvik+Noun+A3sg+Pnon+Nom
işte	işte+Adverb
saten	saten+Noun+A3sg+Pnon+Nom
mutlu	mutlu+Adj
ani	ani+Adj
böyle	böyle+Adverb
olağanüstü	olağanüstü+Adj
yakışıklı	yakışıklı+Adj
ümit	ümit+Noun+A3sg+Pnon+Nom
haberdar	haberdar+Noun+A3sg+Pnon+Nom
halbuki	halbuki+Conj
geç	geç+Adverb
hepsi	hepsi+Pron+Quant+A3pl+P3pl+Nom
hani	hani+Adverb
yemek	yemek+Noun+A3sg+Pnon+Nom
oyun	oyun+Noun+A3sg+Pnon+Nom
rengarenk	rengarenk+Adj
kadife	kadife+Adj
yelek	yelek+Noun+A3sg+Pnon+Nom
dar	dar+Adj
kahverengi	kahverengi+Adj
çapraz	çapraz+Adj
pantolon	pantolon+Noun+A3sg+Pnon+Nom
şahin	şahin+Noun+A3sg+Pnon+Nom
gayet	gayet+Adverb
zarif	zarif+Adj
yeşil	yeşil+Adj
şapka	şapka+Noun+A3sg+Pnon+Nom
kırmızı	kırmızı+Adj
pelerin	pelerin+Noun+A3sg+Pnon+Nom
nefis	nefis+Adj
enfes	enfes+Adj
solgun	solgun+Adj
koyu	koyu+Adj
renk	renk+Noun+A3sg+Pnon+Nom
önceleri	önceleri+Adverb
önceden	önceden+Adverb
tarif	tarif+Noun+A3sg+Pnon+Nom
gül	gül+Noun+A3sg+Pnon+Nom
beyaz	beyaz+Adj
nilüfer	nilüfer+Noun+A3sg+Pnon+Nom
şimdilik	şimdilik+Adverb
sır	sır+Noun+A3sg+Pnon+Nom
reşit	reşit+Adj
tamamen	tamamen+Adverb
iş	iş+Noun+A3sg+Pnon+Nom
layık	layık+Adj
ama	ama+Conj
pratik	pratik+Noun+A3sg+Pnon+Nom
belli	belli+Adj
soru	soru+Noun+A3sg+Pnon+Nom
saf	saf+Adj
merak	merak+Noun+A3sg+Pnon+Nom
şöyle	şöyle+Adj
biz	biz+Pron+Pers+A1pl+Pnon+Nom
orta	orta+Adj
sınıf	sınıf+Noun+A3sg+Pnon+Nom
zaten	zaten+Adverb
modern	modern+Adj
iflah	iflah+Noun+A3sg+Pnon+Nom
hayvan	hayvan+Noun+A3sg+Pnon+Nom
erkek	erkek+Noun+A3sg+Pnon+Nom
yazık	yazık+Noun+A3sg+Pnon+Nom
kaide	kaide+Noun+A3sg+Pnon+Nom
mütemadiyen	mütemadiyen+Adverb
yemin	yemin+Noun+A3sg+Pnon+Nom
dalga	dalga+Noun+A3sg+Pnon+Nom
sadık	sadık+Adj
dehşet	dehşet+Noun+A3sg+Pnon+Nom
parça	parça+Noun+A3sg+Pnon+Nom
salata	salata+Noun+A3sg+Pnon+Nom
kuram	kuram+Noun+A3sg+Pnon+Nom
üzgün	üzgün+Adj
yavaş	yavaş+Adj
ses	ses+Noun+A3sg+Pnon+Nom
iddia	iddia+Noun+A3sg+Pnon+Nom
pembe	pembe+Noun+A3sg+Pnon+Nom
gür	gür+Adj
tekrar	tekrar+Adverb
bizzat	bizzat+Adverb
ince	ince+Adj
uyum	uyum+Noun+A3sg+Pnon+Nom
hırçın	hırçın+Adj
bağnaz	bağnaz+Adj
kabul	kabul+Noun+A3sg+Pnon+Nom
gelenekçi	gelenekçi+Noun+A3sg+Pnon+Nom
ben	ben+Pron+Pers+A1sg+Pnon+Nom
farz	farz+Noun+A3sg+Pnon+Nom
korkunç	korkunç+Adj
bedel	bedel+Noun+A3sg+Pnon+Nom
ressam	ressam+Noun+A3sg+Pnon+Nom
aşırı	aşırı+Adj
satın	satın+Noun+A3sg+Pnon+Nom
velev	velev+Noun+A3sg+Pnon+Nom
ıstırap	ıstırap+Noun+A3sg+Pnon+Nom
ortaçağ	ortaçağ+Noun+A3sg+Pnon+Nom
medeni	medeni+Adj
barbar	barbar+Noun+A3sg+Pnon+Nom
hayran	hayran+Noun+A3sg+Pnon+Nom
baş	baş+Noun+A3sg+Pnon+Nom
evvela	evvela+Adverb
parlak	parlak+Adj
göğüs	göğüs+Noun+A3sg+Pnon+Nom
azar	azar+Noun+A3sg+Pnon+Nom
nüktedan	nüktedan+Adj
mani	mani+Noun+A3sg+Pnon+Nom
niçin	niçin+Adverb
kahve	kahve+Noun+A3sg+Pnon+Nom
getir	getir+Verb+Pos+Imp+A2sg
ayrıca	ayrıca+Adverb
tabii	tabii+Adj
sigara	sigara+Noun+A3sg+Pnon+Nom
boşver	boşver+Verb+Pos+Imp+A2sg
tane	tane+Noun+A3sg+Pnon+Nom
puro	puro+Noun+A3sg+Pnon+Nom
tasvip	tasvip+Noun+A3sg+Pnon+Nom
benzersiz	benzersiz+Adj
keyif	keyif+Noun+A3sg+Pnon+Nom
cüret	cüret+Noun+A3sg+Pnon+Nom
temsil	temsil+Noun+A3sg+Pnon+Nom
ejderha	ejderha+Noun+A3sg+Pnon+Nom
gümüş	gümüş+Adj
bambaşka	bambaşka+Adj
yorgun	yorgun+Adj
kupa	kupa+Noun+A3sg+Pnon+Nom
iki	iki+Num+Card
kişilik	kişilik+Noun+A3sg+Pnon+Nom
yer	yer+Noun+A3sg+Pnon+Nom
takip	takip+Noun+A3sg+Pnon+Nom
et	et+Verb+Pos+Imp+A2sg
kasvet	kasvet+Noun+A3sg+Pnon+Nom
garip	garip+Adj
kayıp	kayıp+Adj
kalabalık	kalabalık+Noun+A3sg+Pnon+Nom
cadde	cadde+Noun+A3sg+Pnon+Nom
tiyatro	tiyatro+Noun+A3sg+Pnon+Nom
şişman	şişman+Adj
el	el+Noun+A3sg+Pnon+Nom
şiir	şiir+Noun+A3sg+Pnon+Nom
onur	onur+Noun+A3sg+Pnon+Nom
hararet	hararet+Noun+A3sg+Pnon+Nom
sarı	sarı+Adj
taç	taç+Noun+A3sg+Pnon+Nom
devasa	devasa+Adj
yıldız	yıldız+Noun+A3sg+Pnon+Nom
birtakım	birtakım+Det
tiz	tiz+Adj
şişe	şişe+Noun+A3sg+Pnon+Nom
tanrıça	tanrıça+Noun+A3sg+Pnon+Nom
uygun	uygun+Adj
adi	adi+Adj
çirkin	çirkin+Adj
kaba	kaba+Adj
keman	keman+Noun+A3sg+Pnon+Nom
hassas	hassas+Adj
tıpkı	tıpkı+Adverb
opera	opera+Noun+A3sg+Pnon+Nom
zira	zira+Conj
tesir	tesir+Noun+A3sg+Pnon+Nom
hoş	hoş+Adj
manevi	manevi+Adj
dek	dek+Postp+PCDat
ruh	ruh+Noun+A3sg+Pnon+Nom
sefil	sefil+Adj
gözyaşı	gözyaşı+Noun+A3sg+P3sg+Nom
hatta	hatta+Conj
orkestra	orkestra+Noun+A3sg+Pnon+Nom
beş	beş+Num+Card
alkış	alkış+Noun+A3sg+Pnon+Nom
sevimli	sevimli+Adj
utangaç	utangaç+Adj
yavru	yavru+Noun+A3sg+Pnon+Nom
göz	göz+Noun+A3sg+Pnon+Nom
donuk	donuk+Adj
adım	adım+Noun+A3sg+Pnon+Nom
içeri	içeri+Noun+A3sg+Pnon+Nom
dans	dans+Noun+A3sg+Pnon+Nom
çiçek	çiçek+Noun+A3sg+Pnon+Nom
adeta	adeta+Adverb
sevinç	sevinç+Noun+A3sg+Pnon+Nom
sözcük	sözcük+Noun+A3sg+Pnon+Nom
cümle	cümle+Noun+A3sg+Pnon+Nom
hacı	hacı+Noun+A3sg+Pnon+Nom
ayan	ayan+Adj
kutsal	kutsal+Adj
diyalog	diyalog+Noun+A3sg+Pnon+Nom
baştanbaşa	baştanbaşa+Adverb
son	son+Adj
derece	derece+Noun+A3sg+Pnon+Nom
iniş	iniş+Noun+A3sg+Pnon+Nom
yapay	yapay+Adj
heyecan	heyecan+Noun+A3sg+Pnon+Nom
cesaret	cesaret+Noun+A3sg+Pnon+Nom
fevkalade	fevkalade+Adj
ikinci	ikinci+Num+Ord
balkon	balkon+Noun+A3sg+Pnon+Nom
inkar	inkar+Noun+A3sg+Pnon+Nom
gülünç	gülünç+Adj
genç	genç+Adj
okul	okul+Noun+A3sg+Pnon+Nom
hitabet	hitabet+Noun+A3sg+Pnon+Nom
harika	harika+Adj
anii	anii+Noun+A3sg+Pnon+Nom
çabucak	çabucak+Adverb
ışık	ışık+Noun+A3sg+Pnon+Nom
olgun	olgun+Adj
ürkek	ürkek+Adj
galeri	galeri+Noun+A3sg+Pnon+Nom
harcıalem	harcıalem+Adj
uğultu	uğultu+Noun+A3sg+Pnon+Nom
müdür	müdür+Noun+A3sg+Pnon+Nom
sakin	sakin+Adj
bölüm	bölüm+Noun+A3sg+Pnon+Nom
ıslık	ıslık+Noun+A3sg+Pnon+Nom
rol	rol+Noun+A3sg+Pnon+Nom
buruk	buruk+Adj
özür	özür+Noun+A3sg+Pnon+Nom
hasta	hasta+Noun+A3sg+Pnon+Nom
soğuk	soğuk+Adj
müthiş	müthiş+Adj
aktris	aktris+Noun+A3sg+Pnon+Nom
sakat	sakat+Noun+A3sg+Pnon+Nom
plan	plan+Noun+A3sg+Pnon+Nom
rezil	rezil+Adj
yalan	yalan+Noun+A3sg+Pnon+Nom
dağ	dağ+Noun+A3sg+Pnon+Nom
tatlı	tatlı+Adj
geniş	geniş+Adj
henüz	henüz+Adverb
taslak	taslak+Noun+A3sg+Pnon+Nom
ana	ana+Adj
sürü	sürü+Noun+A3sg+Pnon+Nom
ihtiyaç	ihtiyaç+Noun+A3sg+Pnon+Nom
bilhassa	bilhassa+Adverb
belki	belki+Adverb
gizli	gizli+Adj
dükkan	dükkan+Noun+A3sg+Pnon+Nom
yani	yani+Conj
tam	tam+Adverb
tuhaf	tuhaf+Noun+A3sg+Pnon+Nom
yirmi	yirmi+Num+Card
kuytu	kuytu+Adj
nüfuz	nüfuz+Noun+A3sg+Pnon+Nom
türlü	türlü+Adj
alabildiğine	alabildiğine+Adverb
konu	konu+Noun+A3sg+Pnon+Nom
his	his+Noun+A3sg+Pnon+Nom
bazen	bazen+Adverb
mucize	mucize+Noun+A3sg+Pnon+Nom
cam	cam+Noun+A3sg+Pnon+Nom
muhafaza	muhafaza+Noun+A3sg+Pnon+Nom
psikolog	psikolog+Noun+A3sg+Pnon+Nom
kalp	kalp+Noun+A3sg+Pnon+Nom
havadis	havadis+Noun+A3sg+Pnon+Nom
şimşek	şimşek+Noun+A3sg+Pnon+Nom
kısmen	kısmen+Adverb
yabancı	yabancı+Adj
sıkıntı	sıkıntı+Noun+A3sg+Pnon+Nom
tersine	tersine+Adverb
eşit	eşit+Adj
milyoner	milyoner+Noun+A3sg+Pnon+Nom
dul	dul+Noun+A3sg+Pnon+Nom
vali	vali+Noun+A3sg+Pnon+Nom
hem	hem+Adverb
birinci	birinci+Num+Ord
kimse	kimse+Noun+A3sg+Pnon+Nom
tahammül	tahammül+Noun+A3sg+Pnon+Nom
hiddet	hiddet+Noun+A3sg+Pnon+Nom
kızgın	kızgın+Adj
günah	günah+Noun+A3sg+Pnon+Nom
hareket	hareket+Noun+A3sg+Pnon+Nom
bar	bar+Noun+A3sg+Pnon+Nom
tahmin	tahmin+Noun+A3sg+Pnon+Nom
geleni	geleni+Noun+A3sg+Pnon+Nom
yüzde	yüzde+Noun+A3sg+Pnon+Nom
yüz	yüz+Noun+A3sg+Pnon+Nom
şimdiden	şimdiden+Adverb
kilit	kilit+Noun+A3sg+Pnon+Nom
hemen	hemen+Adverb
bugün	bugün+Noun+A3sg+Pnon+Nom
bahane	bahane+Noun+A3sg+Pnon+Nom
fikir	fikir+Noun+A3sg+Pnon+Nom
ihmal	ihmal+Noun+A3sg+Pnon+Nom
ilham	ilham+Noun+A3sg+Pnon+Nom
kulak	kulak+Noun+A3sg+Pnon+Nom
yol	yol+Noun+A3sg+Pnon+Nom
kelime	kelime+Noun+A3sg+Pnon+Nom
kadeh	kadeh+Noun+A3sg+Pnon+Nom
şampanya	şampanya+Noun+A3sg+Pnon+Nom
oldukça	oldukça+Adverb
endişe	endişe+Noun+A3sg+Pnon+Nom
takım	takım+Noun+A3sg+Pnon+Nom
nazik	nazik+Adj
ev	ev+Noun+A3sg+Pnon+Nom
cenaze	cenaze+Noun+A3sg+Pnon+Nom
çabuk	çabuk+Adverb
lanet	lanet+Noun+A3sg+Pnon+Nom
kazık	kazık+Noun+A3sg+Pnon+Nom
haliyle	haliyle+Adverb
şüphesiz	şüphesiz+Adverb
hal	hal+Noun+A3sg+Pnon+Nom
tüccar	tüccar+Noun+A3sg+Pnon+Nom
sitem	sitem+Noun+A3sg+Pnon+Nom
üçüncü	üçüncü+Num+Ord
gelişim	gelişim+Noun+A3sg+Pnon+Nom
ayak	ayak+Noun+A3sg+Pnon+Nom
gel	gel+Verb+Pos+Imp+A2sg
dört	dört+Num+Card
içer	içer+Verb+Pos+Imp+A2sg
ihtiyar	ihtiyar+Adj
vaftiz	vaftiz+Noun+A3sg+Pnon+Nom
elli	elli+Num+Card
sıcak	sıcak+Adj
bin	bin+Num+Card
ziyaret	ziyaret+Noun+A3sg+Pnon+Nom
siz	siz+Pron+Pers+A2pl+Pnon+Nom
hücum	hücum+Noun+A3sg+Pnon+Nom
ters	ters+Adj
kalın	kalın+Adj
bakın	bakın+Verb+Pos+Imp+A2sg
saygı	saygı+Noun+A3sg+Pnon+Nom
lütfen	lütfen+Adverb
çoktandır	çoktandır+Adverb
revoir	revoir+Noun+A3sg+Pnon+Nom
au	au+Noun+A3sg+Pnon+Nom
neredeyse	neredeyse+Adverb
beri	beri+Postp+PCAbl
eda	eda+Noun+A3sg+Pnon+Nom
veda	veda+Noun+A3sg+Pnon+Nom
keklik	keklik+Noun+A3sg+Pnon+Nom
parmak	parmak+Noun+A3sg+Pnon+Nom
sabah	sabah+Noun+A3sg+Pnon+Nom
komedi	komedi+Noun+A3sg+Pnon+Nom
kolay	kolay+Adj
razı	razı+Adj
budala	budala+Noun+A3sg+Pnon+Nom
bön	bön+Adj
bakan	bakan+Noun+A3sg+Pnon+Nom
ihanet	ihanet+Noun+A3sg+Pnon+Nom
koyun	koyun+Noun+A3sg+Pnon+Nom
naz	naz+Noun+A3sg+Pnon+Nom
savaş	savaş+Noun+A3sg+Pnon+Nom
iftihar	iftihar+Noun+A3sg+Pnon+Nom
özel	özel+Adj
ilgi	ilgi+Noun+A3sg+Pnon+Nom
vet	vet+Noun+A3sg+Pnon+Nom
fev	fev+Noun+A3sg+Pnon+Nom
ka	ka+Noun+A3sg+Pnon+Nom
la	la+Noun+A3sg+Pnon+Nom
eğ	eğ+Verb+Pos+Imp+A2sg
dik	dik+Adj
yüce	yüce+Adj
komedya	komedya+Noun+A3sg+Pnon+Nom
yaldız	yaldız+Noun+A3sg+Pnon+Nom
cehennem	cehennem+Noun+A3sg+Pnon+Nom
eşek	eşek+Noun+A3sg+Pnon+Nom
paramparça	paramparça+Adj
bak	bak+Verb+Pos+Imp+A2sg
sırf	sırf+Adverb
ikram	ikram+Noun+A3sg+Pnon+Nom
aralık	aralık+Noun+A3sg+Pnon+Nom
dışarı	dışarı+Noun+A3sg+Pnon+Nom
şeker	şeker+Noun+A3sg+Pnon+Nom
komik	komik+Noun+A3sg+Pnon+Nom
olay	olay+Noun+A3sg+Pnon+Nom
yor	yor+Verb+Pos+Imp+A2sg
su	su+Noun+A3sg+Pnon+Nom
nuz	nuz+Noun+A3sg+Pnon+Nom
a	a+Interj
nor	nor+Noun+A3sg+Pnon+Nom
mal	mal+Noun+A3sg+Pnon+Nom
karar	karar+Noun+A3sg+Pnon+Nom
fıçı	fıçı+Noun+A3sg+Pnon+Nom
vücut	vücut+Noun+A3sg+Pnon+Nom
oy	oy+Noun+A3sg+Pnon+Nom
yan	yan+Adj
çocuk	çocuk+Noun+A3sg+Pnon+Nom
kıvrak	kıvrak+Adj
ge	ge+Noun+A3sg+Pnon+Nom
li	li+Noun+A3sg+Pnon+Nom
şi	şi+Noun+A3sg+Pnon+Nom
cici	cici+Adj
kızcağız	kızcağız+Noun+A3sg+Pnon+Nom
süz	süz+Verb+Pos+Imp+A2sg
mü	mü+Ques+Pres+A3sg
bari	bari+Adverb
gene	gene+Adverb
ci	ci+Noun+A3sg+Pnon+Nom
charmante	charmante+Noun+A3sg+Pnon+Nom
şarkı	şarkı+Noun+A3sg+Pnon+Nom
artist	artist+Noun+A3sg+Pnon+Nom
zavallı	zavallı+Adj
has	has+Adj
ağır	ağır+Adj
evlat	evlat+Noun+A3sg+Pnon+Nom
kontes	kontes+Noun+A3sg+Pnon+Nom
otuz	otuz+Num+Card
öl	öl+Verb+Pos+Imp+A2sg
müş	müş+Noun+A3sg+Pnon+Nom
tü	tü+Interj
em	em+Noun+A3sg+Pnon+Nom
sal	sal+Noun+A3sg+Pnon+Nom
ru	ru+Noun+A3sg+Pnon+Nom
kont	kont+Noun+A3sg+Pnon+Nom
ufacık	ufacık+Adj
kavga	kavga+Noun+A3sg+Pnon+Nom
anne	anne+Noun+A3sg+Pnon+Nom
charmant	charmant+Noun+A3sg+Pnon+Nom
zi	zi+Noun+A3sg+Pnon+Nom
ği	ği+Noun+A3sg+Pnon+Nom
taşkın	taşkın+Noun+A3sg+Pnon+Nom
ha	ha+Interj
rış	rış+Noun+A3sg+Pnon+Nom
tı	tı+Noun+A3sg+Pnon+Nom
rı	rı+Noun+A3sg+Pnon+Nom
yo	yo+Interj
rum	rum+Noun+A3sg+Pnon+Nom
galiba	galiba+Adverb
defa	defa+Noun+A3sg+Pnon+Nom
şato	şato+Noun+A3sg+Pnon+Nom
coşkun	coşkun+Adj
tır	tır+Noun+A3sg+Pnon+Nom
siyah	siyah+Adj
pırıl	pırıl+Dup
mağrur	mağrur+Adj
epey	epey+Adverb
diz	diz+Noun+A3sg+Pnon+Nom
me	me+Noun+A3sg+Pnon+Nom
ravissez	ravissez+Noun+A3sg+Pnon+Nom
ma	ma+Noun+A3sg+Pnon+Nom
enfant	enfant+Noun+A3sg+Pnon+Nom
bunca	bunca+Adj
duygu	duygu+Noun+A3sg+Pnon+Nom
tabir	tabir+Noun+A3sg+Pnon+Nom
mükemmel	mükemmel+Adj
taze	taze+Adj
personne	personne+Noun+A3sg+Pnon+Nom
yedi	yedi+Num+Card
ü	ü+Noun+A3sg+Pnon+Nom
çekici	çekici+Adj
hayli	hayli+Adverb
neşe	neşe+Noun+A3sg+Pnon+Nom
zarafet	zarafet+Noun+A3sg+Pnon+Nom
imkan	imkan+Noun+A3sg+Pnon+Nom
örnek	örnek+Noun+A3sg+Pnon+Nom
herkes	herkes+Noun+A3sg+Pnon+Nom
gazete	gazete+Noun+A3sg+Pnon+Nom
gitgide	gitgide+Adverb
demin	demin+Adverb
kı	kı+Noun+A3sg+Pnon+Nom
yı	yı+Noun+A3sg+Pnon+Nom
is	is+Noun+A3sg+Pnon+Nom
te	te+Noun+A3sg+Pnon+Nom
lat	lat+Noun+A3sg+Pnon+Nom
nız	nız+Noun+A3sg+Pnon+Nom
sakın	sakın+Interj
aşık	aşık+Adj
dizüstü	dizüstü+Adj
zangır	zangır+Dup
lar	lar+Noun+A3sg+Pnon+Nom
ler	ler+Noun+A3sg+Pnon+Nom
olanca	olanca+Adj
dokuz	dokuz+Num+Card
yaprak	yaprak+Noun+A3sg+Pnon+Nom
ta	ta+Adverb
pı	pı+Noun+A3sg+Pnon+Nom
huşu	huşu+Noun+A3sg+Pnon+Nom
lı	lı+Noun+A3sg+Pnon+Nom
hangi	hangi+Adj
tahkir	tahkir+Noun+A3sg+Pnon+Nom
no	no+Noun+A3sg+Pnon+Nom
diri	diri+Adj
pa	pa+Noun+A3sg+Pnon+Nom
kor	kor+Noun+A3sg+Pnon+Nom
ku	ku+Noun+A3sg+Pnon+Nom
ye	ye+Verb+Pos+Imp+A2sg
ba	ba+Noun+A3sg+Pnon+Nom
hi	hi+Noun+A3sg+Pnon+Nom
be	be+Interj
miş	miş+Noun+A3sg+Pnon+Nom
ğıt	ğıt+Noun+A3sg+Pnon+Nom
paz	paz+Noun+A3sg+Pnon+Nom
papaz	papaz+Noun+A3sg+Pnon+Nom
ağız	ağız+Noun+A3sg+Pnon+Nom
dimdik	dimdik+Adj
le	le+Noun+A3sg+Pnon+Nom
ri	ri+Noun+A3sg+Pnon+Nom
nefes	nefes+Noun+A3sg+Pnon+Nom
u	u+Noun+A3sg+Pnon+Nom
zan	zan+Noun+A3sg+Pnon+Nom
ter	ter+Noun+A3sg+Pnon+Nom
ziz	ziz+Noun+A3sg+Pnon+Nom
joli	joli+Noun+A3sg+Pnon+Nom
re	re+Noun+A3sg+Pnon+Nom
şiş	şiş+Noun+A3sg+Pnon+Nom
ni	ni+Noun+A3sg+Pnon+Nom
yet	yet+Verb+Pos+Imp+A2sg
selam	selam+Noun+A3sg+Pnon+Nom
ağırlık	ağırlık+Noun+A3sg+Pnon+Nom
tiksinti	tiksinti+Noun+A3sg+Pnon+Nom
alev	alev+Noun+A3sg+Pnon+Nom
eğik	eğik+Adj
kapı	kapı+Noun+A3sg+Pnon+Nom
deli	deli+Adj
isim	isim+Noun+A3sg+Pnon+Nom
gittikçe	gittikçe+Adverb
ala	ala+Noun+A3sg+Pnon+Nom
müspet	müspet+Adj
belirsiz	belirsiz+Adj
haftalık	haftalık+Adj
herhalde	herhalde+Adverb
lüzum	lüzum+Noun+A3sg+Pnon+Nom
zamansız	zamansız+Adj
şahım	şahım+Noun+A3sg+Pnon+Nom
ahmak	ahmak+Adj
omuz	omuz+Noun+A3sg+Pnon+Nom
hanımefendi	hanımefendi+Noun+A3sg+Pnon+Nom
hanım	hanım+Noun+A3sg+Pnon+Nom
çeyrek	çeyrek+Noun+A3sg+Pnon+Nom
hitap	hitap+Noun+A3sg+Pnon+Nom
can	can+Noun+A3sg+Pnon+Nom
terbiyeli	terbiyeli+Adj
toy	toy+Noun+A3sg+Pnon+Nom
soğukkanlı	soğukkanlı+Adj
hak	hak+Noun+A3sg+Pnon+Nom
tasarı	tasarı+Noun+A3sg+Pnon+Nom
kabahat	kabahat+Noun+A3sg+Pnon+Nom
nail	nail+Adj
terbiye	terbiye+Noun+A3sg+Pnon+Nom
dudak	dudak+Noun+A3sg+Pnon+Nom
iftira	iftira+Noun+A3sg+Pnon+Nom
veya	veya+Conj
makine	makine+Noun+A3sg+Pnon+Nom
ilkin	ilkin+Adverb
unvan	unvan+Noun+A3sg+Pnon+Nom
devlet	devlet+Noun+A3sg+Pnon+Nom
dalgın	dalgın+Adj
nokta	nokta+Noun+A3sg+Pnon+Nom
mert	mert+Noun+A3sg+Pnon+Nom
altın	altın+Adj
sevgi	sevgi+Noun+A3sg+Pnon+Nom
cennet	cennet+Noun+A3sg+Pnon+Nom
rica	rica+Noun+A3sg+Pnon+Nom
kişisel	kişisel+Adj
güvercin	güvercin+Noun+A3sg+Pnon+Nom
sade	sade+Adj
menfaat	menfaat+Noun+A3sg+Pnon+Nom
hesaplı	hesaplı+Adj
belirli	belirli+Adj
samimi	samimi+Adj
şaşkın	şaşkın+Adj
kere	kere+Noun+A3sg+Pnon+Nom
cher	cher+Noun+A3sg+Pnon+Nom
kıt	kıt+Noun+A3sg+Pnon+Nom
mahsus	mahsus+Adj
temiz	temiz+Adj
keder	keder+Noun+A3sg+Pnon+Nom
boyun	boyun+Noun+A3sg+Pnon+Nom
deyim	deyim+Noun+A3sg+Pnon+Nom
bıçak	bıçak+Noun+A3sg+Pnon+Nom
boş	boş+Adj
hayır	hayır+Adverb
müzik	müzik+Noun+A3sg+Pnon+Nom
sosyete	sosyete+Noun+A3sg+Pnon+Nom
bitkin	bitkin+Adj
feda	feda+Noun+A3sg+Pnon+Nom
mavi	mavi+Adj
canavar	canavar+Noun+A3sg+Pnon+Nom
hain	hain+Noun+A3sg+Pnon+Nom
özellikle	özellikle+Adverb
mana	mana+Noun+A3sg+Pnon+Nom
uzak	uzak+Adj
engel	engel+Noun+A3sg+Pnon+Nom
meşhur	meşhur+Adj
şeref	şeref+Noun+A3sg+Pnon+Nom
mühim	mühim+Adj
ibaret	ibaret+Adj
tamamıyla	tamamıyla+Adverb
kör	kör+Adj
lazım	lazım+Adj
keşke	keşke+Adverb
mesela	mesela+Adverb
dua	dua+Noun+A3sg+Pnon+Nom
uzun	uzun+Adj
ömür	ömür+Noun+A3sg+Pnon+Nom
gündüz	gündüz+Noun+A3sg+Pnon+Nom
pamuk	pamuk+Noun+A3sg+Pnon+Nom
tuz	tuz+Noun+A3sg+Pnon+Nom
biber	biber+Noun+A3sg+Pnon+Nom
emanet	emanet+Noun+A3sg+Pnon+Nom
sabır	sabır+Noun+A3sg+Pnon+Nom
metanet	metanet+Noun+A3sg+Pnon+Nom
metin	metin+Noun+A3sg+Pnon+Nom
zafer	zafer+Noun+A3sg+Pnon+Nom
pis	pis+Adj
keskin	keskin+Adj
felaket	felaket+Noun+A3sg+Pnon+Nom
başlıca	başlıca+Adj
tehlike	tehlike+Noun+A3sg+Pnon+Nom
rahat	rahat+Adj
hazır	hazır+Adj
tutam	tutam+Noun+A3sg+Pnon+Nom
koku	koku+Noun+A3sg+Pnon+Nom
vaad	vaad+Noun+A3sg+Pnon+Nom
önsezi	önsezi+Noun+A3sg+Pnon+Nom
vız	vız+Noun+A3sg+Pnon+Nom
köy	köy+Noun+A3sg+Pnon+Nom
öbür	öbür+Adj
ertesi	ertesi+Adj
il	il+Noun+A3sg+Pnon+Nom
romantik	romantik+Adj
macera	macera+Noun+A3sg+Pnon+Nom
sarhoş	sarhoş+Noun+A3sg+Pnon+Nom
kıyamet	kıyamet+Noun+A3sg+Pnon+Nom
gürültü	gürültü+Noun+A3sg+Pnon+Nom
patırtı	patırtı+Noun+A3sg+Pnon+Nom
hele	hele+Adverb
muhit	muhit+Noun+A3sg+Pnon+Nom
du	du+Noun+A3sg+Pnon+Nom
mat	mat+Noun+A3sg+Pnon+Nom
hiçbiri	hiçbiri+Pron+Quant+A3sg+P3sg+Nom
davet	davet+Noun+A3sg+Pnon+Nom
aile	aile+Noun+A3sg+Pnon+Nom
güç	güç+Noun+A3sg+Pnon+Nom
arabacı	arabacı+Noun+A3sg+Pnon+Nom
ahşap	ahşap+Adj
ıhlamur	ıhlamur+Noun+A3sg+Pnon+Nom
çevrili	çevrili+Adj
kasırga	kasırga+Noun+A3sg+Pnon+Nom
tembel	tembel+Noun+A3sg+Pnon+Nom
beyin	beyin+Noun+A3sg+Pnon+Nom
telaş	telaş+Noun+A3sg+Pnon+Nom
sayın	sayın+Adj
saç	saç+Noun+A3sg+Pnon+Nom
icat	icat+Noun+A3sg+Pnon+Nom
kıvırcık	kıvırcık+Noun+A3sg+Pnon+Nom
alışık	alışık+Adj
binbir	binbir+Adj
kol	kol+Noun+A3sg+Pnon+Nom
kocaman	kocaman+Adj
yük	yük+Noun+A3sg+Pnon+Nom
dev	dev+Adj
tüm	tüm+Det
manzara	manzara+Noun+A3sg+Pnon+Nom
yaban	yaban+Noun+A3sg+Pnon+Nom
varlık	varlık+Noun+A3sg+Pnon+Nom
yetişkin	yetişkin+Adj
efendi	efendi+Noun+A3sg+Pnon+Nom
karınca	karınca+Noun+A3sg+Pnon+Nom
sağır	sağır+Adj
sürekli	sürekli+Adverb
gereksinim	gereksinim+Noun+A3sg+Pnon+Nom
karabasan	karabasan+Noun+A3sg+Pnon+Nom
kabus	kabus+Noun+A3sg+Pnon+Nom
çanta	çanta+Noun+A3sg+Pnon+Nom
bavul	bavul+Noun+A3sg+Pnon+Nom
tıknaz	tıknaz+Adj
üst	üst+Adj
curcuna	curcuna+Noun+A3sg+Pnon+Nom
terk	terk+Noun+A3sg+Pnon+Nom
bagaj	bagaj+Noun+A3sg+Pnon+Nom
koca	koca+Noun+A3sg+Pnon+Nom
şehir	şehir+Noun+A3sg+Pnon+Nom
araba	araba+Noun+A3sg+Pnon+Nom
güneş	güneş+Noun+A3sg+Pnon+Nom
akıl	akıl+Noun+A3sg+Pnon+Nom
düşmancıl	düşmancıl+Noun+A3sg+Pnon+Nom
yat	yat+Verb+Pos+Imp+A2sg
diken	diken+Noun+A3sg+Pnon+Nom
seyirci	seyirci+Noun+A3sg+Pnon+Nom
bindi	bindi+Noun+A3sg+Pnon+Nom
çarçabuk	çarçabuk+Adverb
bahçe	bahçe+Noun+A3sg+Pnon+Nom
kestane	kestane+Noun+A3sg+Pnon+Nom
sık	sık+Adj
yemyeşil	yemyeşil+Adj
meşe	meşe+Noun+A3sg+Pnon+Nom
taptaze	taptaze+Adj
tezat	tezat+Noun+A3sg+Pnon+Nom
sarımtırak	sarımtırak+Adj
sipsivri	sipsivri+Adj
çakmak	çakmak+Noun+A3sg+Pnon+Nom
çoban	çoban+Noun+A3sg+Pnon+Nom
gerek	gerek+Noun+A3sg+Pnon+Nom
ölümcül	ölümcül+Adj
zar	zar+Noun+A3sg+Pnon+Nom
çaba	çaba+Noun+A3sg+Pnon+Nom
kıç	kıç+Noun+A3sg+Pnon+Nom
dişi	dişi+Noun+A3sg+Pnon+Nom
içgüdü	içgüdü+Noun+A3sg+Pnon+Nom
koş	koş+Verb+Pos+Imp+A2sg
babacığım	babacığım+Noun+A3sg+Pnon+Nom
erken	erken+Adverb
bembeyaz	bembeyaz+Adj
fırsat	fırsat+Noun+A3sg+Pnon+Nom
sefer	sefer+Noun+A3sg+Pnon+Nom
boşuna	boşuna+Adverb
adamakıllı	adamakıllı+Adj
vakit	vakit+Noun+A3sg+Pnon+Nom
gölge	gölge+Noun+A3sg+Pnon+Nom
tazı	tazı+Noun+A3sg+Pnon+Nom
dümdüz	dümdüz+Adj
yumuşak	yumuşak+Adj
böylelikle	böylelikle+Adverb
vahşi	vahşi+Adj
çapulcu	çapulcu+Noun+A3sg+Pnon+Nom
içgüdüsel	içgüdüsel+Adj
kurt	kurt+Noun+A3sg+Pnon+Nom
sıkı	sıkı+Adj
geçmiş	geçmiş+Noun+A3sg+Pnon+Nom
korkak	korkak+Noun+A3sg+Pnon+Nom
hata	hata+Noun+A3sg+Pnon+Nom
ahbap	ahbap+Noun+A3sg+Pnon+Nom
olası	olası+Adj
yaradılış	yaradılış+Noun+A3sg+Pnon+Nom
yolculuk	yolculuk+Noun+A3sg+Pnon+Nom
çiftlik	çiftlik+Noun+A3sg+Pnon+Nom
girişken	girişken+Adj
öç	öç+Noun+A3sg+Pnon+Nom
olanak	olanak+Noun+A3sg+Pnon+Nom
zindan	zindan+Noun+A3sg+Pnon+Nom
binlerce	binlerce+Num+Card
kan	kan+Noun+A3sg+Pnon+Nom
diş	diş+Noun+A3sg+Pnon+Nom
sinir	sinir+Noun+A3sg+Pnon+Nom
inatçı	inatçı+Adj
siper	siper+Noun+A3sg+Pnon+Nom
bezgin	bezgin+Adj
arka	arka+Adj
çoğu	çoğu+Det
adet	adet+Noun+A3sg+Pnon+Nom
karmakarışık	karmakarışık+Adj
basit	basit+Adj
ek	ek+Adj
yine	yine+Adverb
bilgi	bilgi+Noun+A3sg+Pnon+Nom
alaka	alaka+Noun+A3sg+Pnon+Nom
kimi	kimi+Det
mini	mini+Adj
denli	denli+Adverb
zalim	zalim+Adj
acımasız	acımasız+Adj
şamar	şamar+Noun+A3sg+Pnon+Nom
falan	falan+Noun+A3sg+Pnon+Nom
dürüst	dürüst+Adj
yargıç	yargıç+Noun+A3sg+Pnon+Nom
mırıltı	mırıltı+Noun+A3sg+Pnon+Nom
ikna	ikna+Noun+A3sg+Pnon+Nom
güven	güven+Noun+A3sg+Pnon+Nom
hizmetçi	hizmetçi+Noun+A3sg+Pnon+Nom
ayırt	ayırt+Adj
taraf	taraf+Noun+A3sg+Pnon+Nom
antlaşma	antlaşma+Noun+A3sg+Pnon+Nom
barış	barış+Noun+A3sg+Pnon+Nom
bulaşık	bulaşık+Noun+A3sg+Pnon+Nom
arazi	arazi+Noun+A3sg+Pnon+Nom
sınırsız	sınırsız+Adj
ortak	ortak+Adj
kanun	kanun+Noun+A3sg+Pnon+Nom
kural	kural+Noun+A3sg+Pnon+Nom
gözlem	gözlem+Noun+A3sg+Pnon+Nom
faktör	faktör+Noun+A3sg+Pnon+Nom
hafif	hafif+Adj
sözlü	sözlü+Noun+A3sg+Pnon+Nom
yanlış	yanlış+Noun+A3sg+Pnon+Nom
pusula	pusula+Noun+A3sg+Pnon+Nom
evcil	evcil+Adj
zayıf	zayıf+Adj
av	av+Noun+A3sg+Pnon+Nom
erkenden	erkenden+Adverb
aylak	aylak+Adj
burun	burun+Noun+A3sg+Pnon+Nom
iştah	iştah+Noun+A3sg+Pnon+Nom
hamle	hamle+Noun+A3sg+Pnon+Nom
pençe	pençe+Noun+A3sg+Pnon+Nom
leziz	leziz+Adj
ahır	ahır+Noun+A3sg+Pnon+Nom
tavuk	tavuk+Noun+A3sg+Pnon+Nom
silah	silah+Noun+A3sg+Pnon+Nom
incecik	incecik+Adj
kırbaç	kırbaç+Noun+A3sg+Pnon+Nom
sopa	sopa+Noun+A3sg+Pnon+Nom
feryat	feryat+Noun+A3sg+Pnon+Nom
seyis	seyis+Noun+A3sg+Pnon+Nom
müdahale	müdahale+Noun+A3sg+Pnon+Nom
yabani	yabani+Adj
ceza	ceza+Noun+A3sg+Pnon+Nom
odun	odun+Noun+A3sg+Pnon+Nom
eser	eser+Noun+A3sg+Pnon+Nom
ders	ders+Noun+A3sg+Pnon+Nom
anlık	anlık+Noun+A3sg+Pnon+Nom
durgun	durgun+Adj
düşünce	düşünce+Noun+A3sg+Pnon+Nom
yalın	yalın+Adj
karşın	karşın+Postp+PCDat
zevk	zevk+Noun+A3sg+Pnon+Nom
hüzün	hüzün+Noun+A3sg+Pnon+Nom
bucak	bucak+Noun+A3sg+Pnon+Nom
koskoca	koskoca+Adj
başıboş	başıboş+Adj
hergün	hergün+Noun+A3sg+Pnon+Nom
tefek	tefek+Dup
sol	sol+Adj
oynak	oynak+Adj
sağ	sağ+Noun+A3sg+Pnon+Nom
baston	baston+Noun+A3sg+Pnon+Nom
bağ	bağ+Noun+A3sg+Pnon+Nom
üzüntü	üzüntü+Noun+A3sg+Pnon+Nom
böylesine	böylesine+Adverb
kat	kat+Noun+A3sg+Pnon+Nom
tamir	tamir+Noun+A3sg+Pnon+Nom
kül	kül+Noun+A3sg+Pnon+Nom
yaz	yaz+Noun+A3sg+Pnon+Nom
mimar	mimar+Noun+A3sg+Pnon+Nom
restore	restore+Adj
kagir	kagir+Adj
bina	bina+Noun+A3sg+Pnon+Nom
taş	taş+Noun+A3sg+Pnon+Nom
iri	iri+Adj
boya	boya+Noun+A3sg+Pnon+Nom
limon	limon+Noun+A3sg+Pnon+Nom
acıklı	acıklı+Adj
ruhsal	ruhsal+Adj
eksik	eksik+Adj
tedirgin	tedirgin+Adj
örümcek	örümcek+Noun+A3sg+Pnon+Nom
küçücük	küçücük+Adj
dahi	dahi+Conj
kadıncağız	kadıncağız+Noun+A3sg+Pnon+Nom
saygın	saygın+Adj
öylesine	öylesine+Adverb
kibar	kibar+Adj
giysi	giysi+Noun+A3sg+Pnon+Nom
ağırbaşlı	ağırbaşlı+Adj
düzgün	düzgün+Adj
belil	belil+Noun+A3sg+Pnon+Nom
bur	bur+Verb+Pos+Imp+A2sg
sıcakkanlı	sıcakkanlı+Adj
şaşmaz	şaşmaz+Adj
ıssız	ıssız+Adj
köhne	köhne+Adj
kalma	kalma+Adj
veyahut	veyahut+Conj
meşgul	meşgul+Adj
bıyık	bıyık+Noun+A3sg+Pnon+Nom
tebessüm	tebessüm+Noun+A3sg+Pnon+Nom
ilahi	ilahi+Adj
kır	kır+Noun+A3sg+Pnon+Nom
tutku	tutku+Noun+A3sg+Pnon+Nom
apansız	apansız+Adverb
geçer	geçer+Adj
büyü	büyü+Noun+A3sg+Pnon+Nom
paralel	paralel+Adj
genellikle	genellikle+Adverb
kader	kader+Noun+A3sg+Pnon+Nom
serüven	serüven+Noun+A3sg+Pnon+Nom
bulanık	bulanık+Adj
atkı	atkı+Noun+A3sg+Pnon+Nom
ister	ister+Conj
kuş	kuş+Noun+A3sg+Pnon+Nom
acaba	acaba+Adverb
hıçkırık	hıçkırık+Noun+A3sg+Pnon+Nom
ansızın	ansızın+Adverb
ihtimal	ihtimal+Noun+A3sg+Pnon+Nom
düpedüz	düpedüz+Adverb
yürek	yürek+Noun+A3sg+Pnon+Nom
genelde	genelde+Adverb
benzeri	benzeri+Adj
züppe	züppe+Adj
telaffuz	telaffuz+Noun+A3sg+Pnon+Nom
seçkin	seçkin+Adj
kanal	kanal+Noun+A3sg+Pnon+Nom
tereddüt	tereddüt+Noun+A3sg+Pnon+Nom
yaya	yaya+Noun+A3sg+Pnon+Nom
frak	frak+Noun+A3sg+Pnon+Nom
panik	panik+Noun+A3sg+Pnon+Nom
epeyce	epeyce+Adverb
minnet	minnet+Noun+A3sg+Pnon+Nom
kaygı	kaygı+Noun+A3sg+Pnon+Nom
ilişkin	ilişkin+Postp+PCDat
kaçamak	kaçamak+Noun+A3sg+Pnon+Nom
bayan	bayan+Noun+A3sg+Pnon+Nom
zeki	zeki+Adj
böylece	böylece+Adverb
sıkılgan	sıkılgan+Adj
çekingen	çekingen+Adj
düş	düş+Noun+A3sg+Pnon+Nom
narin	narin+Adj
ulu	ulu+Adj
beyefendi	beyefendi+Noun+A3sg+Pnon+Nom
lütuf	lütuf+Noun+A3sg+Pnon+Nom
boşa	boşa+Verb+Pos+Imp+A2sg
arzu	arzu+Noun+A3sg+Pnon+Nom
günü	günü+Noun+A3sg+Pnon+Nom
kaç	kaç+Adj
tümüyle	tümüyle+Adverb
tasavvur	tasavvur+Noun+A3sg+Pnon+Nom
yapayalnız	yapayalnız+Adj
tavır	tavır+Noun+A3sg+Pnon+Nom
kızkardeş	kızkardeş+Noun+A3sg+Pnon+Nom
çift	çift+Adj
bela	bela+Noun+A3sg+Pnon+Nom
yalvar	yalvar+Verb+Pos+Imp+A2sg
kaçık	kaçık+Adj
tamam	tamam+Noun+A3sg+Pnon+Nom
girgin	girgin+Adj
yardımcı	yardımcı+Noun+A3sg+Pnon+Nom
peşin	peşin+Adj
nimet	nimet+Noun+A3sg+Pnon+Nom
anı	anı+Noun+A3sg+Pnon+Nom
uygunsuz	uygunsuz+Adj
randevu	randevu+Noun+A3sg+Pnon+Nom
peşinen	peşinen+Adverb
kesinkes	kesinkes+Noun+A3sg+Pnon+Nom
net	net+Noun+A3sg+Pnon+Nom
tamamiyle	tamamiyle+Adverb
apaçık	apaçık+Adj
arkadaş	arkadaş+Noun+A3sg+Pnon+Nom
barut	barut+Noun+A3sg+Pnon+Nom
ateş	ateş+Noun+A3sg+Pnon+Nom
şükür	şükür+Noun+A3sg+Pnon+Nom
mücadele	mücadele+Noun+A3sg+Pnon+Nom
pırıltı	pırıltı+Noun+A3sg+Pnon+Nom
gevrek	gevrek+Adj
büyükanne	büyükanne+Noun+A3sg+Pnon+Nom
sokak	sokak+Noun+A3sg+Pnon+Nom
yuvarlak	yuvarlak+Adj
peksimet	peksimet+Noun+A3sg+Pnon+Nom
çinko	çinko+Adj
bol	bol+Adj
müddet	müddet+Noun+A3sg+Pnon+Nom
büyükbaba	büyükbaba+Noun+A3sg+Pnon+Nom
yırtık	yırtık+Adj
güçlük	güçlük+Noun+A3sg+Pnon+Nom
gömlek	gömlek+Noun+A3sg+Pnon+Nom
gri	gri+Noun+A3sg+Pnon+Nom
nihayet	nihayet+Adverb
mızmız	mızmız+Adj
haşarı	haşarı+Adj
muhalefet	muhalefet+Noun+A3sg+Pnon+Nom
müstehcen	müstehcen+Adj
alaycı	alaycı+Noun+A3sg+Pnon+Nom
dinç	dinç+Adj
santim	santim+Noun+A3sg+Pnon+Nom
harp	harp+Noun+A3sg+Pnon+Nom
yarış	yarış+Noun+A3sg+Pnon+Nom
baba	baba+Noun+A3sg+Pnon+Nom
anlam	anlam+Noun+A3sg+Pnon+Nom
normal	normal+Adj
tatmin	tatmin+Noun+A3sg+Pnon+Nom
ayrı	ayrı+Adj
birşey	birşey+Noun+A3sg+Pnon+Nom
ciyak	ciyak+Dup
ebe	ebe+Noun+A3sg+Pnon+Nom
ayrık	ayrık+Noun+A3sg+Pnon+Nom
okur	okur+Noun+A3sg+Pnon+Nom
hesap	hesap+Noun+A3sg+Pnon+Nom
muhtaç	muhtaç+Noun+A3sg+Pnon+Nom
hırsız	hırsız+Noun+A3sg+Pnon+Nom
sinsi	sinsi+Adj
herif	herif+Noun+A3sg+Pnon+Nom
sağol	sağol+Verb+Pos+Imp+A2sg
boğa	boğa+Noun+A3sg+Pnon+Nom
aç	aç+Noun+A3sg+Pnon+Nom
hınzır	hınzır+Noun+A3sg+Pnon+Nom
muzip	muzip+Adj
salça	salça+Noun+A3sg+Pnon+Nom
tabak	tabak+Noun+A3sg+Pnon+Nom
al	al+Verb+Pos+Imp+A2sg
otur	otur+Verb+Pos+Imp+A2sg
daikka	daikka+Noun+A3sg+Pnon+Nom
bul	bul+Verb+Pos+Imp+A2sg
vaz	vaz+Noun+A3sg+Pnon+Nom
gidi	gidi+Noun+A3sg+Pnon+Nom
günahkar	günahkar+Adj
keçi	keçi+Noun+A3sg+Pnon+Nom
ziyade	ziyade+Adj
yiyecek	yiyecek+Noun+A3sg+Pnon+Nom
giyecek	giyecek+Noun+A3sg+Pnon+Nom
sabahleyin	sabahleyin+Adverb
öğle	öğle+Noun+A3sg+Pnon+Nom
kuru	kuru+Adj
akşamleyin	akşamleyin+Adverb
herşey	herşey+Noun+A3sg+Pnon+Nom
mevcut	mevcut+Noun+A3sg+Pnon+Nom
eşya	eşya+Noun+A3sg+Pnon+Nom
tahta	tahta+Adj
pervane	pervane+Noun+A3sg+Pnon+Nom
teke	teke+Noun+A3sg+Pnon+Nom
iken	iken+Adverb
açıkhava	açıkhava+Noun+A3sg+Pnon+Nom
kabaca	kabaca+Adverb
serseri	serseri+Noun+A3sg+Pnon+Nom
üzüm	üzüm+Noun+A3sg+Pnon+Nom
koskocaman	koskocaman+Adj
sepet	sepet+Noun+A3sg+Pnon+Nom
aksi	aksi+Adj
gebe	gebe+Adj
bebek	bebek+Noun+A3sg+Pnon+Nom
mil	mil+Noun+A3sg+Pnon+Nom
yetmiş	yetmiş+Num+Card
yedek	yedek+Adj
lastik	lastik+Noun+A3sg+Pnon+Nom
karanlık	karanlık+Adj
kamyon	kamyon+Noun+A3sg+Pnon+Nom
yağ	yağ+Noun+A3sg+Pnon+Nom
tel	tel+Noun+A3sg+Pnon+Nom
toz	toz+Noun+A3sg+Pnon+Nom
tetkik	tetkik+Noun+A3sg+Pnon+Nom
kasket	kasket+Noun+A3sg+Pnon+Nom
elbise	elbise+Noun+A3sg+Pnon+Nom
tasdik	tasdik+Noun+A3sg+Pnon+Nom
fena	fena+Adj
horoz	horoz+Noun+A3sg+Pnon+Nom
kabara	kabara+Noun+A3sg+Pnon+Nom
külhanbeyi	külhanbeyi+Noun+A3sg+P3sg+Nom
kısık	kısık+Adj
hapishane	hapishane+Noun+A3sg+Pnon+Nom
sırık	sırık+Noun+A3sg+Pnon+Nom
otomobil	otomobil+Noun+A3sg+Pnon+Nom
sat	sat+Verb+Pos+Imp+A2sg
rastgele	rastgele+Adj
gelecek	gelecek+Adj
tın	tın+Noun+A3sg+Pnon+Nom
tohum	tohum+Noun+A3sg+Pnon+Nom
birçok	birçok+Det
yığılı	yığılı+Adj
sent	sent+Noun+A3sg+Pnon+Nom
ver	ver+Verb+Pos+Imp+A2sg
doru	doru+Noun+A3sg+Pnon+Nom
kişniyerek	kişniyerek+Noun+A3sg+Pnon+Nom
ata	ata+Noun+A3sg+Pnon+Nom
sekiz	sekiz+Num+Card
tay	tay+Noun+A3sg+Pnon+Nom
bayram	bayram+Noun+A3sg+Pnon+Nom
kurdela	kurdela+Noun+A3sg+Pnon+Nom
prim	prim+Noun+A3sg+Pnon+Nom
içki	içki+Noun+A3sg+Pnon+Nom
meyva	meyva+Noun+A3sg+Pnon+Nom
toprak	toprak+Noun+A3sg+Pnon+Nom
kızıl	kızıl+Adj
sel	sel+Noun+A3sg+Pnon+Nom
yıkık	yıkık+Adj
ızdırap	ızdırap+Noun+A3sg+Pnon+Nom
terör	terör+Noun+A3sg+Pnon+Nom
köşe	köşe+Noun+A3sg+Pnon+Nom
vazo	vazo+Noun+A3sg+Pnon+Nom
tencere	tencere+Noun+A3sg+Pnon+Nom
lamba	lamba+Noun+A3sg+Pnon+Nom
kanaviçe	kanaviçe+Noun+A3sg+Pnon+Nom
çadır	çadır+Noun+A3sg+Pnon+Nom
gaz	gaz+Noun+A3sg+Pnon+Nom
çırılçıplak	çırılçıplak+Adj
kürek	kürek+Noun+A3sg+Pnon+Nom
testere	testere+Noun+A3sg+Pnon+Nom
mengene	mengene+Noun+A3sg+Pnon+Nom
kıskaç	kıskaç+Noun+A3sg+Pnon+Nom
balta	balta+Noun+A3sg+Pnon+Nom
kırk	kırk+Num+Card
püskü	püskü+Adj
kitap	kitap+Noun+A3sg+Pnon+Nom
zifir	zifir+Noun+A3sg+Pnon+Nom
resim	resim+Noun+A3sg+Pnon+Nom
melek	melek+Noun+A3sg+Pnon+Nom
evvel	evvel+Noun+A3sg+Pnon+Nom
porselen	porselen+Adj
mektup	mektup+Noun+A3sg+Pnon+Nom
söğüt	söğüt+Noun+A3sg+Pnon+Nom
ortalık	ortalık+Noun+A3sg+Pnon+Nom
kalk	kalk+Verb+Pos+Imp+A2sg
kırık	kırık+Adj
yuva	yuva+Noun+A3sg+Pnon+Nom
saçak	saçak+Noun+A3sg+Pnon+Nom
domuz	domuz+Noun+A3sg+Pnon+Nom
sabun	sabun+Noun+A3sg+Pnon+Nom
şeftali	şeftali+Adj
yasak	yasak+Noun+A3sg+Pnon+Nom
çürük	çürük+Adj
çık	çık+Verb+Pos+Imp+A2sg
kötümser	kötümser+Adj
yazar	yazar+Noun+A3sg+Pnon+Nom
uyku	uyku+Noun+A3sg+Pnon+Nom
harita	harita+Noun+A3sg+Pnon+Nom
kartpostal	kartpostal+Noun+A3sg+Pnon+Nom
yap	yap+Verb+Pos+Imp+A2sg
muhakkak	muhakkak+Adverb
ilan	ilan+Noun+A3sg+Pnon+Nom
gündüzleri	gündüzleri+Adverb
yatak	yatak+Noun+A3sg+Pnon+Nom
tüy	tüy+Noun+A3sg+Pnon+Nom
zorla	zorla+Verb+Pos+Imp+A2sg
ıslak	ıslak+Adj
alaylı	alaylı+Noun+A3sg+Pnon+Nom
şeytani	şeytani+Adj
çamaşır	çamaşır+Noun+A3sg+Pnon+Nom
değişmez	değişmez+Adj
sandık	sandık+Noun+A3sg+Pnon+Nom
kerata	kerata+Noun+A3sg+Pnon+Nom
hergele	hergele+Noun+A3sg+Pnon+Nom
ocak	ocak+Noun+A3sg+Pnon+Nom
pipo	pipo+Noun+A3sg+Pnon+Nom
nişan	nişan+Noun+A3sg+Pnon+Nom
alışkın	alışkın+Adj
teşekkür	teşekkür+Noun+A3sg+Pnon+Nom
bay	bay+Noun+A3sg+Pnon+Nom
cumartesi	cumartesi+Noun+A3sg+Pnon+Nom
rom	rom+Noun+A3sg+Pnon+Nom
kilise	kilise+Noun+A3sg+Pnon+Nom
gezinti	gezinti+Noun+A3sg+Pnon+Nom
mendil	mendil+Noun+A3sg+Pnon+Nom
saçı	saçı+Noun+A3sg+Pnon+Nom
kurnaz	kurnaz+Adj
çingene	çingene+Noun+A3sg+Pnon+Nom
kaçak	kaçak+Noun+A3sg+Pnon+Nom
gözcü	gözcü+Noun+A3sg+Pnon+Nom
muamele	muamele+Noun+A3sg+Pnon+Nom
baskı	baskı+Noun+A3sg+Pnon+Nom
gösteri	gösteri+Noun+A3sg+Pnon+Nom
direkt	direkt+Adverb
kaşık	kaşık+Noun+A3sg+Pnon+Nom
eğe	eğe+Noun+A3sg+Pnon+Nom
yarım	yarım+Adj
şilin	şilin+Noun+A3sg+Pnon+Nom
avuç	avuç+Noun+A3sg+Pnon+Nom
bozuk	bozuk+Adj
aval	aval+Noun+A3sg+Pnon+Nom
sımsıkı	sımsıkı+Adj
gayret	gayret+Noun+A3sg+Pnon+Nom
muzaffer	muzaffer+Noun+A3sg+Pnon+Nom
banknot	banknot+Noun+A3sg+Pnon+Nom
sığır	sığır+Noun+A3sg+Pnon+Nom
anlaşma	anlaşma+Noun+A3sg+Pnon+Nom
çarşamba	çarşamba+Noun+A3sg+Pnon+Nom
mütereddit	mütereddit+Adj
kare	kare+Noun+A3sg+Pnon+Nom
bira	bira+Noun+A3sg+Pnon+Nom
duvar	duvar+Noun+A3sg+Pnon+Nom
loş	loş+Adj
kasıt	kasıt+Noun+A3sg+Pnon+Nom
lahana	lahana+Noun+A3sg+Pnon+Nom
dal	dal+Noun+A3sg+Pnon+Nom
şimşir	şimşir+Noun+A3sg+Pnon+Nom
pencere	pencere+Noun+A3sg+Pnon+Nom
ağaç	ağaç+Noun+A3sg+Pnon+Nom
kar	kar+Noun+A3sg+Pnon+Nom
kaskatı	kaskatı+Adj
bey	bey+Noun+A3sg+Pnon+Nom
dalkavuk	dalkavuk+Noun+A3sg+Pnon+Nom
konuşkan	konuşkan+Adj
düşman	düşman+Noun+A3sg+Pnon+Nom
özellik	özellik+Noun+A3sg+Pnon+Nom
doğal	doğal+Adj
ciddiyet	ciddiyet+Noun+A3sg+Pnon+Nom
yas	yas+Noun+A3sg+Pnon+Nom
yordam	yordam+Noun+A3sg+Pnon+Nom
laf	laf+Noun+A3sg+Pnon+Nom
alt	alt+Adj
huzur	huzur+Noun+A3sg+Pnon+Nom
zil	zil+Noun+A3sg+Pnon+Nom
tokat	tokat+Noun+A3sg+Pnon+Nom
kıyım	kıyım+Noun+A3sg+Pnon+Nom
mum	mum+Noun+A3sg+Pnon+Nom
sakal	sakal+Noun+A3sg+Pnon+Nom
ol	ol+Verb+Pos+Imp+A2sg
kafa	kafa+Noun+A3sg+Pnon+Nom
tuvalet	tuvalet+Noun+A3sg+Pnon+Nom
dur	dur+Verb+Pos+Imp+A2sg
mezar	mezar+Noun+A3sg+Pnon+Nom
işaret	işaret+Noun+A3sg+Pnon+Nom
tarz	tarz+Noun+A3sg+Pnon+Nom
duman	duman+Noun+A3sg+Pnon+Nom
şık	şık+Adj
oda	oda+Noun+A3sg+Pnon+Nom
küf	küf+Noun+A3sg+Pnon+Nom
lime	lime+Noun+A3sg+Pnon+Nom
obje	obje+Noun+A3sg+Pnon+Nom
ziyafet	ziyafet+Noun+A3sg+Pnon+Nom
masa	masa+Noun+A3sg+Pnon+Nom
süs	süs+Noun+A3sg+Pnon+Nom
kopuk	kopuk+Adj
pasta	pasta+Noun+A3sg+Pnon+Nom
düğün	düğün+Noun+A3sg+Pnon+Nom
hadi	hadi+Interj
at	at+Noun+A3sg+Pnon+Nom
taklit	taklit+Noun+A3sg+Pnon+Nom
kesik	kesik+Adj
çağır	çağır+Verb+Pos+Imp+A2sg
kupkuru	kupkuru+Adj
ayıp	ayıp+Noun+A3sg+Pnon+Nom
mesele	mesele+Noun+A3sg+Pnon+Nom
şahit	şahit+Noun+A3sg+Pnon+Nom
geceleyin	geceleyin+Adverb
zencefil	zencefil+Noun+A3sg+Pnon+Nom
amonyum	amonyum+Noun+A3sg+Pnon+Nom
sindirim	sindirim+Noun+A3sg+Pnon+Nom
sağlam	sağlam+Adj
sevecen	sevecen+Adj
ceviz	ceviz+Noun+A3sg+Pnon+Nom
esmer	esmer+Noun+A3sg+Pnon+Nom
sebep	sebep+Noun+A3sg+Pnon+Nom
asabi	asabi+Adj
piyano	piyano+Noun+A3sg+Pnon+Nom
inat	inat+Noun+A3sg+Pnon+Nom
öpücük	öpücük+Noun+A3sg+Pnon+Nom
mazur	mazur+Noun+A3sg+Pnon+Nom
saniye	saniye+Noun+A3sg+Pnon+Nom
doğum	doğum+Noun+A3sg+Pnon+Nom
nice	nice+Adverb
müsaade	müsaade+Noun+A3sg+Pnon+Nom
teşebbüs	teşebbüs+Noun+A3sg+Pnon+Nom
yığın	yığın+Noun+A3sg+Pnon+Nom
musallat	musallat+Adj
fare	fare+Noun+A3sg+Pnon+Nom
sapsarı	sapsarı+Adj
yoğun	yoğun+Adj
aniden	aniden+Adverb
kağıt	kağıt+Noun+A3sg+Pnon+Nom
tenezzül	tenezzül+Noun+A3sg+Pnon+Nom
düzine	düzine+Noun+A3sg+Pnon+Nom
salatalık	salatalık+Noun+A3sg+Pnon+Nom
muvaffak	muvaffak+Adj
yamru	yamru+Dup
yumru	yumru+Noun+A3sg+Pnon+Nom
emin	emin+Adj
pat	pat+Noun+A3sg+Pnon+Nom
etmen	etmen+Noun+A3sg+Pnon+Nom
özgü	özgü+Adj
değişik	değişik+Adj
ahlak	ahlak+Noun+A3sg+Pnon+Nom
sirke	sirke+Noun+A3sg+Pnon+Nom
sünger	sünger+Noun+A3sg+Pnon+Nom
mekanik	mekanik+Noun+A3sg+Pnon+Nom
sırtüstü	sırtüstü+Adj
bariz	bariz+Adj
maharet	maharet+Noun+A3sg+Pnon+Nom
sürpriz	sürpriz+Noun+A3sg+Pnon+Nom
yara	yara+Noun+A3sg+Pnon+Nom
bere	bere+Noun+A3sg+Pnon+Nom
beter	beter+Adj
masum	masum+Adj
kum	kum+Noun+A3sg+Pnon+Nom
had	had+Noun+A3sg+Pnon+Nom
tabanca	tabanca+Noun+A3sg+Pnon+Nom
intikam	intikam+Noun+A3sg+Pnon+Nom
kolaçan	kolaçan+Noun+A3sg+Pnon+Nom
kapalı	kapalı+Adj
iz	iz+Noun+A3sg+Pnon+Nom
birazdan	birazdan+Adverb
çırak	çırak+Noun+A3sg+Pnon+Nom
cahil	cahil+Adj
hoşgörü	hoşgörü+Noun+A3sg+Pnon+Nom
abartı	abartı+Noun+A3sg+Pnon+Nom
nevi	nevi+Noun+A3sg+Pnon+Nom
demir	demir+Noun+A3sg+Pnon+Nom
itiraf	itiraf+Noun+A3sg+Pnon+Nom
niye	niye+Adverb
gerçi	gerçi+Adverb
dingil	dingil+Noun+A3sg+Pnon+Nom
kaldır	kaldır+Verb+Pos+Imp+A2sg
kaynak	kaynak+Noun+A3sg+Pnon+Nom
ün	ün+Noun+A3sg+Pnon+Nom
kilometre	kilometre+Noun+A3sg+Pnon+Nom
akar	akar+Noun+A3sg+Pnon+Nom
çelik	çelik+Noun+A3sg+Pnon+Nom
genel	genel+Adj
sarıklı	sarıklı+Adj
üstün	üstün+Adj
incelik	incelik+Noun+A3sg+Pnon+Nom
seyyah	seyyah+Noun+A3sg+Pnon+Nom
pitoresk	pitoresk+Adj
rekabet	rekabet+Noun+A3sg+Pnon+Nom
yılan	yılan+Noun+A3sg+Pnon+Nom
batı	batı+Adj
ibadet	ibadet+Noun+A3sg+Pnon+Nom
iman	iman+Noun+A3sg+Pnon+Nom
haremağası	haremağası+Noun+A3sg+P3sg+Nom
dağlık	dağlık+Adj
şarap	şarap+Noun+A3sg+Pnon+Nom
atak	atak+Noun+A3sg+Pnon+Nom
uyanık	uyanık+Adj
doktor	doktor+Noun+A3sg+Pnon+Nom
ebedi	ebedi+Adj
başarı	başarı+Noun+A3sg+Pnon+Nom
tarih	tarih+Noun+A3sg+Pnon+Nom
tütün	tütün+Noun+A3sg+Pnon+Nom
doğu	doğu+Noun+A3sg+Pnon+Nom
esir	esir+Noun+A3sg+Pnon+Nom
işgal	işgal+Noun+A3sg+Pnon+Nom
tercüman	tercüman+Noun+A3sg+Pnon+Nom
hadım	hadım+Noun+A3sg+Pnon+Nom
ak	ak+Adj
harem	harem+Noun+A3sg+Pnon+Nom
cılız	cılız+Adj
örtülü	örtülü+Adj
kocakarı	kocakarı+Noun+A3sg+Pnon+Nom
ötürü	ötürü+Postp+PCAbl
tehdit	tehdit+Noun+A3sg+Pnon+Nom
gönül	gönül+Noun+A3sg+Pnon+Nom
nasip	nasip+Noun+A3sg+Pnon+Nom
halk	halk+Noun+A3sg+Pnon+Nom
hamam	hamam+Noun+A3sg+Pnon+Nom
veba	veba+Noun+A3sg+Pnon+Nom
dilenci	dilenci+Noun+A3sg+Pnon+Nom
ölü	ölü+Noun+A3sg+Pnon+Nom
muayene	muayene+Noun+A3sg+Pnon+Nom
derinlemesine	derinlemesine+Adverb
hatıra	hatıra+Noun+A3sg+Pnon+Nom
armağan	armağan+Noun+A3sg+Pnon+Nom
kahraman	kahraman+Noun+A3sg+Pnon+Nom
ardınca	ardınca+Adverb
karantina	karantina+Noun+A3sg+Pnon+Nom
topluluk	topluluk+Noun+A3sg+Pnon+Nom
allak	allak+Adj
bullak	bullak+Adj
selamet	selamet+Noun+A3sg+Pnon+Nom
yazı	yazı+Noun+A3sg+Pnon+Nom
eleştiri	eleştiri+Noun+A3sg+Pnon+Nom
aşçı	aşçı+Noun+A3sg+Pnon+Nom
perhiz	perhiz+Noun+A3sg+Pnon+Nom
redaktör	redaktör+Noun+A3sg+Pnon+Nom
mezhep	mezhep+Noun+A3sg+Pnon+Nom
sapık	sapık+Adj
inanç	inanç+Noun+A3sg+Pnon+Nom
telakki	telakki+Noun+A3sg+Pnon+Nom
amansız	amansız+Adj
doktrin	doktrin+Noun+A3sg+Pnon+Nom
gelenek	gelenek+Noun+A3sg+Pnon+Nom
üstünkörü	üstünkörü+Adverb
gaddar	gaddar+Adj
olmuştutur	olmuştutur+Noun+A3sg+Pnon+Nom
ahenk	ahenk+Noun+A3sg+Pnon+Nom
ada	ada+Noun+A3sg+Pnon+Nom
şatt	şatt+Noun+A3sg+Pnon+Nom
ave	ave+Noun+A3sg+Pnon+Nom
misal	misal+Noun+A3sg+Pnon+Nom
nalet	nalet+Adj
nal	nal+Noun+A3sg+Pnon+Nom
nalbant	nalbant+Noun+A3sg+Pnon+Nom
sulker	sulker+Noun+A3sg+Pnon+Nom
ayakkabı	ayakkabı+Noun+A3sg+Pnon+Nom
şeytan	şeytan+Noun+A3sg+Pnon+Nom
dolayısıyla	dolayısıyla+Adverb
katı	katı+Adj
buçuk	buçuk+Adj
işçi	işçi+Noun+A3sg+Pnon+Nom
tanık	tanık+Noun+A3sg+Pnon+Nom
bulaşıkçı	bulaşıkçı+Noun+A3sg+Pnon+Nom
ikon	ikon+Noun+A3sg+Pnon+Nom
değin	değin+Postp+PCDat
dok	dok+Noun+A3sg+Pnon+Nom
devrimci	devrimci+Noun+A3sg+Pnon+Nom
kent	kent+Noun+A3sg+Pnon+Nom
burevestnike	burevestnike+Noun+A3sg+Pnon+Nom
ardından	ardından+Adverb
siyasal	siyasal+Adj
yayınevi	yayınevi+Noun+A3sg+P3sg+Nom
sürgün	sürgün+Noun+A3sg+Pnon+Nom
uğrak	uğrak+Noun+A3sg+Pnon+Nom
elit	elit+Noun+A3sg+Pnon+Nom
edebiyat	edebiyat+Noun+A3sg+Pnon+Nom
hizmet	hizmet+Noun+A3sg+Pnon+Nom
dinsel	dinsel+Adj
felsefi	felsefi+Adj
eğilim	eğilim+Noun+A3sg+Pnon+Nom
barışçı	barışçı+Noun+A3sg+Pnon+Nom
kültür	kültür+Noun+A3sg+Pnon+Nom
birçoğu	birçoğu+Pron+Quant+A3pl+P3pl+Nom
alegorik	alegorik+Adj
belgesel	belgesel+Adj
dergi	dergi+Noun+A3sg+Pnon+Nom
liman	liman+Noun+A3sg+Pnon+Nom
toplumsal	toplumsal+Adj
şest	şest+Noun+A3sg+Pnon+Nom
i	i+Noun+A3sg+Pnon+Nom
dönem	dönem+Noun+A3sg+Pnon+Nom
roman	roman+Noun+A3sg+Pnon+Nom
yapıt	yapıt+Noun+A3sg+Pnon+Nom
önem	önem+Noun+A3sg+Pnon+Nom
yönetici	yönetici+Noun+A3sg+Pnon+Nom
özgeçmiş	özgeçmiş+Noun+A3sg+Pnon+Nom
yaşam	yaşam+Noun+A3sg+Pnon+Nom
insancıl	insancıl+Adj
çocukluk	çocukluk+Noun+A3sg+Pnon+Nom
dökme	dökme+Noun+A3sg+Pnon+Nom
gözlemci	gözlemci+Noun+A3sg+Pnon+Nom
ön	ön+Adj
doğrudan	doğrudan+Adj
uğraş	uğraş+Noun+A3sg+Pnon+Nom
etkin	etkin+Adj
eleştirmen	eleştirmen+Noun+A3sg+Pnon+Nom
eleştirel	eleştirel+Adj
üslup	üslup+Noun+A3sg+Pnon+Nom
eşsiz	eşsiz+Adj
usta	usta+Noun+A3sg+Pnon+Nom
öykü	öykü+Noun+A3sg+Pnon+Nom
görüş	görüş+Noun+A3sg+Pnon+Nom
hakim	hakim+Noun+A3sg+Pnon+Nom
unsur	unsur+Noun+A3sg+Pnon+Nom
yapıcı	yapıcı+Adj
boğuk	boğuk+Adj
inilti	inilti+Noun+A3sg+Pnon+Nom
simsiyah	simsiyah+Adj
asık	asık+Adj
bekçi	bekçi+Noun+A3sg+Pnon+Nom
fabrika	fabrika+Noun+A3sg+Pnon+Nom
maden	maden+Noun+A3sg+Pnon+Nom
kapkara	kapkara+Adj
kas	kas+Noun+A3sg+Pnon+Nom
din	din+Noun+A3sg+Pnon+Nom
börek	börek+Noun+A3sg+Pnon+Nom
hava	hava+Noun+A3sg+Pnon+Nom
şemsiye	şemsiye+Noun+A3sg+Pnon+Nom
aciz	aciz+Adj
tekdüze	tekdüze+Adj
nadiren	nadiren+Adverb
kıvılcım	kıvılcım+Noun+A3sg+Pnon+Nom
tertip	tertip+Noun+A3sg+Pnon+Nom
armonik	armonik+Adj
çalar	çalar+Noun+A3sg+Pnon+Nom
sara	sara+Noun+A3sg+Pnon+Nom
miras	miras+Noun+A3sg+Pnon+Nom
olağan	olağan+Adj
dayak	dayak+Noun+A3sg+Pnon+Nom
akıntı	akıntı+Noun+A3sg+Pnon+Nom
nemrut	nemrut+Adj
öfke	öfke+Noun+A3sg+Pnon+Nom
yiğit	yiğit+Noun+A3sg+Pnon+Nom
pazar	pazar+Noun+A3sg+Pnon+Nom
akim	akim+Adj
sivri	sivri+Adj
ok	ok+Noun+A3sg+Pnon+Nom
maruz	maruz+Adj
sıfat	sıfat+Noun+A3sg+Pnon+Nom
polis	polis+Noun+A3sg+Pnon+Nom
çekiç	çekiç+Noun+A3sg+Pnon+Nom
metres	metres+Noun+A3sg+Pnon+Nom
ekmek	ekmek+Noun+A3sg+Pnon+Nom
votka	votka+Noun+A3sg+Pnon+Nom
ölüm	ölüm+Noun+A3sg+Pnon+Nom
gıcırtadarak	gıcırtadarak+Noun+A3sg+Pnon+Nom
aralıksız	aralıksız+Adj
birazcık	birazcık+Adverb
arsenik	arsenik+Noun+A3sg+Pnon+Nom
tavsiye	tavsiye+Noun+A3sg+Pnon+Nom
ameliyat	ameliyat+Noun+A3sg+Pnon+Nom
defol	defol+Verb+Pos+Imp+A2sg
karı	karı+Noun+A3sg+Pnon+Nom
çatık	çatık+Adj
haç	haç+Noun+A3sg+Pnon+Nom
sorhoş	sorhoş+Noun+A3sg+Pnon+Nom
havlu	havlu+Noun+A3sg+Pnon+Nom
tat	tat+Noun+A3sg+Pnon+Nom
içecek	içecek+Noun+A3sg+Pnon+Nom
eziyet	eziyet+Noun+A3sg+Pnon+Nom
demet	demet+Noun+A3sg+Pnon+Nom
pişman	pişman+Adj
buz	buz+Noun+A3sg+Pnon+Nom
aynen	aynen+Adverb
bölme	bölme+Noun+A3sg+Pnon+Nom
dörtgen	dörtgen+Noun+A3sg+Pnon+Nom
iskemle	iskemle+Noun+A3sg+Pnon+Nom
sandalye	sandalye+Noun+A3sg+Pnon+Nom
konsol	konsol+Noun+A3sg+Pnon+Nom
ayna	ayna+Noun+A3sg+Pnon+Nom
aziz	aziz+Adj
tablo	tablo+Noun+A3sg+Pnon+Nom
kadril	kadril+Noun+A3sg+Pnon+Nom
polka	polka+Noun+A3sg+Pnon+Nom
ağrı	ağrı+Noun+A3sg+Pnon+Nom
gücenik	gücenik+Adj
makina	makina+Noun+A3sg+Pnon+Nom
tüfek	tüfek+Noun+A3sg+Pnon+Nom
hoşnut	hoşnut+Adj
hastalık	hastalık+Noun+A3sg+Pnon+Nom
lakırdı	lakırdı+Noun+A3sg+Pnon+Nom
birbiri	birbiri+Pron+Quant+A3sg+P3sg+Nom
zıt	zıt+Adj
haftalarca	haftalarca+Adverb
aylarca	aylarca+Adverb
tespit	tespit+Noun+A3sg+Pnon+Nom
ipek	ipek+Noun+A3sg+Pnon+Nom
kaçınılmaz	kaçınılmaz+Adj
umut	umut+Noun+A3sg+Pnon+Nom
meğer	meğer+Conj
blok	blok+Noun+A3sg+Pnon+Nom
övünç	övünç+Noun+A3sg+Pnon+Nom
öğrenci	öğrenci+Noun+A3sg+Pnon+Nom
muhatap	muhatap+Noun+A3sg+Pnon+Nom
uzadıya	uzadıya+Adverb
günlük	günlük+Adj
gencecik	gencecik+Adj
övgü	övgü+Noun+A3sg+Pnon+Nom
belirgin	belirgin+Adj
tabi	tabi+Adj
uyu	uyu+Verb+Pos+Imp+A2sg
mahkum	mahkum+Adj
kin	kin+Noun+A3sg+Pnon+Nom
adres	adres+Noun+A3sg+Pnon+Nom
eğitim	eğitim+Noun+A3sg+Pnon+Nom
etiket	etiket+Noun+A3sg+Pnon+Nom
hukuk	hukuk+Noun+A3sg+Pnon+Nom
magazin	magazin+Noun+A3sg+Pnon+Nom
fotoğraf	fotoğraf+Noun+A3sg+Pnon+Nom
kafalı	kafalı+Adj
metre	metre+Noun+A3sg+Pnon+Nom
sırt	sırt+Noun+A3sg+Pnon+Nom
bataklık	bataklık+Noun+A3sg+Pnon+Nom
ısırgan	ısırgan+Noun+A3sg+Pnon+Nom
çıplak	çıplak+Adj
dağınık	dağınık+Adj
çorak	çorak+Adj
kurşuni	kurşuni+Noun+A3sg+Pnon+Nom
çizgi	çizgi+Noun+A3sg+Pnon+Nom
in	in+Noun+A3sg+Pnon+Nom
titrek	titrek+Adj
zincir	zincir+Noun+A3sg+Pnon+Nom
delik	delik+Noun+A3sg+Pnon+Nom
deşik	deşik+Adj
bez	bez+Noun+A3sg+Pnon+Nom
sarılı	sarılı+Adj
sırılsıklam	sırılsıklam+Adj
göster	göster+Verb+Pos+Imp+A2sg
tepe	tepe+Noun+A3sg+Pnon+Nom
taklak	taklak+Noun+A3sg+Pnon+Nom
çan	çan+Noun+A3sg+Pnon+Nom
köpoğlu	köpoğlu+Noun+A3sg+Pnon+Nom
tombul	tombul+Adj
tehditkar	tehditkar+Adj
demirci	demirci+Noun+A3sg+Pnon+Nom
ima	ima+Noun+A3sg+Pnon+Nom
dön	dön+Verb+Pos+Imp+A2sg
kurbağa	kurbağa+Noun+A3sg+Pnon+Nom
yılanbalığı	yılanbalığı+Noun+A3sg+P3sg+Nom
kuvvet	kuvvet+Noun+A3sg+Pnon+Nom
usulca	usulca+Adverb
yağmur	yağmur+Noun+A3sg+Pnon+Nom
yatay	yatay+Adj
nesne	nesne+Noun+A3sg+Pnon+Nom
sarışın	sarışın+Adj
babacan	babacan+Adj
iğne	iğne+Noun+A3sg+Pnon+Nom
düğüm	düğüm+Noun+A3sg+Pnon+Nom
önlük	önlük+Noun+A3sg+Pnon+Nom
illa	illa+Adverb
muzdarip	muzdarip+Adj
balmumu	balmumu+Noun+A3sg+P3sg+Nom
mermi	mermi+Noun+A3sg+Pnon+Nom
maymun	maymun+Noun+A3sg+Pnon+Nom
yeterince	yeterince+Adverb
tereyağı	tereyağı+Noun+A3sg+P3sg+Nom
merhem	merhem+Noun+A3sg+Pnon+Nom
dert	dert+Noun+A3sg+Pnon+Nom
arkadaşça	arkadaşça+Adverb
çay	çay+Noun+A3sg+Pnon+Nom
ısırık	ısırık+Noun+A3sg+Pnon+Nom
hap	hap+Noun+A3sg+Pnon+Nom
katran	katran+Noun+A3sg+Pnon+Nom
ilaç	ilaç+Noun+A3sg+Pnon+Nom
miktar	miktar+Noun+A3sg+Pnon+Nom
iksir	iksir+Noun+A3sg+Pnon+Nom
çit	çit+Noun+A3sg+Pnon+Nom
litre	litre+Noun+A3sg+Pnon+Nom
işbirliği	işbirliği+Noun+A3sg+P3sg+Nom
zapt	zapt+Noun+A3sg+Pnon+Nom
bakır	bakır+Noun+A3sg+Pnon+Nom
egzersiz	egzersiz+Noun+A3sg+Pnon+Nom
tavan	tavan+Noun+A3sg+Pnon+Nom
tığ	tığ+Noun+A3sg+Pnon+Nom
top	top+Noun+A3sg+Pnon+Nom
çare	çare+Noun+A3sg+Pnon+Nom
besbelli	besbelli+Adverb
batak	batak+Noun+A3sg+Pnon+Nom
didik	didik+Dup
cinayet	cinayet+Noun+A3sg+Pnon+Nom
soygun	soygun+Noun+A3sg+Pnon+Nom
ketum	ketum+Adj
ilkbahar	ilkbahar+Noun+A3sg+Pnon+Nom
med	med+Noun+A3sg+Pnon+Nom
korsan	korsan+Noun+A3sg+Pnon+Nom
kibrit	kibrit+Noun+A3sg+Pnon+Nom
çatırtı	çatırtı+Noun+A3sg+Pnon+Nom
tavşan	tavşan+Noun+A3sg+Pnon+Nom
peynir	peynir+Noun+A3sg+Pnon+Nom
yaklaşık	yaklaşık+Adj
kavanoz	kavanoz+Noun+A3sg+Pnon+Nom
kıyma	kıyma+Noun+A3sg+Pnon+Nom
kanyak	kanyak+Noun+A3sg+Pnon+Nom
meyan	meyan+Noun+A3sg+Pnon+Nom
mutfak	mutfak+Noun+A3sg+Pnon+Nom
kemik	kemik+Noun+A3sg+Pnon+Nom
dilim	dilim+Noun+A3sg+Pnon+Nom
alet	alet+Noun+A3sg+Pnon+Nom
nem	nem+Noun+A3sg+Pnon+Nom
sis	sis+Noun+A3sg+Pnon+Nom
hayalet	hayalet+Noun+A3sg+Pnon+Nom
öküz	öküz+Noun+A3sg+Pnon+Nom
dindar	dindar+Noun+A3sg+Pnon+Nom
çifte	çifte+Adj
gevşek	gevşek+Adj
nehir	nehir+Noun+A3sg+Pnon+Nom
horul	horul+Dup
küt	küt+Noun+A3sg+Pnon+Nom
ufaklık	ufaklık+Noun+A3sg+Pnon+Nom
likör	likör+Noun+A3sg+Pnon+Nom
hayali	hayali+Adj
şırıltı	şırıltı+Noun+A3sg+Pnon+Nom
üstelik	üstelik+Adverb
profesyonel	profesyonel+Adj
çokça	çokça+Adverb
memnuniyet	memnuniyet+Noun+A3sg+Pnon+Nom
tahrik	tahrik+Noun+A3sg+Pnon+Nom
eş	eş+Noun+A3sg+Pnon+Nom
izlenim	izlenim+Noun+A3sg+Pnon+Nom
sohbet	sohbet+Noun+A3sg+Pnon+Nom
dö	dö+Noun+A3sg+Pnon+Nom
madam	madam+Noun+A3sg+Pnon+Nom
öğüt	öğüt+Noun+A3sg+Pnon+Nom
buhran	buhran+Noun+A3sg+Pnon+Nom
fahişe	fahişe+Noun+A3sg+Pnon+Nom
ı	ı+Noun+A3sg+Pnon+Nom
mesel	mesel+Noun+A3sg+Pnon+Nom
şairane	şairane+Adj
şair	şair+Noun+A3sg+Pnon+Nom
saba	saba+Noun+A3sg+Pnon+Nom
geçerli	geçerli+Adj
istisna	istisna+Noun+A3sg+Pnon+Nom
milli	milli+Adj
banker	banker+Noun+A3sg+Pnon+Nom
yoksun	yoksun+Adj
akl	akl+Noun+A3sg+Pnon+Nom
doktora	doktora+Noun+A3sg+Pnon+Nom
antika	antika+Noun+A3sg+Pnon+Nom
alacak	alacak+Noun+A3sg+Pnon+Nom
sevda	sevda+Noun+A3sg+Pnon+Nom
usul	usul+Noun+A3sg+Pnon+Nom
çıkararabilecek	çıkararabilecek+Noun+A3sg+Pnon+Nom
git	git+Verb+Pos+Imp+A2sg
beyzade	beyzade+Noun+A3sg+Pnon+Nom
mutlak	mutlak+Adj
uşak	uşak+Noun+A3sg+Pnon+Nom
kumarbaz	kumarbaz+Noun+A3sg+Pnon+Nom
düşük	düşük+Adj
casus	casus+Noun+A3sg+Pnon+Nom
ayol	ayol+Interj
sağlık	sağlık+Noun+A3sg+Pnon+Nom
mütevazi	mütevazi+Adj
sahte	sahte+Adj
babalık	babalık+Noun+A3sg+Pnon+Nom
çorap	çorap+Noun+A3sg+Pnon+Nom
kes	kes+Verb+Pos+Imp+A2sg
sefahat	sefahat+Noun+A3sg+Pnon+Nom
enayi	enayi+Adj
tosun	tosun+Noun+A3sg+Pnon+Nom
kuzu	kuzu+Noun+A3sg+Pnon+Nom
frank	frank+Noun+A3sg+Pnon+Nom
zampara	zampara+Noun+A3sg+Pnon+Nom
zenaat	zenaat+Noun+A3sg+Pnon+Nom
ispat	ispat+Noun+A3sg+Pnon+Nom
pazarlık	pazarlık+Noun+A3sg+Pnon+Nom
sene	sene+Noun+A3sg+Pnon+Nom
ücret	ücret+Noun+A3sg+Pnon+Nom
senelik	senelik+Adj
imtiyaz	imtiyaz+Noun+A3sg+Pnon+Nom
beraberce	beraberce+Adverb
fil	fil+Noun+A3sg+Pnon+Nom
endişelenm	endişelenm+Noun+A3sg+Pnon+Nom
zifaf	zifaf+Noun+A3sg+Pnon+Nom
kem	kem+Adj
küm	küm+Noun+A3sg+Pnon+Nom
teslim	teslim+Noun+A3sg+Pnon+Nom
cins	cins+Noun+A3sg+Pnon+Nom
orospu	orospu+Noun+A3sg+Pnon+Nom
melez	melez+Adj
ham	ham+Noun+A3sg+Pnon+Nom
bırak	bırak+Verb+Pos+Imp+A2sg
başbaşa	başbaşa+Adverb
kıpkızıl	kıpkızıl+Adj
sabit	sabit+Adj
fıskiye	fıskiye+Noun+A3sg+Pnon+Nom
mesut	mesut+Adj
çakıl	çakıl+Noun+A3sg+Pnon+Nom
çamur	çamur+Noun+A3sg+Pnon+Nom
marki	marki+Noun+A3sg+Pnon+Nom
ucuz	ucuz+Adj
emlak	emlak+Noun+A3pl+Pnon+Nom
döz	döz+Noun+A3sg+Pnon+Nom
diderek	diderek+Noun+A3sg+Pnon+Nom
tebrik	tebrik+Noun+A3sg+Pnon+Nom
dahil	dahil+Noun+A3sg+Pnon+Nom
haz	haz+Noun+A3sg+Pnon+Nom
saadet	saadet+Noun+A3sg+Pnon+Nom
kral	kral+Noun+A3sg+Pnon+Nom
takdis	takdis+Noun+A3sg+Pnon+Nom
gam	gam+Noun+A3sg+Pnon+Nom
vasıta	vasıta+Noun+A3sg+Pnon+Nom
hayırlı	hayırlı+Adj
kefen	kefen+Noun+A3sg+Pnon+Nom
şen	şen+Adj
bitirim	bitirim+Adj
mecbur	mecbur+Adj
zerre	zerre+Noun+A3sg+Pnon+Nom
ışıl	ışıl+Dup
elmas	elmas+Noun+A3sg+Pnon+Nom
elveda	elveda+Noun+A3sg+Pnon+Nom
yak	yak+Verb+Pos+Imp+A2sg
tuzlu	tuzlu+Adj
divane	divane+Adj
evvelsi	evvelsi+Adj
bilakis	bilakis+Adverb
daim	daim+Adj
hor	hor+Adj
teşhir	teşhir+Noun+A3sg+Pnon+Nom
portmanto	portmanto+Noun+A3sg+Pnon+Nom
uysal	uysal+Adj
itaat	itaat+Noun+A3sg+Pnon+Nom
şart	şart+Noun+A3sg+Pnon+Nom
aday	aday+Noun+A3sg+Pnon+Nom
amade	amade+Adj
hatırşinas	hatırşinas+Adj
şakacı	şakacı+Noun+A3sg+Pnon+Nom
dü	dü+Noun+A3sg+Pnon+Nom
şölen	şölen+Noun+A3sg+Pnon+Nom
kuruş	kuruş+Noun+A3sg+Pnon+Nom
yahu	yahu+Interj
özen	özen+Noun+A3sg+Pnon+Nom
dilber	dilber+Noun+A3sg+Pnon+Nom
misk	misk+Noun+A3sg+Pnon+Nom
makyaj	makyaj+Noun+A3sg+Pnon+Nom
eteklik	eteklik+Noun+A3sg+Pnon+Nom
redingot	redingot+Noun+A3sg+Pnon+Nom
bone	bone+Noun+A3sg+Pnon+Nom
ihmalkar	ihmalkar+Adj
manto	manto+Noun+A3sg+Pnon+Nom
mevsim	mevsim+Noun+A3sg+Pnon+Nom
kış	kış+Noun+A3sg+Pnon+Nom
buket	buket+Noun+A3sg+Pnon+Nom
sığ	sığ+Noun+A3sg+Pnon+Nom
nadir	nadir+Adj
yüzlerce	yüzlerce+Num+Card
çalım	çalım+Noun+A3sg+Pnon+Nom
burjuva	burjuva+Noun+A3sg+Pnon+Nom
neşter	neşter+Noun+A3sg+Pnon+Nom
bünye	bünye+Noun+A3sg+Pnon+Nom
saray	saray+Noun+A3sg+Pnon+Nom
prestij	prestij+Noun+A3sg+Pnon+Nom
görmemiş	görmemiş+Adj
şahane	şahane+Adj
akı	akı+Noun+A3sg+Pnon+Nom
engin	engin+Adj
mermer	mermer+Noun+A3sg+Pnon+Nom
dük	dük+Noun+A3sg+Pnon+Nom
kraliçe	kraliçe+Noun+A3sg+Pnon+Nom
halı	halı+Noun+A3sg+Pnon+Nom
tesadüf	tesadüf+Noun+A3sg+Pnon+Nom
tepsi	tepsi+Noun+A3sg+Pnon+Nom
bardak	bardak+Noun+A3sg+Pnon+Nom
ticari	ticari+Adj
yoksul	yoksul+Noun+A3sg+Pnon+Nom
servet	servet+Noun+A3sg+Pnon+Nom
yaver	yaver+Noun+A3sg+Pnon+Nom
fakir	fakir+Noun+A3sg+Pnon+Nom
gıcır	gıcır+Noun+A3sg+Pnon+Nom
zahmet	zahmet+Noun+A3sg+Pnon+Nom
avukat	avukat+Noun+A3sg+Pnon+Nom
deniz	deniz+Noun+A3sg+Pnon+Nom
sorumlu	sorumlu+Noun+A3sg+Pnon+Nom
azim	azim+Noun+A3sg+Pnon+Nom
öğren	öğren+Verb+Pos+Imp+A2sg
gurur	gurur+Noun+A3sg+Pnon+Nom
kanım	kanım+Noun+A3sg+Pnon+Nom
özgür	özgür+Adj
rüzgar	rüzgar+Noun+A3sg+Pnon+Nom
sarf	sarf+Noun+A3sg+Pnon+Nom
tedbir	tedbir+Noun+A3sg+Pnon+Nom
idam	idam+Noun+A3sg+Pnon+Nom
şefkat	şefkat+Noun+A3sg+Pnon+Nom
istek	istek+Noun+A3sg+Pnon+Nom
bisküvi	bisküvi+Noun+A3sg+Pnon+Nom
nevresim	nevresim+Noun+A3sg+Pnon+Nom
hüküm	hüküm+Noun+A3sg+Pnon+Nom
telafi	telafi+Noun+A3sg+Pnon+Nom
çatı	çatı+Noun+A3sg+Pnon+Nom
anahtar	anahtar+Noun+A3sg+Pnon+Nom
sakınca	sakınca+Noun+A3sg+Pnon+Nom
viski	viski+Noun+A3sg+Pnon+Nom
yarar	yarar+Noun+A3sg+Pnon+Nom
palto	palto+Noun+A3sg+Pnon+Nom
takma	takma+Adj
peki	peki+Adverb
kahvaltı	kahvaltı+Noun+A3sg+Pnon+Nom
cep	cep+Noun+A3sg+Pnon+Nom
kömür	kömür+Noun+A3sg+Pnon+Nom
tur	tur+Noun+A3sg+Pnon+Nom
kel	kel+Noun+A3sg+Pnon+Nom
şişkin	şişkin+Adj
cüzdan	cüzdan+Noun+A3sg+Pnon+Nom
ihbar	ihbar+Noun+A3sg+Pnon+Nom
peruk	peruk+Noun+A3sg+Pnon+Nom
gözlük	gözlük+Noun+A3sg+Pnon+Nom
acil	acil+Adj
kamuflaj	kamuflaj+Noun+A3sg+Pnon+Nom
üniversite	üniversite+Noun+A3sg+Pnon+Nom
çiftçi	çiftçi+Noun+A3sg+Pnon+Nom
temizlikçi	temizlikçi+Noun+A3sg+Pnon+Nom
pansiyon	pansiyon+Noun+A3sg+Pnon+Nom
aman	aman+Interj
teyit	teyit+Noun+A3sg+Pnon+Nom
af	af+Noun+A3sg+Pnon+Nom
sömürgeci	sömürgeci+Adj
tir	tir+Noun+A3sg+Pnon+Nom
belediye	belediye+Noun+A3sg+Pnon+Nom
mutsuz	mutsuz+Adj
parala	parala+Verb+Pos+Imp+A2sg
memur	memur+Noun+A3sg+Pnon+Nom
denk	denk+Noun+A3sg+Pnon+Nom
lüks	lüks+Adj
işkence	işkence+Noun+A3sg+Pnon+Nom
bronz	bronz+Noun+A3sg+Pnon+Nom
akşamüzeri	akşamüzeri+Noun+A3sg+P3sg+Nom
sofra	sofra+Noun+A3sg+Pnon+Nom
alabalık	alabalık+Noun+A3sg+Pnon+Nom
heykel	heykel+Noun+A3sg+Pnon+Nom
kart	kart+Noun+A3sg+Pnon+Nom
pazartesi	pazartesi+Noun+A3sg+Pnon+Nom
bakanlık	bakanlık+Noun+A3sg+Pnon+Nom
rakam	rakam+Noun+A3sg+Pnon+Nom
çalıkuşu	çalıkuşu+Noun+A3sg+P3sg+Nom
ödünç	ödünç+Adj
iste	iste+Verb+Pos+Imp+A2sg
kutu	kutu+Noun+A3sg+Pnon+Nom
seç	seç+Verb+Pos+Imp+A2sg
inci	inci+Noun+A3sg+Pnon+Nom
kolye	kolye+Noun+A3sg+Pnon+Nom
vals	vals+Noun+A3sg+Pnon+Nom
balo	balo+Noun+A3sg+Pnon+Nom
mütevazı	mütevazı+Adj
kısacası	kısacası+Adverb
takı	takı+Noun+A3sg+Pnon+Nom
kuyumcu	kuyumcu+Noun+A3sg+Pnon+Nom
şubat	şubat+Noun+A3sg+Pnon+Nom
ger	ger+Verb+Pos+Imp+A2sg
fiziksel	fiziksel+Adj
çanak	çanak+Noun+A3sg+Pnon+Nom
ip	ip+Noun+A3sg+Pnon+Nom
kasaba	kasaba+Noun+A3sg+Pnon+Nom
senet	senet+Noun+A3sg+Pnon+Nom
dayanıklı	dayanıklı+Adj
eğri	eğri+Noun+A3sg+Pnon+Nom
değişken	değişken+Adj
sefalet	sefalet+Noun+A3sg+Pnon+Nom
pespembe	pespembe+Adj
kitle	kitle+Noun+A3sg+Pnon+Nom
istisnai	istisnai+Noun+A3sg+Pnon+Nom
berrak	berrak+Adj
görüntü	görüntü+Noun+A3sg+Pnon+Nom
hikaye	hikaye+Noun+A3sg+Pnon+Nom
akarsu	akarsu+Noun+A3sg+Pnon+Nom
granit	granit+Noun+A3sg+Pnon+Nom
çam	çam+Noun+A3sg+Pnon+Nom
kaya	kaya+Noun+A3sg+Pnon+Nom
tarım	tarım+Noun+A3sg+Pnon+Nom
endüstri	endüstri+Noun+A3sg+Pnon+Nom
sanat	sanat+Noun+A3sg+Pnon+Nom
zorlu	zorlu+Adj
kalıtsal	kalıtsal+Adj
metal	metal+Noun+A3sg+Pnon+Nom
kindar	kindar+Adj
misafirperver	misafirperver+Noun+A3sg+Pnon+Nom
arkadaşlık	arkadaşlık+Noun+A3sg+Pnon+Nom
han	han+Noun+A3sg+Pnon+Nom
meyhane	meyhane+Noun+A3sg+Pnon+Nom
idare	idare+Noun+A3sg+Pnon+Nom
yokuş	yokuş+Noun+A3sg+Pnon+Nom
seksen	seksen+Num+Card
patates	patates+Noun+A3sg+Pnon+Nom
seyahat	seyahat+Noun+A3sg+Pnon+Nom
evren	evren+Noun+A3sg+Pnon+Nom
skandal	skandal+Noun+A3sg+Pnon+Nom
süvari	süvari+Noun+A3sg+Pnon+Nom
köylü	köylü+Noun+A3sg+Pnon+Nom
asker	asker+Noun+A3sg+Pnon+Nom
geçit	geçit+Noun+A3sg+Pnon+Nom
kanaat	kanaat+Noun+A3sg+Pnon+Nom
kaptan	kaptan+Noun+A3sg+Pnon+Nom
hasır	hasır+Noun+A3sg+Pnon+Nom
nezaket	nezaket+Noun+A3sg+Pnon+Nom
ılık	ılık+Adj
büklüm	büklüm+Noun+A3sg+Pnon+Nom
çarpık	çarpık+Adj
buruşuk	buruşuk+Adj
altmış	altmış+Num+Card
sürahi	sürahi+Noun+A3sg+Pnon+Nom
elma	elma+Noun+A3sg+Pnon+Nom
haydi	haydi+Interj
hancı	hancı+Noun+A3sg+Pnon+Nom
cadı	cadı+Noun+A3sg+Pnon+Nom
sucuk	sucuk+Noun+A3sg+Pnon+Nom
but	but+Noun+A3sg+Pnon+Nom
çorba	çorba+Noun+A3sg+Pnon+Nom
süt	süt+Noun+A3sg+Pnon+Nom
mide	mide+Noun+A3sg+Pnon+Nom
gönüllü	gönüllü+Adj
hediye	hediye+Noun+A3sg+Pnon+Nom
itiraz	itiraz+Noun+A3sg+Pnon+Nom
çakırkeyif	çakırkeyif+Adj
merhaba	merhaba+Noun+A3sg+Pnon+Nom
bedbaht	bedbaht+Adj
lokma	lokma+Noun+A3sg+Pnon+Nom
ozan	ozan+Noun+A3sg+Pnon+Nom
hah	hah+Interj
yalpa	yalpa+Noun+A3sg+Pnon+Nom
nöbet	nöbet+Noun+A3sg+Pnon+Nom
çatlak	çatlak+Adj
içim	içim+Noun+A3sg+Pnon+Nom
hastane	hastane+Noun+A3sg+Pnon+Nom
beşinci	beşinci+Num+Ord
organik	organik+Adj
tutacak	tutacak+Noun+A3sg+Pnon+Nom
paket	paket+Noun+A3sg+Pnon+Nom
çocuksu	çocuksu+Adj
vergi	vergi+Noun+A3sg+Pnon+Nom
hüngür	hüngür+Noun+A3sg+Pnon+Nom
kahkaha	kahkaha+Noun+A3sg+Pnon+Nom
sıcacık	sıcacık+Adj
sıkkın	sıkkın+Adj
mahzun	mahzun+Adj
dördüncü	dördüncü+Num+Ord
bohça	bohça+Noun+A3sg+Pnon+Nom
piliç	piliç+Noun+A3sg+Pnon+Nom
sargı	sargı+Noun+A3sg+Pnon+Nom
pansuman	pansuman+Noun+A3sg+Pnon+Nom
tutun	tutun+Verb+Pos+Imp+A2sg
deri	deri+Noun+A3sg+Pnon+Nom
kardeş	kardeş+Noun+A3sg+Pnon+Nom
surat	surat+Noun+A3sg+Pnon+Nom
mezun	mezun+Adj
kimya	kimya+Noun+A3sg+Pnon+Nom
staj	staj+Noun+A3sg+Pnon+Nom
sigorta	sigorta+Noun+A3sg+Pnon+Nom
mesleki	mesleki+Adj
değişim	değişim+Noun+A3sg+Pnon+Nom
halen	halen+Adverb
yeis	yeis+Noun+A3sg+Pnon+Nom
soyut	soyut+Adj
emekli	emekli+Adj
kubbe	kubbe+Noun+A3sg+Pnon+Nom
yay	yay+Noun+A3sg+Pnon+Nom
yorgan	yorgan+Noun+A3sg+Pnon+Nom
bacak	bacak+Noun+A3sg+Pnon+Nom
rüya	rüya+Noun+A3sg+Pnon+Nom
nasılsa	nasılsa+Adverb
kumaş	kumaş+Noun+A3sg+Pnon+Nom
kürk	kürk+Adj
tren	tren+Noun+A3sg+Pnon+Nom
kaşıntı	kaşıntı+Noun+A3sg+Pnon+Nom
karyola	karyola+Noun+A3sg+Pnon+Nom
istifa	istifa+Noun+A3sg+Pnon+Nom
tıkır	tıkır+Noun+A3sg+Pnon+Nom
yelkovan	yelkovan+Noun+A3sg+Pnon+Nom
acele	acele+Adj
zinde	zinde+Adj
patrona	patrona+Noun+A3sg+Pnon+Nom
kayıtsız	kayıtsız+Adj
yıllık	yıllık+Noun+A3sg+Pnon+Nom
meslek	meslek+Noun+A3sg+Pnon+Nom
kendiliğinden	kendiliğinden+Adverb
minik	minik+Adj
sonuç	sonuç+Noun+A3sg+Pnon+Nom
uyuşuk	uyuşuk+Adj
yön	yön+Noun+A3sg+Pnon+Nom
duyarlı	duyarlı+Adj
akıllıca	akıllıca+Adj
mağaza	mağaza+Noun+A3sg+Pnon+Nom
bütünüyle	bütünüyle+Adverb
kabarık	kabarık+Adj
ritim	ritim+Noun+A3sg+Pnon+Nom
tümü	tümü+Pron+Quant+A3pl+P3pl+Nom
düzenbaz	düzenbaz+Adj
ezkaza	ezkaza+Adverb
vicdan	vicdan+Noun+A3sg+Pnon+Nom
seferber	seferber+Noun+A3sg+Pnon+Nom
maksat	maksat+Noun+A3sg+Pnon+Nom
marangoz	marangoz+Noun+A3sg+Pnon+Nom
çerçeve	çerçeve+Noun+A3sg+Pnon+Nom
gergin	gergin+Adj
patron	patron+Noun+A3sg+Pnon+Nom
derhal	derhal+Adverb
alay	alay+Noun+A3sg+Pnon+Nom
çilingir	çilingir+Noun+A3sg+Pnon+Nom
yapışkan	yapışkan+Adj
sıvı	sıvı+Noun+A3sg+Pnon+Nom
it	it+Noun+A3sg+Pnon+Nom
karış	karış+Noun+A3sg+Pnon+Nom
seyrek	seyrek+Adj
saatlerce	saatlerce+Adverb
askerlik	askerlik+Noun+A3sg+Pnon+Nom
yargı	yargı+Noun+A3sg+Pnon+Nom
işadamı	işadamı+Noun+A3sg+P3sg+Nom
seyyar	seyyar+Adj
kurban	kurban+Noun+A3sg+Pnon+Nom
argın	argın+Noun+A3sg+Pnon+Nom
insanüstü	insanüstü+Adj
güvence	güvence+Noun+A3sg+Pnon+Nom
destek	destek+Noun+A3sg+Pnon+Nom
imdat	imdat+Noun+A3sg+Pnon+Nom
çelişki	çelişki+Noun+A3sg+Pnon+Nom
merdiven	merdiven+Noun+A3sg+Pnon+Nom
insaf	insaf+Noun+A3sg+Pnon+Nom
gerçekte	gerçekte+Adverb
salim	salim+Adj
saplantı	saplantı+Noun+A3sg+Pnon+Nom
şaka	şaka+Noun+A3sg+Pnon+Nom
darbe	darbe+Noun+A3sg+Pnon+Nom
alaca	alaca+Adj
tas	tas+Noun+A3sg+Pnon+Nom
yükses	yükses+Noun+A3sg+Pnon+Nom
seda	seda+Noun+A3sg+Pnon+Nom
damak	damak+Noun+A3sg+Pnon+Nom
sos	sos+Noun+A3sg+Pnon+Nom
badem	badem+Noun+A3sg+Pnon+Nom
kap	kap+Noun+A3sg+Pnon+Nom
döner	döner+Noun+A3sg+Pnon+Nom
aşikar	aşikar+Adj
gerekse	gerekse+Conj
iflas	iflas+Noun+A3sg+Pnon+Nom
belge	belge+Noun+A3sg+Pnon+Nom
not	not+Noun+A3sg+Pnon+Nom
nakit	nakit+Noun+A3sg+Pnon+Nom
içtenlik	içtenlik+Noun+A3sg+Pnon+Nom
ekstra	ekstra+Adj
elbet	elbet+Adverb
resmen	resmen+Adverb
florin	florin+Noun+A3sg+Pnon+Nom
birikim	birikim+Noun+A3sg+Pnon+Nom
ihtiyat	ihtiyat+Noun+A3sg+Pnon+Nom
fazladan	fazladan+Adverb
faiz	faiz+Noun+A3sg+Pnon+Nom
solunum	solunum+Noun+A3sg+Pnon+Nom
gökyüzü	gökyüzü+Noun+A3sg+P3sg+Nom
keten	keten+Noun+A3sg+Pnon+Nom
eğlence	eğlence+Noun+A3sg+Pnon+Nom
örneğin	örneğin+Conj
çocukça	çocukça+Adj
titreşim	titreşim+Noun+A3sg+Pnon+Nom
dolap	dolap+Noun+A3sg+Pnon+Nom
çarşaf	çarşaf+Noun+A3sg+Pnon+Nom
bomboş	bomboş+Adj
dopdolu	dopdolu+Adj
tertemiz	tertemiz+Adj
yaratık	yaratık+Noun+A3sg+Pnon+Nom
ezgi	ezgi+Noun+A3sg+Pnon+Nom
çın	çın+Adj
şakrak	şakrak+Adj
çalçene	çalçene+Noun+A3sg+Pnon+Nom
afacan	afacan+Noun+A3sg+Pnon+Nom
cilve	cilve+Noun+A3sg+Pnon+Nom
tok	tok+Adj
yersiz	yersiz+Adj
muhtemel	muhtemel+Adj
körük	körük+Noun+A3sg+Pnon+Nom
mahir	mahir+Adj
kadir	kadir+Noun+A3sg+Pnon+Nom
kıymet	kıymet+Noun+A3sg+Pnon+Nom
şükran	şükran+Noun+A3sg+Pnon+Nom
parka	parka+Noun+A3sg+Pnon+Nom
içli	içli+Adj
perişan	perişan+Adj
gaddarca	gaddarca+Adj
satır	satır+Noun+A3sg+Pnon+Nom
duyarsız	duyarsız+Adj
akadar	akadar+Noun+A3sg+Pnon+Nom
ca	ca+Noun+A3sg+Pnon+Nom
banka	banka+Noun+A3sg+Pnon+Nom
sicim	sicim+Noun+A3sg+Pnon+Nom
harap	harap+Adj
öksüz	öksüz+Noun+A3sg+Pnon+Nom
yetim	yetim+Noun+A3sg+Pnon+Nom
bakım	bakım+Noun+A3sg+Pnon+Nom
subay	subay+Noun+A3sg+Pnon+Nom
otobiyografik	otobiyografik+Adj
ayrıntı	ayrıntı+Noun+A3sg+Pnon+Nom
radikal	radikal+Adj
demokrat	demokrat+Noun+A3sg+Pnon+Nom
muhafazakar	muhafazakar+Noun+A3sg+Pnon+Nom
liberal	liberal+Noun+A3sg+Pnon+Nom
edebi	edebi+Adj
pedagoji	pedagoji+Noun+A3sg+Pnon+Nom
etken	etken+Noun+A3sg+Pnon+Nom
nam	nam+Noun+A3sg+Pnon+Nom
vas	vas+Noun+A3sg+Pnon+Nom
aforoz	aforoz+Noun+A3sg+Pnon+Nom
yurt	yurt+Noun+A3sg+Pnon+Nom
demiryolu	demiryolu+Noun+A3sg+P3sg+Nom
epik	epik+Noun+A3sg+Pnon+Nom
egemen	egemen+Adj
tema	tema+Noun+A3sg+Pnon+Nom
iletişim	iletişim+Noun+A3sg+Pnon+Nom
cinsel	cinsel+Adj
tmi	tmi+Noun+A3sg+Pnon+Nom
ahlaksal	ahlaksal+Adj
yenilikçi	yenilikçi+Noun+A3sg+Pnon+Nom
defalarca	defalarca+Adverb
milyonlarca	milyonlarca+Num+Card
şaheser	şaheser+Noun+A3sg+Pnon+Nom
bahar	bahar+Noun+A3sg+Pnon+Nom
kaldırım	kaldırım+Noun+A3sg+Pnon+Nom
mis	mis+Noun+A3sg+Pnon+Nom
tahakküm	tahakküm+Noun+A3sg+Pnon+Nom
icad	icad+Noun+A3sg+Pnon+Nom
süküna	süküna+Noun+A3sg+Pnon+Nom
numara	numara+Noun+A3sg+Pnon+Nom
başlık	başlık+Noun+A3sg+Pnon+Nom
mühür	mühür+Noun+A3sg+Pnon+Nom
nisan	nisan+Noun+A3sg+Pnon+Nom
sırma	sırma+Noun+A3sg+Pnon+Nom
ceket	ceket+Noun+A3sg+Pnon+Nom
kemer	kemer+Noun+A3sg+Pnon+Nom
gardiyan	gardiyan+Noun+A3sg+Pnon+Nom
lağım	lağım+Noun+A3sg+Pnon+Nom
kaput	kaput+Noun+A3sg+Pnon+Nom
file	file+Noun+A3sg+Pnon+Nom
aba	aba+Noun+A3sg+Pnon+Nom
başörtü	başörtü+Noun+A3sg+Pnon+Nom
lüle	lüle+Noun+A3sg+Pnon+Nom
şehla	şehla+Adj
tut	tut+Verb+Pos+Imp+A2sg
katip	katip+Noun+A3sg+Pnon+Nom
götür	götür+Verb+Pos+Imp+A2sg
çavuş	çavuş+Noun+A3sg+Pnon+Nom
sallıyarak	sallıyarak+Noun+A3sg+Pnon+Nom
metelik	metelik+Noun+A3sg+Pnon+Nom
gayrimeşru	gayrimeşru+Adj
birgün	birgün+Adverb
inek	inek+Noun+A3sg+Pnon+Nom
nurtopu	nurtopu+Noun+A3sg+P3sg+Nom
evlatlık	evlatlık+Noun+A3sg+Pnon+Nom
onaltı	onaltı+Num+Card
prens	prens+Noun+A3sg+Pnon+Nom
ruble	ruble+Noun+A3sg+Pnon+Nom
hamile	hamile+Noun+A3sg+Pnon+Nom
jandarma	jandarma+Noun+A3sg+Pnon+Nom
lohusa	lohusa+Noun+A3sg+Pnon+Nom
çamaşırhane	çamaşırhane+Noun+A3sg+Pnon+Nom
harçlık	harçlık+Noun+A3sg+Pnon+Nom
cazip	cazip+Adj
kurdele	kurdele+Noun+A3sg+Pnon+Nom
döşeli	döşeli+Adj
apartman	apartman+Noun+A3sg+Pnon+Nom
vesika	vesika+Noun+A3sg+Pnon+Nom
muhabbet	muhabbet+Noun+A3sg+Pnon+Nom
dekolte	dekolte+Noun+A3sg+Pnon+Nom
nüfus	nüfus+Noun+A3sg+Pnon+Nom
itibaren	itibaren+Postp+PCAbl
madensuyu	madensuyu+Noun+A3sg+P3sg+Nom
banyo	banyo+Noun+A3sg+Pnon+Nom
krem	krem+Noun+A3sg+Pnon+Nom
gözalıcı	gözalıcı+Adj
çalgı	çalgı+Noun+A3sg+Pnon+Nom
ortam	ortam+Noun+A3sg+Pnon+Nom
şafak	şafak+Noun+A3sg+Pnon+Nom
saçık	saçık+Adj
kuştüyü	kuştüyü+Noun+A3sg+P3sg+Nom
kolonya	kolonya+Noun+A3sg+Pnon+Nom
briyantin	briyantin+Noun+A3sg+Pnon+Nom
lavanta	lavanta+Noun+A3sg+Pnon+Nom
fırça	fırça+Noun+A3sg+Pnon+Nom
bitişik	bitişik+Adj
boyunbağı	boyunbağı+Noun+A3sg+P3sg+Nom
büfe	büfe+Noun+A3sg+Pnon+Nom
örtü	örtü+Noun+A3sg+Pnon+Nom
matem	matem+Noun+A3sg+Pnon+Nom
jüri	jüri+Noun+A3sg+Pnon+Nom
talip	talip+Noun+A3sg+Pnon+Nom
mayıs	mayıs+Noun+A3sg+Pnon+Nom
irtica	irtica+Noun+A3sg+Pnon+Nom
siyasi	siyasi+Adj
kur	kur+Noun+A3sg+Pnon+Nom
rahmetli	rahmetli+Adj
tahsil	tahsil+Noun+A3sg+Pnon+Nom
ikiyüz	ikiyüz+Noun+A3sg+Pnon+Nom
hektar	hektar+Noun+A3sg+Pnon+Nom
geçim	geçim+Noun+A3sg+Pnon+Nom
niyet	niyet+Noun+A3sg+Pnon+Nom
estetik	estetik+Noun+A3sg+Pnon+Nom
mahkeme	mahkeme+Noun+A3sg+Pnon+Nom
delil	delil+Noun+A3sg+Pnon+Nom
bekar	bekar+Noun+A3sg+Pnon+Nom
esrarengiz	esrarengiz+Adj
giyim	giyim+Noun+A3sg+Pnon+Nom
olumlu	olumlu+Adj
nazaran	nazaran+Postp+PCDat
pistolde	pistolde+Noun+A3sg+Pnon+Nom
nazır	nazır+Adj
muhakeme	muhakeme+Noun+A3sg+Pnon+Nom
savcı	savcı+Noun+A3sg+Pnon+Nom
sorgu	sorgu+Noun+A3sg+Pnon+Nom
affet	affet+Verb+Pos+Imp+A2sg
elele	elele+Adverb
mürekkep	mürekkep+Noun+A3sg+Pnon+Nom
emir	emir+Noun+A3sg+Pnon+Nom
tedarik	tedarik+Noun+A3sg+Pnon+Nom
intihar	intihar+Noun+A3sg+Pnon+Nom
kısım	kısım+Noun+A3sg+Pnon+Nom
malik	malik+Noun+A3sg+Pnon+Nom
menkul	menkul+Adj
gayri	gayri+Noun+A3sg+Pnon+Nom
vasiyetname	vasiyetname+Noun+A3sg+Pnon+Nom
rahip	rahip+Noun+A3sg+Pnon+Nom
tediye	tediye+Noun+A3sg+Pnon+Nom
tahvil	tahvil+Noun+A3sg+Pnon+Nom
anıt	anıt+Noun+A3sg+Pnon+Nom
kabir	kabir+Noun+A3sg+Pnon+Nom
inşa	inşa+Noun+A3sg+Pnon+Nom
dayalı	dayalı+Adj
dönük	dönük+Adj
kitabe	kitabe+Noun+A3sg+Pnon+Nom
naçiz	naçiz+Adj
hitaben	hitaben+Postp+PCDat
beraat	beraat+Noun+A3sg+Pnon+Nom
müteveffa	müteveffa+Adj
izmarit	izmarit+Noun+A3sg+Pnon+Nom
çöl	çöl+Noun+A3sg+Pnon+Nom
cemiyet	cemiyet+Noun+A3sg+Pnon+Nom
yoldaş	yoldaş+Noun+A3sg+Pnon+Nom
put	put+Noun+A3sg+Pnon+Nom
beyanname	beyanname+Noun+A3sg+Pnon+Nom
iade	iade+Noun+A3sg+Pnon+Nom
amaç	amaç+Noun+A3sg+Pnon+Nom
forsa	forsa+Noun+A3sg+Pnon+Nom
hız	hız+Noun+A3sg+Pnon+Nom
zihin	zihin+Noun+A3sg+Pnon+Nom
arma	arma+Noun+A3sg+Pnon+Nom
yolcu	yolcu+Noun+A3sg+Pnon+Nom
çivi	çivi+Noun+A3sg+Pnon+Nom
tabure	tabure+Noun+A3sg+Pnon+Nom
ajan	ajan+Noun+A3sg+Pnon+Nom
itibar	itibar+Noun+A3sg+Pnon+Nom
kravat	kravat+Noun+A3sg+Pnon+Nom
dayanak	dayanak+Noun+A3sg+Pnon+Nom
mesafe	mesafe+Noun+A3sg+Pnon+Nom
sürgü	sürgü+Noun+A3sg+Pnon+Nom
tekme	tekme+Noun+A3sg+Pnon+Nom
talimat	talimat+Noun+A3sg+Pnon+Nom
gözardı	gözardı+Noun+A3sg+P3sg+Nom
veri	veri+Noun+A3sg+Pnon+Nom
sistem	sistem+Noun+A3sg+Pnon+Nom
tutarlı	tutarlı+Adj
yerel	yerel+Adj
oturum	oturum+Noun+A3sg+Pnon+Nom
ağ	ağ+Noun+A3sg+Pnon+Nom
kablo	kablo+Noun+A3sg+Pnon+Nom
görev	görev+Noun+A3sg+Pnon+Nom
bkz	bkz+Noun+A3sg+Pnon+Nom
koşul	koşul+Noun+A3sg+Pnon+Nom
devre	devre+Noun+A3sg+Pnon+Nom
komut	komut+Noun+A3sg+Pnon+Nom
eylem	eylem+Noun+A3sg+Pnon+Nom
toplantı	toplantı+Noun+A3sg+Pnon+Nom
yaygın	yaygın+Adj
parola	parola+Noun+A3sg+Pnon+Nom
yapısal	yapısal+Adj
uyarı	uyarı+Noun+A3sg+Pnon+Nom
ondalık	ondalık+Noun+A3sg+Pnon+Nom
pozitif	pozitif+Adj
negatif	negatif+Adj
klasör	klasör+Noun+A3sg+Pnon+Nom
ad	ad+Noun+A3sg+Pnon+Nom
görünüm	görünüm+Noun+A3sg+Pnon+Nom
ayar	ayar+Noun+A3sg+Pnon+Nom
sorun	sorun+Noun+A3sg+Pnon+Nom
program	program+Noun+A3sg+Pnon+Nom
otomatik	otomatik+Adj
ksh	ksh+Noun+A3sg+Pnon+Nom
bağımsız	bağımsız+Adj
görüntüle	görüntüle+Verb+Pos+Imp+A2sg
araç	araç+Noun+A3sg+Pnon+Nom
öğe	öğe+Noun+A3sg+Pnon+Nom
seçim	seçim+Noun+A3sg+Pnon+Nom
sütun	sütun+Noun+A3sg+Pnon+Nom
onay	onay+Noun+A3sg+Pnon+Nom
seçenek	seçenek+Noun+A3sg+Pnon+Nom
dosya	dosya+Noun+A3sg+Pnon+Nom
sinyal	sinyal+Noun+A3sg+Pnon+Nom
işlem	işlem+Noun+A3sg+Pnon+Nom
devranılacak	devranılacak+Noun+A3sg+Pnon+Nom
bilgisayar	bilgisayar+Noun+A3sg+Pnon+Nom
grup	grup+Noun+A3sg+Pnon+Nom
bireysel	bireysel+Adj
kimlik	kimlik+Noun+A3sg+Pnon+Nom
bağımlı	bağımlı+Adj
erişim	erişim+Noun+A3sg+Pnon+Nom
italik	italik+Adj
dikey	dikey+Adj
harf	harf+Noun+A3sg+Pnon+Nom
geçici	geçici+Adj
düzen	düzen+Noun+A3sg+Pnon+Nom
toplu	toplu+Adj
ürün	ürün+Noun+A3sg+Pnon+Nom
kolon	kolon+Noun+A3sg+Pnon+Nom
düzey	düzey+Noun+A3sg+Pnon+Nom
filtre	filtre+Noun+A3sg+Pnon+Nom
hücre	hücre+Noun+A3sg+Pnon+Nom
toplam	toplam+Noun+A3sg+Pnon+Nom
birim	birim+Noun+A3sg+Pnon+Nom
spor	spor+Noun+A3sg+Pnon+Nom
özet	özet+Noun+A3sg+Pnon+Nom
işlev	işlev+Noun+A3sg+Pnon+Nom
düzenle	düzenle+Verb+Pos+Imp+A2sg
veritabanı	veritabanı+Noun+A3sg+P3sg+Nom
esas	esas+Adj
sunucu	sunucu+Noun+A3sg+Pnon+Nom
uygulama	uygulama+Noun+A3sg+Pnon+Nom
karşıt	karşıt+Adj
sayı	sayı+Noun+A3sg+Pnon+Nom
video	video+Noun+A3sg+Pnon+Nom
efekt	efekt+Noun+A3sg+Pnon+Nom
grafik	grafik+Noun+A3sg+Pnon+Nom
elektronik	elektronik+Adj
yerleşik	yerleşik+Adj
kayıt	kayıt+Noun+A3sg+Pnon+Nom
düğme	düğme+Noun+A3sg+Pnon+Nom
artı	artı+Noun+A3sg+Pnon+Nom
eksi	eksi+Noun+A3sg+Pnon+Nom
hiyerarşi	hiyerarşi+Noun+A3sg+Pnon+Nom
sayfa	sayfa+Noun+A3sg+Pnon+Nom
çevrimdışı	çevrimdışı+Noun+A3sg+P3sg+Nom
çevrimiçi	çevrimiçi+Adj
temel	temel+Adj
dizi	dizi+Noun+A3sg+Pnon+Nom
seri	seri+Noun+A3sg+Pnon+Nom
kategori	kategori+Noun+A3sg+Pnon+Nom
x	x+Noun+A3sg+Pnon+Nom
masaüstü	masaüstü+Adj
bağlantı	bağlantı+Noun+A3sg+Pnon+Nom
performans	performans+Noun+A3sg+Pnon+Nom
sayaç	sayaç+Noun+A3sg+Pnon+Nom
dizin	dizin+Noun+A3sg+Pnon+Nom
geçersiz	geçersiz+Adj
yazılım	yazılım+Noun+A3sg+Pnon+Nom
simge	simge+Noun+A3sg+Pnon+Nom
sürüm	sürüm+Noun+A3sg+Pnon+Nom
yönetimsel	yönetimsel+Adj
e	e+Noun+A3sg+Pnon+Nom
posta	posta+Noun+A3sg+Pnon+Nom
alternatif	alternatif+Noun+A3sg+Pnon+Nom
işletim	işletim+Noun+A3sg+Pnon+Nom
kök	kök+Noun+A3sg+Pnon+Nom
risk	risk+Noun+A3sg+Pnon+Nom
tünel	tünel+Noun+A3sg+Pnon+Nom
trafik	trafik+Noun+A3sg+Pnon+Nom
yöntem	yöntem+Noun+A3sg+Pnon+Nom
ilke	ilke+Noun+A3sg+Pnon+Nom
dinamik	dinamik+Adj
kesim	kesim+Noun+A3sg+Pnon+Nom
elektrik	elektrik+Noun+A3sg+Pnon+Nom
disk	disk+Noun+A3sg+Pnon+Nom
sürücü	sürücü+Noun+A3sg+Pnon+Nom
birincil	birincil+Adj
mantıksal	mantıksal+Adj
sertifika	sertifika+Noun+A3sg+Pnon+Nom
yönetim	yönetim+Noun+A3sg+Pnon+Nom
özne	özne+Noun+A3sg+Pnon+Nom
standart	standart+Adj
masraf	masraf+Noun+A3sg+Pnon+Nom
mekanizma	mekanizma+Noun+A3sg+Pnon+Nom
sezgisel	sezgisel+Adj
kapsam	kapsam+Noun+A3sg+Pnon+Nom
sanal	sanal+Adj
esnek	esnek+Adj
profil	profil+Noun+A3sg+Pnon+Nom
küme	küme+Noun+A3sg+Pnon+Nom
kullanım	kullanım+Noun+A3sg+Pnon+Nom
arabirim	arabirim+Noun+A3sg+Pnon+Nom
aygıt	aygıt+Noun+A3sg+Pnon+Nom
karma	karma+Adj
algoritma	algoritma+Noun+A3sg+Pnon+Nom
ileti	ileti+Noun+A3sg+Pnon+Nom
dolmuş	dolmuş+Noun+A3sg+Pnon+Nom
dijital	dijital+Adj
kuruluş	kuruluş+Noun+A3sg+Pnon+Nom
temsilci	temsilci+Noun+A3sg+Pnon+Nom
cscript	cscript+Noun+A3sg+Pnon+Nom
tırnak	tırnak+Noun+A3sg+Pnon+Nom
orman	orman+Noun+A3sg+Pnon+Nom
ipsec	ipsec+Noun+A3sg+Pnon+Nom
kapatma	kapatma+Noun+A3sg+Pnon+Nom
matematik	matematik+Noun+A3sg+Pnon+Nom
sayısal	sayısal+Adj
aritmetik	aritmetik+Adj
liste	liste+Noun+A3sg+Pnon+Nom
sınır	sınır+Noun+A3sg+Pnon+Nom
yoksaymak	yoksaymak+Noun+A3sg+Pnon+Nom
şov	şov+Noun+A3sg+Pnon+Nom
donanım	donanım+Noun+A3sg+Pnon+Nom
kapak	kapak+Noun+A3sg+Pnon+Nom
doc	doc+Noun+A3sg+Pnon+Nom
txt	txt+Noun+A3sg+Pnon+Nom
depo	depo+Noun+A3sg+Pnon+Nom
ilaveten	ilaveten+Postp+PCDat
içerik	içerik+Noun+A3sg+Pnon+Nom
zorunlu	zorunlu+Adj
hesabıyle	hesabıyle+Noun+A3sg+Pnon+Nom
ilişki	ilişki+Noun+A3sg+Pnon+Nom
denetim	denetim+Noun+A3sg+Pnon+Nom
boyut	boyut+Noun+A3sg+Pnon+Nom
faks	faks+Noun+A3sg+Pnon+Nom
teknoloji	teknoloji+Noun+A3sg+Pnon+Nom
güncel	güncel+Adj
basamak	basamak+Noun+A3sg+Pnon+Nom
imleç	imleç+Noun+A3sg+Pnon+Nom
itici	itici+Adj
ekran	ekran+Noun+A3sg+Pnon+Nom
monitör	monitör+Noun+A3sg+Pnon+Nom
slayt	slayt+Noun+A3sg+Pnon+Nom
görsel	görsel+Adj
karakter	karakter+Noun+A3sg+Pnon+Nom
park	park+Noun+A3sg+Pnon+Nom
salt	salt+Adverb
yetki	yetki+Noun+A3sg+Pnon+Nom
ağım	ağım+Noun+A3sg+Pnon+Nom
ayraç	ayraç+Noun+A3sg+Pnon+Nom
kısayol	kısayol+Noun+A3sg+Pnon+Nom
sihirbaz	sihirbaz+Noun+A3sg+Pnon+Nom
işlevsel	işlevsel+Adj
taşınmaz	taşınmaz+Noun+A3sg+Pnon+Nom
dil	dil+Noun+A3sg+Pnon+Nom
konum	konum+Noun+A3sg+Pnon+Nom
menü	menü+Noun+A3sg+Pnon+Nom
yaklaşım	yaklaşım+Noun+A3sg+Pnon+Nom
formül	formül+Noun+A3sg+Pnon+Nom
kopya	kopya+Noun+A3sg+Pnon+Nom
telefon	telefon+Noun+A3sg+Pnon+Nom
huni	huni+Noun+A3sg+Pnon+Nom
disket	disket+Noun+A3sg+Pnon+Nom
flash	flash+Noun+A3sg+Pnon+Nom
katılımcı	katılımcı+Noun+A3sg+Pnon+Nom
teknik	teknik+Adj
başvuru	başvuru+Noun+A3sg+Pnon+Nom
tasarruf	tasarruf+Noun+A3sg+Pnon+Nom
medya	medya+Noun+A3sg+Pnon+Nom
tasarımcı	tasarımcı+Noun+A3sg+Pnon+Nom
envanter	envanter+Noun+A3sg+Pnon+Nom
tenis	tenis+Noun+A3sg+Pnon+Nom
golf	golf+Noun+A3sg+Pnon+Nom
köprü	köprü+Noun+A3sg+Pnon+Nom
müşteri	müşteri+Noun+A3sg+Pnon+Nom
solucan	solucan+Noun+A3sg+Pnon+Nom
tif	tif+Noun+A3sg+Pnon+Nom
modem	modem+Noun+A3sg+Pnon+Nom
radyo	radyo+Noun+A3sg+Pnon+Nom
abone	abone+Noun+A3sg+Pnon+Nom
yatırım	yatırım+Noun+A3sg+Pnon+Nom
trigonometri	trigonometri+Noun+A3sg+Pnon+Nom
istatistik	istatistik+Noun+A3sg+Pnon+Nom
istatistiksel	istatistiksel+Adj
düz	düz+Adj
y	y+Noun+A3sg+Pnon+Nom
sıfır	sıfır+Noun+A3sg+Pnon+Nom
ortalama	ortalama+Adj
beta	beta+Noun+A3sg+Pnon+Nom
televizyon	televizyon+Noun+A3sg+Pnon+Nom
kod	kod+Noun+A3sg+Pnon+Nom
popülasyon	popülasyon+Noun+A3sg+Pnon+Nom
güvenirlik	güvenirlik+Noun+A3sg+Pnon+Nom
sipariş	sipariş+Noun+A3sg+Pnon+Nom
radyan	radyan+Noun+A3sg+Pnon+Nom
ülke	ülke+Noun+A3sg+Pnon+Nom
bölge	bölge+Noun+A3sg+Pnon+Nom
ambalaj	ambalaj+Noun+A3sg+Pnon+Nom
tamsayı	tamsayı+Noun+A3sg+Pnon+Nom
üs	üs+Noun+A3sg+Pnon+Nom
teyp	teyp+Noun+A3sg+Pnon+Nom
optik	optik+Noun+A3sg+Pnon+Nom
sayım	sayım+Noun+A3sg+Pnon+Nom
laboratuar	laboratuar+Noun+A3sg+Pnon+Nom
şube	şube+Noun+A3sg+Pnon+Nom
milisaniye	milisaniye+Noun+A3sg+Pnon+Nom
bellek	bellek+Noun+A3sg+Pnon+Nom
kilobayt	kilobayt+Noun+A3sg+Pnon+Nom
eşdeğer	eşdeğer+Adj
zorlama	zorlama+Adj
asimetrik	asimetrik+Adj
true	true+Noun+A3sg+Pnon+Nom
kota	kota+Noun+A3sg+Pnon+Nom
mikroişlemci	mikroişlemci+Noun+A3sg+Pnon+Nom
kesinti	kesinti+Noun+A3sg+Pnon+Nom
bildirim	bildirim+Noun+A3sg+Pnon+Nom
kurulum	kurulum+Noun+A3sg+Pnon+Nom
inf	inf+Noun+A3sg+Pnon+Nom
bant	bant+Noun+A3sg+Pnon+Nom
biçim	biçim+Noun+A3sg+Pnon+Nom
öncelik	öncelik+Noun+A3sg+Pnon+Nom
protokol	protokol+Noun+A3sg+Pnon+Nom
kanıt	kanıt+Noun+A3sg+Pnon+Nom
muaf	muaf+Adj
kısmi	kısmi+Adj
bilr	bilr+Noun+A3sg+Pnon+Nom
kapsüllemek	kapsüllemek+Noun+A3sg+Pnon+Nom
üstbilgi	üstbilgi+Noun+A3sg+Pnon+Nom
altyapı	altyapı+Noun+A3sg+Pnon+Nom
yorum	yorum+Noun+A3sg+Pnon+Nom
parti	parti+Noun+A3sg+Pnon+Nom
salise	salise+Noun+A3sg+Pnon+Nom
lisans	lisans+Noun+A3sg+Pnon+Nom
uzantı	uzantı+Noun+A3sg+Pnon+Nom
başlangıç	başlangıç+Noun+A3sg+Pnon+Nom
parametre	parametre+Noun+A3sg+Pnon+Nom
kaza	kaza+Noun+A3sg+Pnon+Nom
bit	bit+Noun+A3sg+Pnon+Nom
gezici	gezici+Adj
site	site+Noun+A3sg+Pnon+Nom
fatura	fatura+Noun+A3sg+Pnon+Nom
basın	basın+Noun+A3sg+Pnon+Nom
arabellek	arabellek+Noun+A3sg+Pnon+Nom
klavye	klavye+Noun+A3sg+Pnon+Nom
hacim	hacim+Noun+A3sg+Pnon+Nom
hasar	hasar+Noun+A3sg+Pnon+Nom
hiyerarşik	hiyerarşik+Adj
ölçüt	ölçüt+Noun+A3sg+Pnon+Nom
ayrıcalık	ayrıcalık+Noun+A3sg+Pnon+Nom
çeviri	çeviri+Noun+A3sg+Pnon+Nom
girişim	girişim+Noun+A3sg+Pnon+Nom
çoklu	çoklu+Adj
hiperbolik	hiperbolik+Adj
ardışık	ardışık+Adj
bakiye	bakiye+Noun+A3sg+Pnon+Nom
hurda	hurda+Adj
vbs	vbs+Noun+A3sg+Pnon+Nom
arşiv	arşiv+Noun+A3sg+Pnon+Nom
işlemsel	işlemsel+Adj
false	false+Noun+A3sg+Pnon+Nom
ataş	ataş+Noun+A3sg+Pnon+Nom
dolgu	dolgu+Noun+A3sg+Pnon+Nom
girinti	girinti+Noun+A3sg+Pnon+Nom
madde	madde+Noun+A3sg+Pnon+Nom
birkaçı	birkaçı+Pron+Quant+A3pl+P3pl+Nom
parantez	parantez+Noun+A3sg+Pnon+Nom
gözatmak	gözatmak+Noun+A3sg+Pnon+Nom
yayımcı	yayımcı+Noun+A3sg+Pnon+Nom
ünlem	ünlem+Noun+A3sg+Pnon+Nom
sınav	sınav+Noun+A3sg+Pnon+Nom
bd	bd+Noun+A3sg+Pnon+Nom
mevduat	mevduat+Noun+A3sg+Pnon+Nom
geometrik	geometrik+Adj
dağılım	dağılım+Noun+A3sg+Pnon+Nom
lognormal	lognormal+Noun+A3sg+Pnon+Nom
sapma	sapma+Noun+A3sg+Pnon+Nom
hipotez	hipotez+Noun+A3sg+Pnon+Nom
pmt	pmt+Noun+A3sg+Pnon+Nom
indirim	indirim+Noun+A3sg+Pnon+Nom
enflasyon	enflasyon+Noun+A3sg+Pnon+Nom
anapara	anapara+Noun+A3sg+Pnon+Nom
odak	odak+Noun+A3sg+Pnon+Nom
deneme	deneme+Noun+A3sg+Pnon+Nom
yönerge	yönerge+Noun+A3sg+Pnon+Nom
taban	taban+Noun+A3sg+Pnon+Nom
gd	gd+Noun+A3sg+Pnon+Nom
doğrusal	doğrusal+Adj
ölçer	ölçer+Noun+A3sg+Pnon+Nom
n	n+Noun+A3sg+Pnon+Nom
kartvizit	kartvizit+Noun+A3sg+Pnon+Nom
vcf	vcf+Noun+A3sg+Pnon+Nom
ics	ics+Noun+A3sg+Pnon+Nom
konur	konur+Adj
t	t+Noun+A3sg+Pnon+Nom
şifre	şifre+Noun+A3sg+Pnon+Nom
özgün	özgün+Adj
otonom	otonom+Adj
geribildirim	geribildirim+Noun+A3sg+Pnon+Nom
çizik	çizik+Adj
saklı	saklı+Adj
ekle	ekle+Verb+Pos+Imp+A2sg
çıkın	çıkın+Noun+A3sg+Pnon+Nom
joker	joker+Noun+A3sg+Pnon+Nom
film	film+Noun+A3sg+Pnon+Nom
albüm	albüm+Noun+A3sg+Pnon+Nom
kasa	kasa+Noun+A3sg+Pnon+Nom
basılı	basılı+Adj
paragraf	paragraf+Noun+A3sg+Pnon+Nom
anket	anket+Noun+A3sg+Pnon+Nom
alfabetik	alfabetik+Adj
fonksiyon	fonksiyon+Noun+A3sg+Pnon+Nom
depozito	depozito+Noun+A3sg+Pnon+Nom
cari	cari+Adj
tasarım	tasarım+Noun+A3sg+Pnon+Nom
muhasebe	muhasebe+Noun+A3sg+Pnon+Nom
hisse	hisse+Noun+A3sg+Pnon+Nom
dikte	dikte+Noun+A3sg+Pnon+Nom
hoparlör	hoparlör+Noun+A3sg+Pnon+Nom
mikrofon	mikrofon+Noun+A3sg+Pnon+Nom
that	that+Noun+A3sg+Pnon+Nom
imza	imza+Noun+A3sg+Pnon+Nom
çubuk	çubuk+Noun+A3sg+Pnon+Nom
dikdörtgen	dikdörtgen+Noun+A3sg+Pnon+Nom
denge	denge+Noun+A3sg+Pnon+Nom
silgi	silgi+Noun+A3sg+Pnon+Nom
işyeri	işyeri+Noun+A3sg+P3sg+Nom
tablet	tablet+Noun+A3sg+Pnon+Nom
paylaşım	paylaşım+Noun+A3sg+Pnon+Nom
saldırı	saldırı+Noun+A3sg+Pnon+Nom
işlemci	işlemci+Noun+A3sg+Pnon+Nom
zarf	zarf+Noun+A3sg+Pnon+Nom
başvur	başvur+Verb+Pos+Imp+A2sg
tekil	tekil+Adj
ipucu	ipucu+Noun+A3sg+P3sg+Nom
gösterge	gösterge+Noun+A3sg+Pnon+Nom
form	form+Noun+A3sg+Pnon+Nom
garanti	garanti+Noun+A3sg+Pnon+Nom
yaklayabilir	yaklayabilir+Noun+A3sg+Pnon+Nom
mobil	mobil+Adj
pil	pil+Noun+A3sg+Pnon+Nom
şarj	şarj+Noun+A3sg+Pnon+Nom
enerji	enerji+Noun+A3sg+Pnon+Nom
pili	pili+Noun+A3sg+Pnon+Nom
dönüşüm	dönüşüm+Noun+A3sg+Pnon+Nom
atık	atık+Adj
projektör	projektör+Noun+A3sg+Pnon+Nom
sunu	sunu+Noun+A3sg+Pnon+Nom
konferans	konferans+Noun+A3sg+Pnon+Nom
koru	koru+Noun+A3sg+Pnon+Nom
uç	uç+Noun+A3sg+Pnon+Nom
daire	daire+Noun+A3sg+Pnon+Nom
kurşun	kurşun+Noun+A3sg+Pnon+Nom
kalem	kalem+Noun+A3sg+Pnon+Nom
çizelge	çizelge+Noun+A3sg+Pnon+Nom
detay	detay+Noun+A3sg+Pnon+Nom
uygula	uygula+Verb+Pos+Imp+A2sg
piksel	piksel+Noun+A3sg+Pnon+Nom
stil	stil+Noun+A3sg+Pnon+Nom
nötr	nötr+Adj
puan	puan+Noun+A3sg+Pnon+Nom
altyazı	altyazı+Noun+A3sg+Pnon+Nom
personel	personel+Noun+A3sg+Pnon+Nom
special	special+Noun+A3sg+Pnon+Nom
statik	statik+Adj
vezir	vezir+Noun+A3sg+Pnon+Nom
kale	kale+Noun+A3sg+Pnon+Nom
terfi	terfi+Noun+A3sg+Pnon+Nom
stratejik	stratejik+Adj
etkileşim	etkileşim+Noun+A3sg+Pnon+Nom
önlem	önlem+Noun+A3sg+Pnon+Nom
oyuncu	oyuncu+Noun+A3sg+Pnon+Nom
mayın	mayın+Noun+A3sg+Pnon+Nom
kalite	kalite+Noun+A3sg+Pnon+Nom
mor	mor+Adj
önizleme	önizleme+Noun+A3sg+Pnon+Nom
meta	meta+Noun+A3sg+Pnon+Nom
eksen	eksen+Noun+A3sg+Pnon+Nom
çizim	çizim+Noun+A3sg+Pnon+Nom
ölçü	ölçü+Noun+A3sg+Pnon+Nom
kredi	kredi+Noun+A3sg+Pnon+Nom
mali	mali+Adj
gözatmas	gözatmas+Noun+A3sg+Pnon+Nom
intranet	intranet+Noun+A3sg+Pnon+Nom
ayrım	ayrım+Noun+A3sg+Pnon+Nom
amortisman	amortisman+Noun+A3sg+Pnon+Nom
amorti	amorti+Noun+A3sg+Pnon+Nom
flaş	flaş+Noun+A3sg+Pnon+Nom
defter	defter+Noun+A3sg+Pnon+Nom
tuş	tuş+Noun+A3sg+Pnon+Nom
geleneksel	geleneksel+Adj
dahili	dahili+Adj
nispeten	nispeten+Adverb
mezuniyet	mezuniyet+Noun+A3sg+Pnon+Nom
kategorize	kategorize+Adj
animasyon	animasyon+Noun+A3sg+Pnon+Nom
birleşik	birleşik+Noun+A3sg+Pnon+Nom
kümülatif	kümülatif+Adj
virgül	virgül+Noun+A3sg+Pnon+Nom
jpg	jpg+Noun+A3sg+Pnon+Nom
gif	gif+Noun+A3sg+Pnon+Nom
png	png+Noun+A3sg+Pnon+Nom
makro	makro+Noun+A3sg+Pnon+Nom
eklenti	eklenti+Noun+A3sg+Pnon+Nom
csv	csv+Noun+A3sg+Pnon+Nom
kabuk	kabuk+Noun+A3sg+Pnon+Nom
kuyruk	kuyruk+Noun+A3sg+Pnon+Nom
saydam	saydam+Adj
strateji	strateji+Noun+A3sg+Pnon+Nom
şablon	şablon+Noun+A3sg+Pnon+Nom
kullan	kullan+Verb+Pos+Imp+A2sg
mount	mount+Noun+A3sg+Pnon+Nom
saldırgan	saldırgan+Noun+A3sg+Pnon+Nom
tutucu	tutucu+Adj
kılavuz	kılavuz+Noun+A3sg+Pnon+Nom
bayt	bayt+Noun+A3sg+Pnon+Nom
bağıntı	bağıntı+Noun+A3sg+Pnon+Nom
yayın	yayın+Noun+A3sg+Pnon+Nom
örtük	örtük+Adj
asal	asal+Adj
devir	devir+Noun+A3sg+Pnon+Nom
ins	ins+Noun+A3sg+Pnon+Nom
senaryo	senaryo+Noun+A3sg+Pnon+Nom
keser	keser+Noun+A3sg+Pnon+Nom
mod	mod+Noun+A3sg+Pnon+Nom
uzman	uzman+Noun+A3sg+Pnon+Nom
satıcı	satıcı+Noun+A3sg+Pnon+Nom
servis	servis+Noun+A3sg+Pnon+Nom
üretim	üretim+Noun+A3sg+Pnon+Nom
ticaret	ticaret+Noun+A3sg+Pnon+Nom
önbellek	önbellek+Noun+A3sg+Pnon+Nom
döngü	döngü+Noun+A3sg+Pnon+Nom
arşivci	arşivci+Noun+A3sg+Pnon+Nom
gözat	gözat+Noun+A3sg+Pnon+Nom
üçgen	üçgen+Noun+A3sg+Pnon+Nom
yoksayılır	yoksayılır+Noun+A3sg+Pnon+Nom
kızılötesi	kızılötesi+Noun+A3sg+P3sg+Nom
tümleşik	tümleşik+Adj
fok	fok+Noun+A3sg+Pnon+Nom
set	set+Noun+A3sg+Pnon+Nom
avcı	avcı+Noun+A3sg+Pnon+Nom
protesto	protesto+Noun+A3sg+Pnon+Nom
temas	temas+Noun+A3sg+Pnon+Nom
dava	dava+Noun+A3sg+Pnon+Nom
lirik	lirik+Noun+A3sg+Pnon+Nom
isyan	isyan+Noun+A3sg+Pnon+Nom
internet	internet+Noun+A3sg+Pnon+Nom
tango	tango+Noun+A3sg+Pnon+Nom
katliam	katliam+Noun+A3sg+Pnon+Nom
boykot	boykot+Noun+A3sg+Pnon+Nom
sivil	sivil+Noun+A3sg+Pnon+Nom
toplum	toplum+Noun+A3sg+Pnon+Nom
demokratik	demokratik+Adj
hasat	hasat+Noun+A3sg+Pnon+Nom
ihlal	ihlal+Noun+A3sg+Pnon+Nom
protestocu	protestocu+Noun+A3sg+Pnon+Nom
propaganda	propaganda+Noun+A3sg+Pnon+Nom
bağış	bağış+Noun+A3sg+Pnon+Nom
rekor	rekor+Noun+A3sg+Pnon+Nom
kırsal	kırsal+Adj
perde	perde+Noun+A3sg+Pnon+Nom
ihracat	ihracat+Noun+A3sg+Pnon+Nom
lokanta	lokanta+Noun+A3sg+Pnon+Nom
reklam	reklam+Noun+A3sg+Pnon+Nom
vahim	vahim+Adj
eylemci	eylemci+Noun+A3sg+Pnon+Nom
balina	balina+Noun+A3sg+Pnon+Nom
isabet	isabet+Noun+A3sg+Pnon+Nom
özürlü	özürlü+Adj
gezi	gezi+Noun+A3sg+Pnon+Nom
talep	talep+Noun+A3sg+Pnon+Nom
amatör	amatör+Adj
malum	malum+Noun+A3sg+Pnon+Nom
found	found+Noun+A3sg+Pnon+Nom
my	my+Noun+A3sg+Pnon+Nom
love	love+Noun+A3sg+Pnon+Nom
çeltik	çeltik+Noun+A3sg+Pnon+Nom
gürül	gürül+Dup
turkuvaz	turkuvaz+Noun+A3sg+Pnon+Nom
vişneçürüğü	vişneçürüğü+Noun+A3sg+P3sg+Nom
fesleğen	fesleğen+Noun+A3sg+Pnon+Nom
samısak	samısak+Noun+A3sg+Pnon+Nom
zeytinyağı	zeytinyağı+Noun+A3sg+P3sg+Nom
müzisyen	müzisyen+Noun+A3sg+Pnon+Nom
pesto	pesto+Noun+A3sg+Pnon+Nom
fıstık	fıstık+Noun+A3sg+Pnon+Nom
sarmısak	sarmısak+Noun+A3sg+Pnon+Nom
karabiber	karabiber+Noun+A3sg+Pnon+Nom
patlıcan	patlıcan+Noun+A3sg+Pnon+Nom
rakle	rakle+Noun+A3sg+Pnon+Nom
rende	rende+Noun+A3sg+Pnon+Nom
domates	domates+Noun+A3sg+Pnon+Nom
klakson	klakson+Noun+A3sg+Pnon+Nom
romancı	romancı+Noun+A3sg+Pnon+Nom
kuşkonmaz	kuşkonmaz+Noun+A3sg+Pnon+Nom
rizotto	rizotto+Noun+A3sg+Pnon+Nom
meyve	meyve+Noun+A3sg+Pnon+Nom
armanyak	armanyak+Noun+A3sg+Pnon+Nom
zirve	zirve+Noun+A3sg+Pnon+Nom
doğa	doğa+Noun+A3sg+Pnon+Nom
buzul	buzul+Noun+A3sg+Pnon+Nom
elverişsiz	elverişsiz+Adj
tedavi	tedavi+Noun+A3sg+Pnon+Nom
taburcu	taburcu+Adj
rehber	rehber+Noun+A3sg+Pnon+Nom
ant	ant+Noun+A3sg+Pnon+Nom
perşembe	perşembe+Noun+A3sg+Pnon+Nom
dağcı	dağcı+Noun+A3sg+Pnon+Nom
ekip	ekip+Noun+A3sg+Pnon+Nom
öğretmen	öğretmen+Noun+A3sg+Pnon+Nom
kala	kala+Postp+PCNom
şerpa	şerpa+Noun+A3sg+Pnon+Nom
zatürree	zatürree+Noun+A3sg+Pnon+Nom
akut	akut+Adj
güney	güney+Noun+A3sg+Pnon+Nom
turist	turist+Noun+A3sg+Pnon+Nom
popüler	popüler+Adj
tatil	tatil+Noun+A3sg+Pnon+Nom
maske	maske+Noun+A3sg+Pnon+Nom
hapis	hapis+Noun+A3sg+Pnon+Nom
gerekçe	gerekçe+Noun+A3sg+Pnon+Nom
şöhret	şöhret+Noun+A3sg+Pnon+Nom
ekonomi	ekonomi+Noun+A3sg+Pnon+Nom
yapı	yapı+Noun+A3sg+Pnon+Nom
tesadüfen	tesadüfen+Adverb
süper	süper+Noun+A3sg+Pnon+Nom
ajans	ajans+Noun+A3sg+Pnon+Nom
kaş	kaş+Noun+A3sg+Pnon+Nom
erkeksi	erkeksi+Adj
çete	çete+Noun+A3sg+Pnon+Nom
fedakar	fedakar+Adj
abla	abla+Noun+A3sg+Pnon+Nom
göçmen	göçmen+Noun+A3sg+Pnon+Nom
sinema	sinema+Noun+A3sg+Pnon+Nom
tipik	tipik+Adj
müze	müze+Noun+A3sg+Pnon+Nom
bangır	bangır+Noun+A3sg+Pnon+Nom
halay	halay+Noun+A3sg+Pnon+Nom
mikro	mikro+Adj
lahmacun	lahmacun+Noun+A3sg+Pnon+Nom
taşıt	taşıt+Noun+A3sg+Pnon+Nom
benzin	benzin+Noun+A3sg+Pnon+Nom
akaryakıt	akaryakıt+Noun+A3sg+Pnon+Nom
kuzey	kuzey+Noun+A3sg+Pnon+Nom
direksiyon	direksiyon+Noun+A3sg+Pnon+Nom
fren	fren+Noun+A3sg+Pnon+Nom
seyir	seyir+Noun+A3sg+Pnon+Nom
kamera	kamera+Noun+A3sg+Pnon+Nom
otobüs	otobüs+Noun+A3sg+Pnon+Nom
takograf	takograf+Noun+A3sg+Pnon+Nom
geceyarısı	geceyarısı+Noun+A3sg+P3sg+Nom
otel	otel+Noun+A3sg+Pnon+Nom
motel	motel+Noun+A3sg+Pnon+Nom
yasa	yasa+Noun+A3sg+Pnon+Nom
sevimsiz	sevimsiz+Adj
fıkra	fıkra+Noun+A3sg+Pnon+Nom
şirin	şirin+Adj
adamcağız	adamcağız+Noun+A3sg+Pnon+Nom
mail	mail+Noun+A3sg+Pnon+Nom
sığırcık	sığırcık+Noun+A3sg+Pnon+Nom
buzdolabı	buzdolabı+Noun+A3sg+P3sg+Nom
çimento	çimento+Noun+A3sg+Pnon+Nom
buğday	buğday+Noun+A3sg+Pnon+Nom
komünist	komünist+Noun+A3sg+Pnon+Nom
kanunen	kanunen+Adverb
tedavül	tedavül+Noun+A3sg+Pnon+Nom
mukannen	mukannen+Adj
imtina	imtina+Noun+A3sg+Pnon+Nom
terörist	terörist+Noun+A3sg+Pnon+Nom
derman	derman+Noun+A3sg+Pnon+Nom
alışveriş	alışveriş+Noun+A3sg+Pnon+Nom
ciro	ciro+Noun+A3sg+Pnon+Nom
komşu	komşu+Noun+A3sg+Pnon+Nom
müslüman	müslüman+Adj
hassasiyet	hassasiyet+Noun+A3sg+Pnon+Nom
vize	vize+Noun+A3sg+Pnon+Nom
turizm	turizm+Noun+A3sg+Pnon+Nom
laik	laik+Adj
tanıtım	tanıtım+Noun+A3sg+Pnon+Nom
modacı	modacı+Noun+A3sg+Pnon+Nom
ideal	ideal+Noun+A3sg+Pnon+Nom
fuar	fuar+Noun+A3sg+Pnon+Nom
kültürel	kültürel+Adj
coğrafya	coğrafya+Noun+A3sg+Pnon+Nom
stand	stand+Noun+A3sg+Pnon+Nom
şifa	şifa+Noun+A3sg+Pnon+Nom
gözde	gözde+Adj
otopark	otopark+Noun+A3sg+Pnon+Nom
euro	euro+Noun+A3sg+Pnon+Nom
havalimanı	havalimanı+Noun+A3sg+P3sg+Nom
fiyat	fiyat+Noun+A3sg+Pnon+Nom
taksi	taksi+Noun+A3sg+Pnon+Nom
havaalanı	havaalanı+Noun+A3sg+P3sg+Nom
ihale	ihale+Noun+A3sg+Pnon+Nom
hpark	hpark+Noun+A3sg+Pnon+Nom
proje	proje+Noun+A3sg+Pnon+Nom
fiyasko	fiyasko+Noun+A3sg+Pnon+Nom
fay	fay+Noun+A3sg+Pnon+Nom
taahhüt	taahhüt+Noun+A3sg+Pnon+Nom
soft	soft+Noun+A3sg+Pnon+Nom
finanse	finanse+Noun+A3sg+Pnon+Nom
kasım	kasım+Noun+A3sg+Pnon+Nom
görüşme	görüşme+Noun+A3sg+Pnon+Nom
tıs	tıs+Noun+A3sg+Pnon+Nom
geçenlerde	geçenlerde+Adverb
ilave	ilave+Noun+A3sg+Pnon+Nom
of	of+Interj
tekstil	tekstil+Noun+A3sg+Pnon+Nom
sektör	sektör+Noun+A3sg+Pnon+Nom
ciklet	ciklet+Noun+A3sg+Pnon+Nom
mekan	mekan+Noun+A3sg+Pnon+Nom
saksafon	saksafon+Noun+A3sg+Pnon+Nom
müzayede	müzayede+Noun+A3sg+Pnon+Nom
padişah	padişah+Noun+A3sg+Pnon+Nom
broş	broş+Noun+A3sg+Pnon+Nom
yılbaşı	yılbaşı+Noun+A3sg+P3sg+Nom
ortaklaşa	ortaklaşa+Adverb
konsolos	konsolos+Noun+A3sg+Pnon+Nom
hazırlık	hazırlık+Noun+A3sg+Pnon+Nom
fahri	fahri+Adj
ritm	ritm+Noun+A3sg+Pnon+Nom
ulusal	ulusal+Adj
marketing	marketing+Noun+A3sg+Pnon+Nom
sonuncu	sonuncu+Adj
adil	adil+Adj
oran	oran+Noun+A3sg+Pnon+Nom
kurum	kurum+Noun+A3sg+Pnon+Nom
laborant	laborant+Noun+A3sg+Pnon+Nom
rehin	rehin+Noun+A3sg+Pnon+Nom
akın	akın+Noun+A3sg+Pnon+Nom
zanlı	zanlı+Adj
şans	şans+Noun+A3sg+Pnon+Nom
rehine	rehine+Noun+A3sg+Pnon+Nom
meme	meme+Noun+A3sg+Pnon+Nom
mm	mm+Noun+A3sg+Pnon+Nom
koltuk	koltuk+Noun+A3sg+Pnon+Nom
anaokulu	anaokulu+Noun+A3sg+P3sg+Nom
ilköğretim	ilköğretim+Noun+A3sg+Pnon+Nom
lise	lise+Noun+A3sg+Pnon+Nom
kargaşa	kargaşa+Noun+A3sg+Pnon+Nom
sulh	sulh+Noun+A3sg+Pnon+Nom
gazeteci	gazeteci+Noun+A3sg+Pnon+Nom
menzil	menzil+Noun+A3sg+Pnon+Nom
finans	finans+Noun+A3sg+Pnon+Nom
olumsuz	olumsuz+Adj
rezervasyon	rezervasyon+Noun+A3sg+Pnon+Nom
kapasite	kapasite+Noun+A3sg+Pnon+Nom
sendikasyon	sendikasyon+Noun+A3sg+Pnon+Nom
politik	politik+Adj
çalkantı	çalkantı+Noun+A3sg+Pnon+Nom
ikiyüzlü	ikiyüzlü+Adj
sendika	sendika+Noun+A3sg+Pnon+Nom
kulis	kulis+Noun+A3sg+Pnon+Nom
birlik	birlik+Noun+A3sg+Pnon+Nom
vesile	vesile+Noun+A3sg+Pnon+Nom
müteahhit	müteahhit+Noun+A3sg+Pnon+Nom
iskan	iskan+Noun+A3sg+Pnon+Nom
hibe	hibe+Noun+A3sg+Pnon+Nom
ton	ton+Noun+A3sg+Pnon+Nom
mafya	mafya+Noun+A3sg+Pnon+Nom
hükümet	hükümet+Noun+A3sg+Pnon+Nom
rüşvet	rüşvet+Noun+A3sg+Pnon+Nom
haziran	haziran+Noun+A3sg+Pnon+Nom
temmuz	temmuz+Noun+A3sg+Pnon+Nom
baskın	baskın+Noun+A3sg+Pnon+Nom
pirinç	pirinç+Noun+A3sg+Pnon+Nom
bedava	bedava+Adj
çuval	çuval+Noun+A3sg+Pnon+Nom
firma	firma+Noun+A3sg+Pnon+Nom
rutubet	rutubet+Noun+A3sg+Pnon+Nom
çarkçıbaşı	çarkçıbaşı+Noun+A3sg+Pnon+Nom
mukavemet	mukavemet+Noun+A3sg+Pnon+Nom
acente	acente+Noun+A3sg+Pnon+Nom
alelacele	alelacele+Adverb
uyduruk	uyduruk+Adj
kaynakçı	kaynakçı+Noun+A3sg+Pnon+Nom
kilometrekare	kilometrekare+Noun+A3sg+Pnon+Nom
ekvator	ekvator+Noun+A3sg+Pnon+Nom
ihtilal	ihtilal+Noun+A3sg+Pnon+Nom
astsubay	astsubay+Noun+A3sg+Pnon+Nom
konsey	konsey+Noun+A3sg+Pnon+Nom
ordu	ordu+Noun+A3sg+Pnon+Nom
kilo	kilo+Noun+A3sg+Pnon+Nom
kene	kene+Noun+A3sg+Pnon+Nom
inşaat	inşaat+Noun+A3sg+Pnon+Nom
deprem	deprem+Noun+A3sg+Pnon+Nom
meclis	meclis+Noun+A3sg+Pnon+Nom
zam	zam+Noun+A3sg+Pnon+Nom
göçük	göçük+Noun+A3sg+Pnon+Nom
konut	konut+Noun+A3sg+Pnon+Nom
işmerkezi	işmerkezi+Noun+A3sg+P3sg+Nom
yıllarca	yıllarca+Adverb
merhum	merhum+Noun+A3sg+Pnon+Nom
müfettiş	müfettiş+Noun+A3sg+Pnon+Nom
bozguncu	bozguncu+Noun+A3sg+Pnon+Nom
usulen	usulen+Adverb
rüçhan	rüçhan+Noun+A3sg+Pnon+Nom
çoğunluk	çoğunluk+Noun+A3sg+Pnon+Nom
tuvale	tuvale+Noun+A3sg+Pnon+Nom
siyasetçi	siyasetçi+Noun+A3sg+Pnon+Nom
sanatsever	sanatsever+Adj
antik	antik+Adj
çöp	çöp+Noun+A3sg+Pnon+Nom
yılsonu	yılsonu+Noun+A3sg+Pnon+Nom
hasret	hasret+Noun+A3sg+Pnon+Nom
şeffaf	şeffaf+Adj
tatbik	tatbik+Noun+A3sg+Pnon+Nom
kamuoyu	kamuoyu+Noun+A3sg+P3sg+Nom
müzakere	müzakere+Noun+A3sg+Pnon+Nom
beddua	beddua+Noun+A3sg+Pnon+Nom
peşkeş	peşkeş+Noun+A3sg+Pnon+Nom
bankacı	bankacı+Noun+A3sg+Pnon+Nom
göl	göl+Noun+A3sg+Pnon+Nom
bilimsel	bilimsel+Adj
sanayi	sanayi+Noun+A3sg+Pnon+Nom
ithalat	ithalat+Noun+A3sg+Pnon+Nom
filan	filan+Adj
züğürt	züğürt+Noun+A3sg+Pnon+Nom
cimri	cimri+Adj
rakı	rakı+Noun+A3sg+Pnon+Nom
tıklım	tıklım+Dup
kalamar	kalamar+Noun+A3sg+Pnon+Nom
ızgara	ızgara+Noun+A3sg+Pnon+Nom
soğan	soğan+Noun+A3sg+Pnon+Nom
çiğ	çiğ+Adj
fasulye	fasulye+Noun+A3sg+Pnon+Nom
turistik	turistik+Adj
tahsis	tahsis+Noun+A3sg+Pnon+Nom
tesis	tesis+Noun+A3sg+Pnon+Nom
mark	mark+Noun+A3sg+Pnon+Nom
izah	izah+Noun+A3sg+Pnon+Nom
siyaset	siyaset+Noun+A3sg+Pnon+Nom
dinci	dinci+Noun+A3sg+Pnon+Nom
partizan	partizan+Noun+A3sg+Pnon+Nom
öneri	öneri+Noun+A3sg+Pnon+Nom
gıda	gıda+Noun+A3sg+Pnon+Nom
müsteşar	müsteşar+Noun+A3sg+Pnon+Nom
dayanışma	dayanışma+Noun+A3sg+Pnon+Nom
km	km+Noun+A3sg+Pnon+Nom
parlamento	parlamento+Noun+A3sg+Pnon+Nom
donnnn	donnnn+Noun+A3sg+Pnon+Nom
dank	dank+Noun+A3sg+Pnon+Nom
dankkk	dankkk+Noun+A3sg+Pnon+Nom
ciztakkk	ciztakkk+Noun+A3sg+Pnon+Nom
yerli	yerli+Adj
amir	amir+Noun+A3sg+Pnon+Nom
işletme	işletme+Noun+A3sg+Pnon+Nom
çevre	çevre+Noun+A3sg+Pnon+Nom
gasp	gasp+Noun+A3sg+Pnon+Nom
senfoni	senfoni+Noun+A3sg+Pnon+Nom
armoni	armoni+Noun+A3sg+Pnon+Nom
koordinasyon	koordinasyon+Noun+A3sg+Pnon+Nom
tercüme	tercüme+Noun+A3sg+Pnon+Nom
klasik	klasik+Adj
çağdaş	çağdaş+Adj
mutabakat	mutabakat+Noun+A3sg+Pnon+Nom
çığır	çığır+Noun+A3sg+Pnon+Nom
devrim	devrim+Noun+A3sg+Pnon+Nom
süreç	süreç+Noun+A3sg+Pnon+Nom
yerleşim	yerleşim+Noun+A3sg+Pnon+Nom
imar	imar+Noun+A3sg+Pnon+Nom
başkanlık	başkanlık+Noun+A3sg+Pnon+Nom
jest	jest+Noun+A3sg+Pnon+Nom
toplusözleşme	toplusözleşme+Noun+A3sg+Pnon+Nom
uçurum	uçurum+Noun+A3sg+Pnon+Nom
bonkör	bonkör+Adj
komisyon	komisyon+Noun+A3sg+Pnon+Nom
noter	noter+Noun+A3sg+Pnon+Nom
mendirek	mendirek+Noun+A3sg+Pnon+Nom
konsorsiyum	konsorsiyum+Noun+A3sg+Pnon+Nom
cin	cin+Noun+A3sg+Pnon+Nom
stard	stard+Noun+A3sg+Pnon+Nom
kruvaziyer	kruvaziyer+Noun+A3sg+Pnon+Nom
kongre	kongre+Noun+A3sg+Pnon+Nom
pilot	pilot+Noun+A3sg+Pnon+Nom
ithal	ithal+Noun+A3sg+Pnon+Nom
teminat	teminat+Noun+A3sg+Pnon+Nom
mevzuat	mevzuat+Noun+A3sg+Pnon+Nom
fiş	fiş+Noun+A3sg+Pnon+Nom
istinaden	istinaden+Postp+PCDat
tanzim	tanzim+Noun+A3sg+Pnon+Nom
ulus	ulus+Noun+A3sg+Pnon+Nom
fırla	fırla+Verb+Pos+Imp+A2sg
salgın	salgın+Noun+A3sg+Pnon+Nom
tahliye	tahliye+Noun+A3sg+Pnon+Nom
başkent	başkent+Noun+A3sg+Pnon+Nom
dalgıç	dalgıç+Noun+A3sg+Pnon+Nom
kauçuk	kauçuk+Noun+A3sg+Pnon+Nom
bulut	bulut+Noun+A3sg+Pnon+Nom
ceset	ceset+Noun+A3sg+Pnon+Nom
ampul	ampul+Noun+A3sg+Pnon+Nom
kaval	kaval+Noun+A3sg+Pnon+Nom
omurga	omurga+Noun+A3sg+Pnon+Nom
hızar	hızar+Noun+A3sg+Pnon+Nom
teşhis	teşhis+Noun+A3sg+Pnon+Nom
bungalov	bungalov+Noun+A3sg+Pnon+Nom
mesaj	mesaj+Noun+A3sg+Pnon+Nom
gezgin	gezgin+Noun+A3sg+Pnon+Nom
gümrük	gümrük+Noun+A3sg+Pnon+Nom
yanısıra	yanısıra+Postp+PCGen
sağcı	sağcı+Noun+A3sg+Pnon+Nom
lider	lider+Noun+A3sg+Pnon+Nom
konser	konser+Noun+A3sg+Pnon+Nom
mahşer	mahşer+Noun+A3sg+Pnon+Nom
fenomen	fenomen+Noun+A3sg+Pnon+Nom
konvoy	konvoy+Noun+A3sg+Pnon+Nom
şampiyon	şampiyon+Noun+A3sg+Pnon+Nom
fanatik	fanatik+Adj
tempo	tempo+Noun+A3sg+Pnon+Nom
salon	salon+Noun+A3sg+Pnon+Nom
firar	firar+Noun+A3sg+Pnon+Nom
bertaraf	bertaraf+Adverb
flama	flama+Noun+A3sg+Pnon+Nom
apar	apar+Adj
topar	topar+Dup
zeybreak	zeybreak+Noun+A3sg+Pnon+Nom
saz	saz+Noun+A3sg+Pnon+Nom
tim	tim+Noun+A3sg+Pnon+Nom
çevirmen	çevirmen+Noun+A3sg+Pnon+Nom
ziyaretçi	ziyaretçi+Noun+A3sg+Pnon+Nom
uçak	uçak+Noun+A3sg+Pnon+Nom
taşra	taşra+Noun+A3sg+Pnon+Nom
orijinal	orijinal+Adj
astım	astım+Noun+A3sg+Pnon+Nom
maslahatgüzar	maslahatgüzar+Noun+A3sg+Pnon+Nom
menemen	menemen+Noun+A3sg+Pnon+Nom
döküntü	döküntü+Noun+A3sg+Pnon+Nom
esnaf	esnaf+Noun+A3sg+Pnon+Nom
tropikal	tropikal+Noun+A3sg+Pnon+Nom
naylon	naylon+Noun+A3sg+Pnon+Nom
birkez	birkez+Noun+A3sg+Pnon+Nom
kıs	kıs+Verb+Pos+Imp+A2sg
eko	eko+Noun+A3sg+Pnon+Nom
tarhana	tarhana+Noun+A3sg+Pnon+Nom
ırmak	ırmak+Noun+A3sg+Pnon+Nom
terapi	terapi+Noun+A3sg+Pnon+Nom
huş	huş+Noun+A3sg+Pnon+Nom
organizasyon	organizasyon+Noun+A3sg+Pnon+Nom
pay	pay+Noun+A3sg+Pnon+Nom
müteşebbis	müteşebbis+Adj
ihraç	ihraç+Noun+A3sg+Pnon+Nom
perakende	perakende+Adj
kanserojen	kanserojen+Adj
maksimum	maksimum+Noun+A3sg+Pnon+Nom
iktidar	iktidar+Noun+A3sg+Pnon+Nom
batık	batık+Adj
off	off+Noun+A3sg+Pnon+Nom
tonton	tonton+Noun+A3sg+Pnon+Nom
yumuşacık	yumuşacık+Adj
amca	amca+Noun+A3sg+Pnon+Nom
makam	makam+Noun+A3sg+Pnon+Nom
boğaz	boğaz+Noun+A3sg+Pnon+Nom
sebebiyet	sebebiyet+Noun+A3sg+Pnon+Nom
onlarca	onlarca+Num+Card
öngörü	öngörü+Noun+A3sg+Pnon+Nom
meteorolog	meteorolog+Noun+A3sg+Pnon+Nom
atmosferik	atmosferik+Adj
tansiyon	tansiyon+Noun+A3sg+Pnon+Nom
oksijen	oksijen+Noun+A3sg+Pnon+Nom
kanyon	kanyon+Noun+A3sg+Pnon+Nom
diyabet	diyabet+Noun+A3sg+Pnon+Nom
problem	problem+Noun+A3sg+Pnon+Nom
idrar	idrar+Noun+A3sg+Pnon+Nom
enfeksiyon	enfeksiyon+Noun+A3sg+Pnon+Nom
rutin	rutin+Adj
güzergah	güzergah+Noun+A3sg+Pnon+Nom
insülin	insülin+Noun+A3sg+Pnon+Nom
ulaşım	ulaşım+Noun+A3sg+Pnon+Nom
elektrolit	elektrolit+Noun+A3sg+Pnon+Nom
ölçüm	ölçüm+Noun+A3sg+Pnon+Nom
cami	cami+Noun+A3sg+Pnon+Nom
medrese	medrese+Noun+A3sg+Pnon+Nom
nane	nane+Noun+A3sg+Pnon+Nom
çarşı	çarşı+Noun+A3sg+Pnon+Nom
nargile	nargile+Noun+A3sg+Pnon+Nom
baklava	baklava+Noun+A3sg+Pnon+Nom
wa	wa+Noun+A3sg+Pnon+Nom
durak	durak+Noun+A3sg+Pnon+Nom
sikke	sikke+Noun+A3sg+Pnon+Nom
gar	gar+Noun+A3sg+Pnon+Nom
mozaik	mozaik+Noun+A3sg+Pnon+Nom
kabak	kabak+Noun+A3sg+Pnon+Nom
turunç	turunç+Noun+A3sg+Pnon+Nom
kayak	kayak+Noun+A3sg+Pnon+Nom
günübirlik	günübirlik+Adverb
manyetik	manyetik+Adj
baby	baby+Noun+A3sg+Pnon+Nom
snowboard	snowboard+Noun+A3sg+Pnon+Nom
trekking	trekking+Noun+A3sg+Pnon+Nom
alakart	alakart+Adj
tabldot	tabldot+Noun+A3sg+Pnon+Nom
barbekü	barbekü+Noun+A3sg+Pnon+Nom
hoca	hoca+Noun+A3sg+Pnon+Nom
rafting	rafting+Noun+A3sg+Pnon+Nom
peri	peri+Noun+A3sg+Pnon+Nom
stabilize	stabilize+Adj
kavak	kavak+Noun+A3sg+Pnon+Nom
yıkım	yıkım+Noun+A3sg+Pnon+Nom
bel	bel+Noun+A3sg+Pnon+Nom
anlayış	anlayış+Noun+A3sg+Pnon+Nom
mesai	mesai+Noun+A3sg+Pnon+Nom
danış	danış+Noun+A3sg+Pnon+Nom
zihniyet	zihniyet+Noun+A3sg+Pnon+Nom
hendek	hendek+Noun+A3sg+Pnon+Nom
gündoğumu	gündoğumu+Noun+A3sg+P3sg+Nom
restoran	restoran+Noun+A3sg+Pnon+Nom
kafeterya	kafeterya+Noun+A3sg+Pnon+Nom
denizci	denizci+Noun+A3sg+Pnon+Nom
tutuklu	tutuklu+Noun+A3sg+Pnon+Nom
modernize	modernize+Adj
tekne	tekne+Noun+A3sg+Pnon+Nom
vatoz	vatoz+Noun+A3sg+Pnon+Nom
akvaryum	akvaryum+Noun+A3sg+Pnon+Nom
botanik	botanik+Noun+A3sg+Pnon+Nom
bitki	bitki+Noun+A3sg+Pnon+Nom
ağustos	ağustos+Noun+A3sg+Pnon+Nom
eylül	eylül+Noun+A3sg+Pnon+Nom
jackass	jackass+Noun+A3sg+Pnon+Nom
penguen	penguen+Noun+A3sg+Pnon+Nom
market	market+Noun+A3sg+Pnon+Nom
sahil	sahil+Noun+A3sg+Pnon+Nom
bilet	bilet+Noun+A3sg+Pnon+Nom
barı	barı+Noun+A3sg+Pnon+Nom
okyanus	okyanus+Noun+A3sg+Pnon+Nom
kolonyal	kolonyal+Noun+A3sg+Pnon+Nom
mimari	mimari+Adj
kokteyl	kokteyl+Noun+A3sg+Pnon+Nom
maalesef	maalesef+Adverb
ender	ender+Adj
kafe	kafe+Noun+A3sg+Pnon+Nom
odalık	odalık+Noun+A3sg+Pnon+Nom
sauna	sauna+Noun+A3sg+Pnon+Nom
masaj	masaj+Noun+A3sg+Pnon+Nom
panoramik	panoramik+Adj
telesiyej	telesiyej+Noun+A3sg+Pnon+Nom
teleski	teleski+Noun+A3sg+Pnon+Nom
pist	pist+Noun+A3sg+Pnon+Nom
hat	hat+Noun+A3sg+Pnon+Nom
çınar	çınar+Noun+A3sg+Pnon+Nom
parkur	parkur+Noun+A3sg+Pnon+Nom
kaşar	kaşar+Noun+A3sg+Pnon+Nom
bakir	bakir+Adj
kumsal	kumsal+Adj
kampanya	kampanya+Noun+A3sg+Pnon+Nom
aza	aza+Noun+A3sg+Pnon+Nom
doyum	doyum+Noun+A3sg+Pnon+Nom
barınak	barınak+Noun+A3sg+Pnon+Nom
erozyon	erozyon+Noun+A3sg+Pnon+Nom
sürat	sürat+Noun+A3sg+Pnon+Nom
olta	olta+Noun+A3sg+Pnon+Nom
çipura	çipura+Noun+A3sg+Pnon+Nom
mırmır	mırmır+Noun+A3sg+Pnon+Nom
levrek	levrek+Noun+A3sg+Pnon+Nom
yengeç	yengeç+Noun+A3sg+Pnon+Nom
kaplumbağa	kaplumbağa+Noun+A3sg+Pnon+Nom
kertenkele	kertenkele+Noun+A3sg+Pnon+Nom
ikiz	ikiz+Noun+A3sg+Pnon+Nom
incir	incir+Noun+A3sg+Pnon+Nom
köle	köle+Noun+A3sg+Pnon+Nom
görkem	görkem+Noun+A3sg+Pnon+Nom
tahribat	tahribat+Noun+A3sg+Pnon+Nom
yazıt	yazıt+Noun+A3sg+Pnon+Nom
sunak	sunak+Noun+A3sg+Pnon+Nom
havuz	havuz+Noun+A3sg+Pnon+Nom
caretta	caretta+Noun+A3sg+Pnon+Nom
tilki	tilki+Noun+A3sg+Pnon+Nom
yem	yem+Noun+A3sg+Pnon+Nom
çukur	çukur+Noun+A3sg+Pnon+Nom
yumurta	yumurta+Noun+A3sg+Pnon+Nom
kamp	kamp+Noun+A3sg+Pnon+Nom
kaplıca	kaplıca+Noun+A3sg+Pnon+Nom
zeytin	zeytin+Noun+A3sg+Pnon+Nom
tük	tük+Adj
cip	cip+Noun+A3sg+Pnon+Nom
palmiye	palmiye+Noun+A3sg+Pnon+Nom
dönümlük	dönümlük+Noun+A3sg+Pnon+Nom
safari	safari+Noun+A3sg+Pnon+Nom
yamaç	yamaç+Noun+A3sg+Pnon+Nom
bisiklet	bisiklet+Noun+A3sg+Pnon+Nom
mikrolight	mikrolight+Noun+A3sg+Pnon+Nom
afet	afet+Noun+A3sg+Pnon+Nom
kentsel	kentsel+Adj
karayolu	karayolu+Noun+A3sg+P3sg+Nom
helikopter	helikopter+Noun+A3sg+Pnon+Nom
denizyolu	denizyolu+Noun+A3sg+P3sg+Nom
komuta	komuta+Noun+A3sg+Pnon+Nom
iskele	iskele+Noun+A3sg+Pnon+Nom
transfer	transfer+Noun+A3sg+Pnon+Nom
itfaiye	itfaiye+Noun+A3sg+Pnon+Nom
çadırkent	çadırkent+Noun+A3sg+Pnon+Nom
idari	idari+Adj
lojistik	lojistik+Noun+A3sg+Pnon+Nom
azami	azami+Adj
kitapçık	kitapçık+Noun+A3sg+Pnon+Nom
bodrum	bodrum+Noun+A3sg+Pnon+Nom
mahalle	mahalle+Noun+A3sg+Pnon+Nom
hane	hane+Noun+A3sg+Pnon+Nom
mustarip	mustarip+Adj
sarnıç	sarnıç+Noun+A3sg+Pnon+Nom
poşet	poşet+Noun+A3sg+Pnon+Nom
eldiven	eldiven+Noun+A3sg+Pnon+Nom
rağbet	rağbet+Noun+A3sg+Pnon+Nom
by	by+Noun+A3sg+Pnon+Nom
pass	pass+Noun+A3sg+Pnon+Nom
konfeksiyon	konfeksiyon+Noun+A3sg+Pnon+Nom
alçı	alçı+Noun+A3sg+Pnon+Nom
sünnet	sünnet+Noun+A3sg+Pnon+Nom
kuyu	kuyu+Noun+A3sg+Pnon+Nom
vana	vana+Noun+A3sg+Pnon+Nom
barfiks	barfiks+Noun+A3sg+Pnon+Nom
devret	devret+Verb+Pos+Imp+A2sg
aslen	aslen+Adverb
muhtar	muhtar+Noun+A3sg+Pnon+Nom
gözbebeği	gözbebeği+Noun+A3sg+P3sg+Nom
ten	ten+Noun+A3sg+Pnon+Nom
yeraltı	yeraltı+Noun+A3sg+P3sg+Nom
anekdot	anekdot+Noun+A3sg+Pnon+Nom
gele	gele+Noun+A3sg+Pnon+Nom
turizmci	turizmci+Noun+A3sg+Pnon+Nom
girift	girift+Adj
danışman	danışman+Noun+A3sg+Pnon+Nom
temsilcilik	temsilcilik+Noun+A3sg+Pnon+Nom
kırmızııı	kırmızııı+Noun+A3sg+Pnon+Nom
maviiii	maviiii+Noun+A3sg+Pnon+Nom
hançer	hançer+Noun+A3sg+Pnon+Nom
tadilat	tadilat+Noun+A3sg+Pnon+Nom
cephe	cephe+Noun+A3sg+Pnon+Nom
stüdyo	stüdyo+Noun+A3sg+Pnon+Nom
avam	avam+Noun+A3pl+Pnon+Nom
metrekare	metrekare+Noun+A3sg+Pnon+Nom
yetkili	yetkili+Noun+A3sg+Pnon+Nom
deformasyon	deformasyon+Noun+A3sg+Pnon+Nom
yetersiz	yetersiz+Adj
otomotiv	otomotiv+Noun+A3sg+Pnon+Nom
onarım	onarım+Noun+A3sg+Pnon+Nom
yedekparça	yedekparça+Noun+A3sg+Pnon+Nom
kazı	kazı+Noun+A3sg+Pnon+Nom
kazan	kazan+Noun+A3sg+Pnon+Nom
termos	termos+Noun+A3sg+Pnon+Nom
motorin	motorin+Noun+A3sg+Pnon+Nom
oto	oto+Noun+A3sg+Pnon+Nom
scooter	scooter+Noun+A3sg+Pnon+Nom
scooterlar	scooterlar+Noun+A3sg+Pnon+Nom
lojman	lojman+Noun+A3sg+Pnon+Nom
şenlik	şenlik+Noun+A3sg+Pnon+Nom
işçilik	işçilik+Noun+A3sg+Pnon+Nom
hafıza	hafıza+Noun+A3sg+Pnon+Nom
soyad	soyad+Noun+A3sg+Pnon+Nom
motor	motor+Noun+A3sg+Pnon+Nom
prensip	prensip+Noun+A3sg+Pnon+Nom
gıcık	gıcık+Noun+A3sg+Pnon+Nom
faşizm	faşizm+Noun+A3sg+Pnon+Nom
abuk	abuk+Adj
katiyen	katiyen+Adverb
absürd	absürd+Noun+A3sg+Pnon+Nom
mazallah	mazallah+Noun+A3sg+Pnon+Nom
iltica	iltica+Noun+A3sg+Pnon+Nom
empoze	empoze+Adj
acayip	acayip+Adj
kombine	kombine+Adj
konfor	konfor+Noun+A3sg+Pnon+Nom
halt	halt+Noun+A3sg+Pnon+Nom
taa	taa+Noun+A3sg+Pnon+Nom
birbuçuk	birbuçuk+Noun+A3sg+Pnon+Nom
kurak	kurak+Adj
şerbet	şerbet+Noun+A3sg+Pnon+Nom
bencileyin	bencileyin+Noun+A3sg+Pnon+Nom
miyop	miyop+Noun+A3sg+Pnon+Nom
tonik	tonik+Noun+A3sg+Pnon+Nom
hamamböceği	hamamböceği+Noun+A3sg+P3sg+Nom
beton	beton+Noun+A3sg+Pnon+Nom
püfür	püfür+Dup
millet	millet+Noun+A3sg+Pnon+Nom
rivayet	rivayet+Noun+A3sg+Pnon+Nom
aptes	aptes+Noun+A3sg+Pnon+Nom
deodorant	deodorant+Noun+A3sg+Pnon+Nom
ceylan	ceylan+Noun+A3sg+Pnon+Nom
nafile	nafile+Adj
madalya	madalya+Noun+A3sg+Pnon+Nom
gümbür	gümbür+Dup
gözüpek	gözüpek+Adj
asalak	asalak+Noun+A3sg+Pnon+Nom
çalakalem	çalakalem+Adverb
karakol	karakol+Noun+A3sg+Pnon+Nom
tadım	tadım+Noun+A3sg+Pnon+Nom
limonata	limonata+Noun+A3sg+Pnon+Nom
kravl	kravl+Noun+A3sg+Pnon+Nom
kelebek	kelebek+Noun+A3sg+Pnon+Nom
çakı	çakı+Noun+A3sg+Pnon+Nom
pıloff	pıloff+Noun+A3sg+Pnon+Nom
layt	layt+Noun+A3sg+Pnon+Nom
çekince	çekince+Noun+A3sg+Pnon+Nom
kedi	kedi+Noun+A3sg+Pnon+Nom
leeyr	leeyr+Noun+A3sg+Pnon+Nom
iskambil	iskambil+Noun+A3sg+Pnon+Nom
balık	balık+Noun+A3sg+Pnon+Nom
kebap	kebap+Noun+A3sg+Pnon+Nom
fasıl	fasıl+Noun+A3sg+Pnon+Nom
anason	anason+Noun+A3sg+Pnon+Nom
bas	bas+Adj
bariton	bariton+Noun+A3sg+Pnon+Nom
mukayese	mukayese+Noun+A3sg+Pnon+Nom
fon	fon+Noun+A3sg+Pnon+Nom
doku	doku+Noun+A3sg+Pnon+Nom
yün	yün+Noun+A3sg+Pnon+Nom
dekor	dekor+Noun+A3sg+Pnon+Nom
spot	spot+Noun+A3sg+Pnon+Nom
tenha	tenha+Noun+A3sg+Pnon+Nom
blueslar	blueslar+Noun+A3sg+Pnon+Nom
takvim	takvim+Noun+A3sg+Pnon+Nom
makul	makul+Adj
ahtapot	ahtapot+Noun+A3sg+Pnon+Nom
şakşuka	şakşuka+Noun+A3sg+Pnon+Nom
kuşbakışı	kuşbakışı+Noun+A3sg+P3sg+Nom
peşpeşe	peşpeşe+Adj
lacivert	lacivert+Adj
fast	fast+Adj
food	food+Noun+A3sg+Pnon+Nom
güzelim	güzelim+Adj
rota	rota+Noun+A3sg+Pnon+Nom
içiçe	içiçe+Adj
unutturucak	unutturucak+Noun+A3sg+Pnon+Nom
illaki	illaki+Noun+A3sg+Pnon+Nom
penaltı	penaltı+Noun+A3sg+Pnon+Nom
salı	salı+Noun+A3sg+Pnon+Nom
ası	ası+Noun+A3sg+Pnon+Nom
hakem	hakem+Noun+A3sg+Pnon+Nom
gol	gol+Noun+A3sg+Pnon+Nom
moral	moral+Noun+A3sg+Pnon+Nom
galibiyet	galibiyet+Noun+A3sg+Pnon+Nom
futbol	futbol+Noun+A3sg+Pnon+Nom
konsantre	konsantre+Adj
maç	maç+Noun+A3sg+Pnon+Nom
şut	şut+Noun+A3sg+Pnon+Nom
korner	korner+Noun+A3sg+Pnon+Nom
galip	galip+Noun+A3sg+Pnon+Nom
final	final+Noun+A3sg+Pnon+Nom
salto	salto+Noun+A3sg+Pnon+Nom
tutuk	tutuk+Adj
müsabaka	müsabaka+Noun+A3sg+Pnon+Nom
olimpiyat	olimpiyat+Noun+A3sg+Pnon+Nom
ekol	ekol+Noun+A3sg+Pnon+Nom
güreş	güreş+Noun+A3sg+Pnon+Nom
perspektif	perspektif+Noun+A3sg+Pnon+Nom
başkan	başkan+Noun+A3sg+Pnon+Nom
efsanevi	efsanevi+Adj
basketbolcu	basketbolcu+Noun+A3sg+Pnon+Nom
sporcu	sporcu+Noun+A3sg+Pnon+Nom
efsane	efsane+Noun+A3sg+Pnon+Nom
altüst	altüst+Adj
smaç	smaç+Noun+A3sg+Pnon+Nom
anneanne	anneanne+Noun+A3sg+Pnon+Nom
fazlasıyla	fazlasıyla+Adverb
motivasyon	motivasyon+Noun+A3sg+Pnon+Nom
motive	motive+Adj
katılmamamış	katılmamamış+Noun+A3sg+Pnon+Nom
maddi	maddi+Adj
adapte	adapte+Adj
judo	judo+Noun+A3sg+Pnon+Nom
rekortmen	rekortmen+Noun+A3sg+Pnon+Nom
fizik	fizik+Noun+A3sg+Pnon+Nom
milletvekili	milletvekili+Noun+A3sg+P3sg+Nom
direktör	direktör+Noun+A3sg+Pnon+Nom
kıyak	kıyak+Noun+A3sg+Pnon+Nom
küsur	küsur+Noun+A3sg+Pnon+Nom
hile	hile+Noun+A3sg+Pnon+Nom
hülle	hülle+Noun+A3sg+Pnon+Nom
lügat	lügat+Noun+A3sg+Pnon+Nom
uçuk	uçuk+Adj
müracaat	müracaat+Noun+A3sg+Pnon+Nom
futbolcu	futbolcu+Noun+A3sg+Pnon+Nom
rezalet	rezalet+Noun+A3sg+Pnon+Nom
lig	lig+Noun+A3sg+Pnon+Nom
hükümlü	hükümlü+Noun+A3sg+Pnon+Nom
derbi	derbi+Noun+A3sg+Pnon+Nom
rakip	rakip+Noun+A3sg+Pnon+Nom
sezon	sezon+Noun+A3sg+Pnon+Nom
çepeçevre	çepeçevre+Adverb
golcü	golcü+Noun+A3sg+Pnon+Nom
taraftar	taraftar+Noun+A3sg+Pnon+Nom
ilkokul	ilkokul+Noun+A3sg+Pnon+Nom
okey	okey+Noun+A3sg+Pnon+Nom
mağlup	mağlup+Adj
menajer	menajer+Noun+A3sg+Pnon+Nom
berabere	berabere+Adverb
kulüp	kulüp+Noun+A3sg+Pnon+Nom
kadro	kadro+Noun+A3sg+Pnon+Nom
vallahi	vallahi+Adverb
tenisçi	tenisçi+Noun+A3sg+Pnon+Nom
sportif	sportif+Adj
foto	foto+Noun+A3sg+Pnon+Nom
print	print+Noun+A3sg+Pnon+Nom
alım	alım+Noun+A3sg+Pnon+Nom
kotalarınıaşmak	kotalarınıaşmak+Noun+A3sg+Pnon+Nom
iyibir	iyibir+Noun+A3sg+Pnon+Nom
saha	saha+Noun+A3sg+Pnon+Nom
malzeme	malzeme+Noun+A3sg+Pnon+Nom
idman	idman+Noun+A3sg+Pnon+Nom
gör	gör+Verb+Pos+Imp+A2sg
peş	peş+Noun+A3sg+Pnon+Nom
düdük	düdük+Noun+A3sg+Pnon+Nom
ofsayt	ofsayt+Noun+A3sg+Pnon+Nom
icap	icap+Noun+A3sg+Pnon+Nom
defans	defans+Noun+A3sg+Pnon+Nom
buluşor	buluşor+Noun+A3sg+Pnon+Nom
voleybol	voleybol+Noun+A3sg+Pnon+Nom
kah	kah+Noun+A3sg+Pnon+Nom
basketbol	basketbol+Noun+A3sg+Pnon+Nom
akabinde	akabinde+Adverb
kıstas	kıstas+Noun+A3sg+Pnon+Nom
atlet	atlet+Noun+A3sg+Pnon+Nom
şok	şok+Noun+A3sg+Pnon+Nom
infaz	infaz+Noun+A3sg+Pnon+Nom
antrenman	antrenman+Noun+A3sg+Pnon+Nom
inşaallah	inşaallah+Noun+A3sg+Pnon+Nom
atletizm	atletizm+Noun+A3sg+Pnon+Nom
ferdi	ferdi+Adj
antrenör	antrenör+Noun+A3sg+Pnon+Nom
raf	raf+Noun+A3sg+Pnon+Nom
çekirdek	çekirdek+Noun+A3sg+Pnon+Nom
fokus	fokus+Noun+A3sg+Pnon+Nom
teorik	teorik+Adj
trendy	trendy+Noun+A3sg+Pnon+Nom
metroseksüel	metroseksüel+Noun+A3sg+Pnon+Nom
trendsetter	trendsetter+Noun+A3sg+Pnon+Nom
kült	kült+Noun+A3sg+Pnon+Nom
ikonik	ikonik+Noun+A3sg+Pnon+Nom
çalışkan	çalışkan+Adj
itaatkar	itaatkar+Adj
yetenek	yetenek+Noun+A3sg+Pnon+Nom
karizma	karizma+Noun+A3sg+Pnon+Nom
kariyer	kariyer+Noun+A3sg+Pnon+Nom
müjde	müjde+Noun+A3sg+Pnon+Nom
cool	cool+Noun+A3sg+Pnon+Nom
zoka	zoka+Noun+A3sg+Pnon+Nom
kay	kay+Noun+A3sg+Pnon+Nom
konsept	konsept+Noun+A3sg+Pnon+Nom
biriy	biriy+Noun+A3sg+Pnon+Nom
kritik	kritik+Adj
acizane	acizane+Adj
ginko	ginko+Noun+A3sg+Pnon+Nom
bilabo	bilabo+Noun+A3sg+Pnon+Nom
vitamin	vitamin+Noun+A3sg+Pnon+Nom
pres	pres+Noun+A3sg+Pnon+Nom
markaj	markaj+Noun+A3sg+Pnon+Nom
takriben	takriben+Adverb
sporsever	sporsever+Noun+A3sg+Pnon+Nom
mantık	mantık+Noun+A3sg+Pnon+Nom
ütü	ütü+Noun+A3sg+Pnon+Nom
halvet	halvet+Noun+A3sg+Pnon+Nom
travesti	travesti+Noun+A3sg+Pnon+Nom
tecavüzkar	tecavüzkar+Adj
şerit	şerit+Noun+A3sg+Pnon+Nom
seks	seks+Noun+A3sg+Pnon+Nom
zulüm	zulüm+Noun+A3sg+Pnon+Nom
maytap	maytap+Noun+A3sg+Pnon+Nom
yanık	yanık+Adj
netice	netice+Noun+A3sg+Pnon+Nom
koşu	koşu+Noun+A3sg+Pnon+Nom
mümtaz	mümtaz+Adj
endüstriyel	endüstriyel+Adj
tribün	tribün+Noun+A3sg+Pnon+Nom
alıntı	alıntı+Noun+A3sg+Pnon+Nom
adrenalin	adrenalin+Noun+A3sg+Pnon+Nom
tadıyouz	tadıyouz+Noun+A3sg+Pnon+Nom
hakikaten	hakikaten+Adverb
aslan	aslan+Noun+A3sg+Pnon+Nom
pankart	pankart+Noun+A3sg+Pnon+Nom
slogan	slogan+Noun+A3sg+Pnon+Nom
cuma	cuma+Noun+A3sg+Pnon+Nom
gerilim	gerilim+Noun+A3sg+Pnon+Nom
sörf	sörf+Noun+A3sg+Pnon+Nom
tip	tip+Noun+A3sg+Pnon+Nom
tektip	tektip+Adj
dikiz	dikiz+Noun+A3sg+Pnon+Nom
etik	etik+Noun+A3sg+Pnon+Nom
abi	abi+Noun+A3sg+Pnon+Nom
balerin	balerin+Noun+A3sg+Pnon+Nom
bilim	bilim+Noun+A3sg+Pnon+Nom
tahriş	tahriş+Noun+A3sg+Pnon+Nom
test	test+Noun+A3sg+Pnon+Nom
veto	veto+Noun+A3sg+Pnon+Nom
kurul	kurul+Noun+A3sg+Pnon+Nom
maaş	maaş+Noun+A3sg+Pnon+Nom
aidat	aidat+Noun+A3sg+Pnon+Nom
vurgun	vurgun+Noun+A3sg+Pnon+Nom
bordro	bordro+Noun+A3sg+Pnon+Nom
dernek	dernek+Noun+A3sg+Pnon+Nom
fukara	fukara+Adj
yasal	yasal+Adj
gazetecilik	gazetecilik+Noun+A3sg+Pnon+Nom
sponsor	sponsor+Noun+A3sg+Pnon+Nom
kaçıncı	kaçıncı+Adj
suskun	suskun+Adj
bomba	bomba+Noun+A3sg+Pnon+Nom
kira	kira+Noun+A3sg+Pnon+Nom
stopaj	stopaj+Noun+A3sg+Pnon+Nom
federasyon	federasyon+Noun+A3sg+Pnon+Nom
özerk	özerk+Adj
anti	anti+Adj
kontratak	kontratak+Noun+A3sg+Pnon+Nom
koyalabilir	koyalabilir+Noun+A3sg+Pnon+Nom
bunalım	bunalım+Noun+A3sg+Pnon+Nom
jenerasyon	jenerasyon+Noun+A3sg+Pnon+Nom
mesuliyet	mesuliyet+Noun+A3sg+Pnon+Nom
takviye	takviye+Noun+A3sg+Pnon+Nom
favori	favori+Noun+A3sg+Pnon+Nom
parasal	parasal+Adj
dönüm	dönüm+Noun+A3sg+Pnon+Nom
avantaj	avantaj+Noun+A3sg+Pnon+Nom
yenilgi	yenilgi+Noun+A3sg+Pnon+Nom
akılcı	akılcı+Noun+A3sg+Pnon+Nom
matematiksel	matematiksel+Adj
eyyamcı	eyyamcı+Noun+A3sg+Pnon+Nom
idareci	idareci+Noun+A3sg+Pnon+Nom
gedik	gedik+Noun+A3sg+Pnon+Nom
randıman	randıman+Noun+A3sg+Pnon+Nom
namzet	namzet+Noun+A3sg+Pnon+Nom
briç	briç+Noun+A3sg+Pnon+Nom
anektod	anektod+Noun+A3sg+Pnon+Nom
çakar	çakar+Noun+A3sg+Pnon+Nom
trefl	trefl+Noun+A3sg+Pnon+Nom
izole	izole+Adj
onör	onör+Noun+A3sg+Pnon+Nom
karo	karo+Noun+A3sg+Pnon+Nom
çakın	çakın+Noun+A3sg+Pnon+Nom
vale	vale+Noun+A3sg+Pnon+Nom
as	as+Noun+A3sg+Pnon+Nom
empas	empas+Noun+A3sg+Pnon+Nom
pik	pik+Noun+A3sg+Pnon+Nom
muhalif	muhalif+Noun+A3sg+Pnon+Nom
mahrum	mahrum+Adj
erotik	erotik+Adj
genetik	genetik+Noun+A3sg+Pnon+Nom
gök	gök+Noun+A3sg+Pnon+Nom
rastlantı	rastlantı+Noun+A3sg+Pnon+Nom
abes	abes+Adj
hepten	hepten+Adverb
mercek	mercek+Noun+A3sg+Pnon+Nom
gerçekleşibelecek	gerçekleşibelecek+Noun+A3sg+Pnon+Nom
plase	plase+Noun+A3sg+Pnon+Nom
taktik	taktik+Noun+A3sg+Pnon+Nom
mental	mental+Noun+A3sg+Pnon+Nom
habis	habis+Adj
smaçör	smaçör+Noun+A3sg+Pnon+Nom
turuncu	turuncu+Adj
zaafiyet	zaafiyet+Noun+A3sg+Pnon+Nom
skor	skor+Noun+A3sg+Pnon+Nom
pota	pota+Noun+A3sg+Pnon+Nom
oynancak	oynancak+Noun+A3sg+Pnon+Nom
mazeret	mazeret+Noun+A3sg+Pnon+Nom
teşkil	teşkil+Noun+A3sg+Pnon+Nom
bedensel	bedensel+Adj
basket	basket+Noun+A3sg+Pnon+Nom
faaliyet	faaliyet+Noun+A3sg+Pnon+Nom
play	play+Noun+A3sg+Pnon+Nom
rehabilitasyon	rehabilitasyon+Noun+A3sg+Pnon+Nom
atıcılık	atıcılık+Noun+A3sg+Pnon+Nom
bilardo	bilardo+Noun+A3sg+Pnon+Nom
halter	halter+Noun+A3sg+Pnon+Nom
bilek	bilek+Noun+A3sg+Pnon+Nom
trend	trend+Noun+A3sg+Pnon+Nom
imal	imal+Noun+A3sg+Pnon+Nom
egzoz	egzoz+Noun+A3sg+Pnon+Nom
dubleks	dubleks+Noun+A3sg+Pnon+Nom
kameriye	kameriye+Noun+A3sg+Pnon+Nom
doğalgaz	doğalgaz+Noun+A3sg+Pnon+Nom
kombi	kombi+Noun+A3sg+Pnon+Nom
ferah	ferah+Adj
müstakil	müstakil+Adj
peşinat	peşinat+Noun+A3sg+Pnon+Nom
taksit	taksit+Noun+A3sg+Pnon+Nom
tescil	tescil+Noun+A3sg+Pnon+Nom
santimetre	santimetre+Noun+A3sg+Pnon+Nom
monoblok	monoblok+Noun+A3sg+Pnon+Nom
radye	radye+Noun+A3sg+Pnon+Nom
betonarme	betonarme+Noun+A3sg+Pnon+Nom
donatı	donatı+Noun+A3sg+Pnon+Nom
direnç	direnç+Noun+A3sg+Pnon+Nom
tuğla	tuğla+Noun+A3sg+Pnon+Nom
ısı	ısı+Noun+A3sg+Pnon+Nom
ısıcam	ısıcam+Noun+A3sg+Pnon+Nom
seramik	seramik+Noun+A3sg+Pnon+Nom
fayans	fayans+Noun+A3sg+Pnon+Nom
laminat	laminat+Noun+A3sg+Pnon+Nom
dekoratif	dekoratif+Adj
broker	broker+Noun+A3sg+Pnon+Nom
borsa	borsa+Noun+A3sg+Pnon+Nom
endeks	endeks+Noun+A3sg+Pnon+Nom
dealer	dealer+Noun+A3sg+Pnon+Nom
stres	stres+Noun+A3sg+Pnon+Nom
telkin	telkin+Noun+A3sg+Pnon+Nom
beden	beden+Noun+A3sg+Pnon+Nom
veleybol	veleybol+Noun+A3sg+Pnon+Nom
süpriz	süpriz+Noun+A3sg+Pnon+Nom
doğrultusundak	doğrultusundak+Noun+A3sg+Pnon+Nom
misafir	misafir+Noun+A3sg+Pnon+Nom
yönetmen	yönetmen+Noun+A3sg+Pnon+Nom
çat	çat+Noun+A3sg+Pnon+Nom
karmaşa	karmaşa+Noun+A3sg+Pnon+Nom
monte	monte+Noun+A3sg+Pnon+Nom
lokum	lokum+Noun+A3sg+Pnon+Nom
yaşamsal	yaşamsal+Adj
tepetaklak	tepetaklak+Adverb
başbakan	başbakan+Noun+A3sg+Pnon+Nom
mbar	mbar+Noun+A3sg+Pnon+Nom
basınç	basınç+Noun+A3sg+Pnon+Nom
gr	gr+Noun+A3sg+Pnon+Nom
tüketim	tüketim+Noun+A3sg+Pnon+Nom
model	model+Noun+A3sg+Pnon+Nom
mecburiyet	mecburiyet+Noun+A3sg+Pnon+Nom
uhruç	uhruç+Noun+A3sg+Pnon+Nom
faul	faul+Noun+A3sg+Pnon+Nom
referans	referans+Noun+A3sg+Pnon+Nom
kumral	kumral+Noun+A3sg+Pnon+Nom
göbek	göbek+Noun+A3sg+Pnon+Nom
suşi	suşi+Noun+A3sg+Pnon+Nom
figüran	figüran+Noun+A3sg+Pnon+Nom
argo	argo+Noun+A3sg+Pnon+Nom
fön	fön+Noun+A3sg+Pnon+Nom
kavram	kavram+Noun+A3sg+Pnon+Nom
diyet	diyet+Noun+A3sg+Pnon+Nom
hormonal	hormonal+Adj
kıl	kıl+Noun+A3sg+Pnon+Nom
ayva	ayva+Noun+A3sg+Pnon+Nom
kimsayal	kimsayal+Noun+A3sg+Pnon+Nom
katkı	katkı+Noun+A3sg+Pnon+Nom
şampuan	şampuan+Noun+A3sg+Pnon+Nom
klor	klor+Noun+A3sg+Pnon+Nom
merkez	merkez+Noun+A3sg+Pnon+Nom
baz	baz+Noun+A3sg+Pnon+Nom
aktif	aktif+Adj
yanal	yanal+Adj
karpuz	karpuz+Noun+A3sg+Pnon+Nom
manken	manken+Noun+A3sg+Pnon+Nom
filanca	filanca+Adj
fotojenik	fotojenik+Adj
çekim	çekim+Noun+A3sg+Pnon+Nom
fiziki	fiziki+Adj
ödül	ödül+Noun+A3sg+Pnon+Nom
alkol	alkol+Noun+A3sg+Pnon+Nom
birebir	birebir+Adj
emek	emek+Noun+A3sg+Pnon+Nom
önayak	önayak+Noun+A3sg+Pnon+Nom
faz	faz+Noun+A3sg+Pnon+Nom
yurtdışı	yurtdışı+Adj
esin	esin+Noun+A3sg+Pnon+Nom
rock	rock+Noun+A3sg+Pnon+Nom
heavy	heavy+Noun+A3sg+Pnon+Nom
caz	caz+Noun+A3sg+Pnon+Nom
pop	pop+Adj
entegre	entegre+Adj
nesil	nesil+Noun+A3sg+Pnon+Nom
bebe	bebe+Noun+A3sg+Pnon+Nom
aspirin	aspirin+Noun+A3sg+Pnon+Nom
kanser	kanser+Noun+A3sg+Pnon+Nom
klinik	klinik+Noun+A3sg+Pnon+Nom
laboratuvar	laboratuvar+Noun+A3sg+Pnon+Nom
placebo	placebo+Noun+A3sg+Pnon+Nom
denek	denek+Noun+A3sg+Pnon+Nom
deney	deney+Noun+A3sg+Pnon+Nom
sebze	sebze+Noun+A3sg+Pnon+Nom
kalım	kalım+Noun+A3sg+Pnon+Nom
şiddet	şiddet+Noun+A3sg+Pnon+Nom
çaydanlık	çaydanlık+Noun+A3sg+Pnon+Nom
mizah	mizah+Noun+A3sg+Pnon+Nom
tebligat	tebligat+Noun+A3sg+Pnon+Nom
tarihçi	tarihçi+Noun+A3sg+Pnon+Nom
akademisyen	akademisyen+Noun+A3sg+Pnon+Nom
soykırım	soykırım+Noun+A3sg+Pnon+Nom
demokrasi	demokrasi+Noun+A3sg+Pnon+Nom
evrensel	evrensel+Adj
hukuki	hukuki+Adj
ense	ense+Noun+A3sg+Pnon+Nom
insanoğlu	insanoğlu+Noun+A3sg+P3sg+Nom
yenetek	yenetek+Noun+A3sg+Pnon+Nom
evrimsel	evrimsel+Adj
iskelet	iskelet+Noun+A3sg+Pnon+Nom
ligament	ligament+Noun+A3sg+Pnon+Nom
nucal	nucal+Noun+A3sg+Pnon+Nom
nuchae	nuchae+Noun+A3sg+Pnon+Nom
spinal	spinal+Noun+A3sg+Pnon+Nom
yatkın	yatkın+Adj
geyik	geyik+Noun+A3sg+Pnon+Nom
adaptasyon	adaptasyon+Noun+A3sg+Pnon+Nom
bitap	bitap+Adj
obez	obez+Adj
mücadeleci	mücadeleci+Noun+A3sg+Pnon+Nom
dere	dere+Noun+A3sg+Pnon+Nom
irtibat	irtibat+Noun+A3sg+Pnon+Nom
protein	protein+Noun+A3sg+Pnon+Nom
sevap	sevap+Noun+A3sg+Pnon+Nom
besin	besin+Noun+A3sg+Pnon+Nom
zoonotik	zoonotik+Noun+A3sg+Pnon+Nom
tüberküloz	tüberküloz+Noun+A3sg+Pnon+Nom
kuduz	kuduz+Adj
hayvansal	hayvansal+Adj
hormon	hormon+Noun+A3sg+Pnon+Nom
veteriner	veteriner+Noun+A3sg+Pnon+Nom
hekim	hekim+Noun+A3sg+Pnon+Nom
kist	kist+Noun+A3sg+Pnon+Nom
kamusal	kamusal+Adj
revize	revize+Adj
mezbaha	mezbaha+Noun+A3sg+Pnon+Nom
anormal	anormal+Adj
organ	organ+Noun+A3sg+Pnon+Nom
lenf	lenf+Noun+A3sg+Pnon+Nom
cihaz	cihaz+Noun+A3sg+Pnon+Nom
bilinç	bilinç+Noun+A3sg+Pnon+Nom
karbondioksit	karbondioksit+Noun+A3sg+Pnon+Nom
büyükbaş	büyükbaş+Adj
fetva	fetva+Noun+A3sg+Pnon+Nom
oje	oje+Noun+A3sg+Pnon+Nom
helal	helal+Noun+A3sg+Pnon+Nom
haram	haram+Adj
namaz	namaz+Noun+A3sg+Pnon+Nom
ramazan	ramazan+Noun+A3sg+Pnon+Nom
garsoniyer	garsoniyer+Noun+A3sg+Pnon+Nom
uyuşturucu	uyuşturucu+Noun+A3sg+Pnon+Nom
kuşam	kuşam+Noun+A3sg+Pnon+Nom
cariye	cariye+Noun+A3sg+Pnon+Nom
ziynet	ziynet+Noun+A3sg+Pnon+Nom
müzeyyen	müzeyyen+Adj
dövün	dövün+Verb+Pos+Imp+A2sg
islam	islam+Noun+A3sg+Pnon+Nom
cahiliye	cahiliye+Noun+A3sg+Pnon+Nom
uygalamak	uygalamak+Noun+A3sg+Pnon+Nom
mahcup	mahcup+Adj
beyan	beyan+Noun+A3sg+Pnon+Nom
abdest	abdest+Noun+A3sg+Pnon+Nom
kimyevi	kimyevi+Adj
kimyager	kimyager+Noun+A3sg+Pnon+Nom
mecazi	mecazi+Adj
muhterem	muhterem+Adj
peder	peder+Noun+A3sg+Pnon+Nom
reis	reis+Noun+A3sg+Pnon+Nom
taşlık	taşlık+Noun+A3sg+Pnon+Nom
vaat	vaat+Noun+A3sg+Pnon+Nom
anonim	anonim+Noun+A3sg+Pnon+Nom
milyarlarca	milyarlarca+Num+Card
bulvar	bulvar+Noun+A3sg+Pnon+Nom
kasap	kasap+Noun+A3sg+Pnon+Nom
menteşe	menteşe+Noun+A3sg+Pnon+Nom
adaylık	adaylık+Noun+A3sg+Pnon+Nom
islamcı	islamcı+Noun+A3sg+Pnon+Nom
batılı	batılı+Noun+A3sg+Pnon+Nom
uydu	uydu+Noun+A3sg+Pnon+Nom
istihbarat	istihbarat+Noun+A3sg+Pnon+Nom
atasözü	atasözü+Noun+A3sg+P3sg+Nom
cevaben	cevaben+Adverb
sevk	sevk+Noun+A3sg+Pnon+Nom
illegal	illegal+Adj
asimile	asimile+Adj
tepkisel	tepkisel+Adj
polisiye	polisiye+Adj
mecburen	mecburen+Adverb
göç	göç+Noun+A3sg+Pnon+Nom
kupür	kupür+Noun+A3sg+Pnon+Nom
insani	insani+Adj
akademik	akademik+Adj
anlatım	anlatım+Noun+A3sg+Pnon+Nom
günce	günce+Noun+A3sg+Pnon+Nom
göçü	göçü+Noun+A3sg+Pnon+Nom
mübadele	mübadele+Noun+A3sg+Pnon+Nom
dram	dram+Noun+A3sg+Pnon+Nom
girişimci	girişimci+Noun+A3sg+Pnon+Nom
eleman	eleman+Noun+A3sg+Pnon+Nom
partili	partili+Noun+A3sg+Pnon+Nom
kuşak	kuşak+Noun+A3sg+Pnon+Nom
topluca	topluca+Adj
pastacı	pastacı+Noun+A3sg+Pnon+Nom
müftü	müftü+Noun+A3sg+Pnon+Nom
tarihsel	tarihsel+Adj
meşrep	meşrep+Noun+A3sg+Pnon+Nom
husumet	husumet+Noun+A3sg+Pnon+Nom
cidden	cidden+Adverb
takıyye	takıyye+Noun+A3sg+Pnon+Nom
bilirkişi	bilirkişi+Noun+A3sg+Pnon+Nom
halef	halef+Noun+A3sg+Pnon+Nom
selef	selef+Noun+A3sg+Pnon+Nom
zamanaşımı	zamanaşımı+Noun+A3sg+P3sg+Nom
shore	shore+Noun+A3sg+Pnon+Nom
imam	imam+Noun+A3sg+Pnon+Nom
izdiham	izdiham+Noun+A3sg+Pnon+Nom
nikah	nikah+Noun+A3sg+Pnon+Nom
zekat	zekat+Noun+A3sg+Pnon+Nom
infak	infak+Noun+A3sg+Pnon+Nom
sömürü	sömürü+Noun+A3sg+Pnon+Nom
örgüt	örgüt+Noun+A3sg+Pnon+Nom
kalaşnikof	kalaşnikof+Noun+A3sg+Pnon+Nom
makarof	makarof+Noun+A3sg+Pnon+Nom
takarof	takarof+Noun+A3sg+Pnon+Nom
kaset	kaset+Noun+A3sg+Pnon+Nom
fitre	fitre+Noun+A3sg+Pnon+Nom
sadaka	sadaka+Noun+A3sg+Pnon+Nom
fiilen	fiilen+Adverb
hicret	hicret+Noun+A3sg+Pnon+Nom
deşifre	deşifre+Adj
beşeri	beşeri+Adj
ikamet	ikamet+Noun+A3sg+Pnon+Nom
akraba	akraba+Noun+A3sg+Pnon+Nom
taviz	taviz+Noun+A3sg+Pnon+Nom
islami	islami+Adj
fiili	fiili+Adj
tasfiye	tasfiye+Noun+A3sg+Pnon+Nom
meçhul	meçhul+Adj
operasyon	operasyon+Noun+A3sg+Pnon+Nom
doküman	doküman+Noun+A3sg+Pnon+Nom
faal	faal+Adj
cezaevi	cezaevi+Noun+A3sg+P3sg+Nom
göstermelik	göstermelik+Noun+A3sg+Pnon+Nom
örgütsel	örgütsel+Adj
iştirak	iştirak+Noun+A3sg+Pnon+Nom
darp	darp+Noun+A3sg+Pnon+Nom
sempatizan	sempatizan+Noun+A3sg+Pnon+Nom
otorite	otorite+Noun+A3sg+Pnon+Nom
rejim	rejim+Noun+A3sg+Pnon+Nom
cihat	cihat+Noun+A3sg+Pnon+Nom
tebliğ	tebliğ+Noun+A3sg+Pnon+Nom
cemaat	cemaat+Noun+A3sg+Pnon+Nom
kezzap	kezzap+Noun+A3sg+Pnon+Nom
şura	şura+Noun+A3sg+Pnon+Nom
red	red+Noun+A3sg+Pnon+Nom
hukuksal	hukuksal+Adj
temyiz	temyiz+Noun+A3sg+Pnon+Nom
yapranıp	yapranıp+Noun+A3sg+Pnon+Nom
oybirliği	oybirliği+Noun+A3sg+P3sg+Nom
oluşum	oluşum+Noun+A3sg+Pnon+Nom
koalisyon	koalisyon+Noun+A3sg+Pnon+Nom
simülasyon	simülasyon+Noun+A3sg+Pnon+Nom
temayüz	temayüz+Noun+A3sg+Pnon+Nom
parlemento	parlemento+Noun+A3sg+Pnon+Nom
asgari	asgari+Adj
sandalya	sandalya+Noun+A3sg+Pnon+Nom
seçmen	seçmen+Noun+A3sg+Pnon+Nom
meşru	meşru+Adj
köklü	köklü+Adj
istikrarsızlırk	istikrarsızlırk+Noun+A3sg+Pnon+Nom
kılpayı	kılpayı+Adj
sözkonusu	sözkonusu+Noun+A3sg+P3sg+Nom
edebiyatçı	edebiyatçı+Noun+A3sg+Pnon+Nom
yankı	yankı+Noun+A3sg+Pnon+Nom
peygamber	peygamber+Noun+A3sg+Pnon+Nom
ilkel	ilkel+Adj
sistematik	sistematik+Adj
rafine	rafine+Adj
medeniyet	medeniyet+Noun+A3sg+Pnon+Nom
birfiil	birfiil+Noun+A3sg+Pnon+Nom
parlamenter	parlamenter+Noun+A3sg+Pnon+Nom
kasiyer	kasiyer+Noun+A3sg+Pnon+Nom
maşallah	maşallah+Noun+A3sg+Pnon+Nom
aydın	aydın+Adj
bilimci	bilimci+Noun+A3sg+Pnon+Nom
katılım	katılım+Noun+A3sg+Pnon+Nom
komünizm	komünizm+Noun+A3sg+Pnon+Nom
orjinal	orjinal+Noun+A3sg+Pnon+Nom
sosyolojik	sosyolojik+Adj
müttefik	müttefik+Adj
konuşmacı	konuşmacı+Noun+A3sg+Pnon+Nom
tecelli	tecelli+Noun+A3sg+Pnon+Nom
entegrasyon	entegrasyon+Noun+A3sg+Pnon+Nom
reel	reel+Adj
yalnış	yalnış+Noun+A3sg+Pnon+Nom
çook	çook+Noun+A3sg+Pnon+Nom
elbirliği	elbirliği+Noun+A3sg+P3sg+Nom
karga	karga+Noun+A3sg+Pnon+Nom
tu	tu+Interj
kaka	kaka+Noun+A3sg+Pnon+Nom
maaalesef	maaalesef+Noun+A3sg+Pnon+Nom
kalemşör	kalemşör+Noun+A3sg+Pnon+Nom
naklen	naklen+Adverb
art	art+Noun+A3sg+Pnon+Nom
yangın	yangın+Noun+A3sg+Pnon+Nom
kiriş	kiriş+Noun+A3sg+Pnon+Nom
oylum	oylum+Noun+A3sg+Pnon+Nom
vazife	vazife+Noun+A3sg+Pnon+Nom
platin	platin+Noun+A3sg+Pnon+Nom
nöbetçi	nöbetçi+Noun+A3sg+Pnon+Nom
kilim	kilim+Noun+A3sg+Pnon+Nom
mangal	mangal+Noun+A3sg+Pnon+Nom
yepyeni	yepyeni+Adj
duş	duş+Noun+A3sg+Pnon+Nom
kabin	kabin+Noun+A3sg+Pnon+Nom
alafranga	alafranga+Adj
panjur	panjur+Noun+A3sg+Pnon+Nom
gündelik	gündelik+Noun+A3sg+Pnon+Nom
zina	zina+Noun+A3sg+Pnon+Nom
şeriat	şeriat+Noun+A3sg+Pnon+Nom
üniter	üniter+Adj
takdim	takdim+Noun+A3sg+Pnon+Nom
konuşuyacak	konuşuyacak+Noun+A3sg+Pnon+Nom
saman	saman+Noun+A3sg+Pnon+Nom
es	es+Noun+A3sg+Pnon+Nom
burç	burç+Noun+A3sg+Pnon+Nom
kavuşum	kavuşum+Noun+A3sg+Pnon+Nom
fal	fal+Noun+A3sg+Pnon+Nom
meditasyon	meditasyon+Noun+A3sg+Pnon+Nom
vekil	vekil+Noun+A3sg+Pnon+Nom
tayin	tayin+Noun+A3sg+Pnon+Nom
burcu	burcu+Noun+A3sg+Pnon+Nom
açı	açı+Noun+A3sg+Pnon+Nom
partner	partner+Noun+A3sg+Pnon+Nom
iyimser	iyimser+Adj
ırk	ırk+Noun+A3sg+Pnon+Nom
greyfurt	greyfurt+Noun+A3sg+Pnon+Nom
kafatası	kafatası+Noun+A3sg+P3sg+Nom
cüce	cüce+Noun+A3sg+Pnon+Nom
yüzyıl	yüzyıl+Noun+A3sg+Pnon+Nom
zeka	zeka+Noun+A3sg+Pnon+Nom
astroloji	astroloji+Noun+A3sg+Pnon+Nom
şikayetçi	şikayetçi+Noun+A3sg+Pnon+Nom
katil	katil+Noun+A3sg+Pnon+Nom
rıza	rıza+Noun+A3sg+Pnon+Nom
sanık	sanık+Noun+A3sg+Pnon+Nom
vatan	vatan+Noun+A3sg+Pnon+Nom
üniforma	üniforma+Noun+A3sg+Pnon+Nom
kelepçe	kelepçe+Noun+A3sg+Pnon+Nom
don	don+Noun+A3sg+Pnon+Nom
hazin	hazin+Adj
sıkıyönetim	sıkıyönetim+Noun+A3sg+Pnon+Nom
albay	albay+Noun+A3sg+Pnon+Nom
hakimiyet	hakimiyet+Noun+A3sg+Pnon+Nom
l	l+Noun+A3sg+Pnon+Nom
akli	akli+Adj
ayran	ayran+Noun+A3sg+Pnon+Nom
haciz	haciz+Noun+A3sg+Pnon+Nom
şoför	şoför+Noun+A3sg+Pnon+Nom
ganimet	ganimet+Noun+A3sg+Pnon+Nom
şayka	şayka+Noun+A3sg+Pnon+Nom
yağma	yağma+Noun+A3sg+Pnon+Nom
daimi	daimi+Adj
inşaa	inşaa+Noun+A3sg+Pnon+Nom
yalı	yalı+Noun+A3sg+Pnon+Nom
ayazma	ayazma+Noun+A3sg+Pnon+Nom
vasi	vasi+Noun+A3sg+Pnon+Nom
vefat	vefat+Noun+A3sg+Pnon+Nom
bildiri	bildiri+Noun+A3sg+Pnon+Nom
komiser	komiser+Noun+A3sg+Pnon+Nom
atletik	atletik+Adj
kep	kep+Noun+A3sg+Pnon+Nom
yurttaş	yurttaş+Noun+A3sg+Pnon+Nom
öncülük	öncülük+Noun+A3sg+Pnon+Nom
serbesti	serbesti+Noun+A3sg+Pnon+Nom
simgesel	simgesel+Adj
ikilem	ikilem+Noun+A3sg+Pnon+Nom
burs	burs+Noun+A3sg+Pnon+Nom
düşünsel	düşünsel+Adj
grip	grip+Noun+A3sg+Pnon+Nom
aktör	aktör+Noun+A3sg+Pnon+Nom
imparator	imparator+Noun+A3sg+Pnon+Nom
prodüktör	prodüktör+Noun+A3sg+Pnon+Nom
körfez	körfez+Noun+A3sg+Pnon+Nom
kanto	kanto+Noun+A3sg+Pnon+Nom
imaj	imaj+Noun+A3sg+Pnon+Nom
versiyon	versiyon+Noun+A3sg+Pnon+Nom
protest	protest+Noun+A3sg+Pnon+Nom
klip	klip+Noun+A3sg+Pnon+Nom
ütopik	ütopik+Adj
sperm	sperm+Noun+A3sg+Pnon+Nom
fantazi	fantazi+Noun+A3sg+Pnon+Nom
agresif	agresif+Adj
dolaşım	dolaşım+Noun+A3sg+Pnon+Nom
koz	koz+Noun+A3sg+Pnon+Nom
ültimatom	ültimatom+Noun+A3sg+Pnon+Nom
heyet	heyet+Noun+A3sg+Pnon+Nom
mahsur	mahsur+Adj
dizel	dizel+Noun+A3sg+Pnon+Nom
lokomotif	lokomotif+Noun+A3sg+Pnon+Nom
ecel	ecel+Noun+A3sg+Pnon+Nom
grayder	grayder+Noun+A3sg+Pnon+Nom
dozer	dozer+Noun+A3sg+Pnon+Nom
kepçe	kepçe+Noun+A3sg+Pnon+Nom
kg	kg+Noun+A3sg+Pnon+Nom
serum	serum+Noun+A3sg+Pnon+Nom
safra	safra+Noun+A3sg+Pnon+Nom
kolestrol	kolestrol+Noun+A3sg+Pnon+Nom
glikoz	glikoz+Noun+A3sg+Pnon+Nom
glikojen	glikojen+Noun+A3sg+Pnon+Nom
karaciğer	karaciğer+Noun+A3sg+Pnon+Nom
kronik	kronik+Noun+A3sg+Pnon+Nom
spesifik	spesifik+Adj
ultrason	ultrason+Noun+A3sg+Pnon+Nom
alkolik	alkolik+Adj
sendrom	sendrom+Noun+A3sg+Pnon+Nom
anflamatuar	anflamatuar+Noun+A3sg+Pnon+Nom
viral	viral+Noun+A3sg+Pnon+Nom
fosfor	fosfor+Noun+A3sg+Pnon+Nom
kolestrolü	kolestrolü+Noun+A3sg+Pnon+Nom
zemin	zemin+Noun+A3sg+Pnon+Nom
nasır	nasır+Noun+A3sg+Pnon+Nom
elverişli	elverişli+Adj
mantar	mantar+Noun+A3sg+Pnon+Nom
termofor	termofor+Noun+A3sg+Pnon+Nom
bölgesel	bölgesel+Adj
bağışık	bağışık+Adj
kabine	kabine+Noun+A3sg+Pnon+Nom
yandaş	yandaş+Noun+A3sg+Pnon+Nom
revizyon	revizyon+Noun+A3sg+Pnon+Nom
har	har+Noun+A3sg+Pnon+Nom
harman	harman+Noun+A3sg+Pnon+Nom
ilelebet	ilelebet+Adverb
gündem	gündem+Noun+A3sg+Pnon+Nom
bozukluk	bozukluk+Noun+A3sg+Pnon+Nom
fısıltı	fısıltı+Noun+A3sg+Pnon+Nom
çek	çek+Verb+Pos+Imp+A2sg
barışık	barışık+Adj
nasihat	nasihat+Noun+A3sg+Pnon+Nom
cumhurbaşkanı	cumhurbaşkanı+Noun+A3sg+P3sg+Nom
inandırıcı	inandırıcı+Adj
kimyasal	kimyasal+Adj
sus	sus+Verb+Pos+Imp+A2sg
pus	pus+Noun+A3sg+Pnon+Nom
bürokrat	bürokrat+Noun+A3sg+Pnon+Nom
villa	villa+Noun+A3sg+Pnon+Nom
kontrolör	kontrolör+Noun+A3sg+Pnon+Nom
başmüfettiş	başmüfettiş+Noun+A3sg+Pnon+Nom
kavgacı	kavgacı+Noun+A3sg+Pnon+Nom
sermaye	sermaye+Noun+A3sg+Pnon+Nom
ekonomist	ekonomist+Noun+A3sg+Pnon+Nom
sabep	sabep+Noun+A3sg+Pnon+Nom
huy	huy+Noun+A3sg+Pnon+Nom
müsrif	müsrif+Adj
istişare	istişare+Noun+A3sg+Pnon+Nom
örf	örf+Noun+A3sg+Pnon+Nom
gecelik	gecelik+Adj
istikrar	istikrar+Noun+A3sg+Pnon+Nom
şayan	şayan+Adj
sirayet	sirayet+Noun+A3sg+Pnon+Nom
destekçi	destekçi+Noun+A3sg+Pnon+Nom
tahkik	tahkik+Noun+A3sg+Pnon+Nom
sekreter	sekreter+Noun+A3sg+Pnon+Nom
modernizm	modernizm+Noun+A3sg+Pnon+Nom
versus	versus+Noun+A3sg+Pnon+Nom
sosyolog	sosyolog+Noun+A3sg+Pnon+Nom
aktivite	aktivite+Noun+A3sg+Pnon+Nom
icracı	icracı+Noun+A3sg+Pnon+Nom
istihdam	istihdam+Noun+A3sg+Pnon+Nom
tecih	tecih+Noun+A3sg+Pnon+Nom
husus	husus+Noun+A3sg+Pnon+Nom
pozisyon	pozisyon+Noun+A3sg+Pnon+Nom
c	c+Noun+A3sg+Pnon+Nom
mekik	mekik+Noun+A3sg+Pnon+Nom
acilen	acilen+Adverb
uzlaşı	uzlaşı+Noun+A3sg+Pnon+Nom
politika	politika+Noun+A3sg+Pnon+Nom
ılımlı	ılımlı+Adj
milliyetçi	milliyetçi+Noun+A3sg+Pnon+Nom
bütçe	bütçe+Noun+A3sg+Pnon+Nom
ödenek	ödenek+Noun+A3sg+Pnon+Nom
diplomatik	diplomatik+Adj
aksesuvar	aksesuvar+Noun+A3sg+Pnon+Nom
kuaför	kuaför+Noun+A3sg+Pnon+Nom
sosyetik	sosyetik+Adj
püf	püf+Noun+A3sg+Pnon+Nom
topuz	topuz+Noun+A3sg+Pnon+Nom
şifon	şifon+Noun+A3sg+Pnon+Nom
şaç	şaç+Noun+A3sg+Pnon+Nom
vatka	vatka+Noun+A3sg+Pnon+Nom
plastik	plastik+Adj
röntgen	röntgen+Noun+A3sg+Pnon+Nom
eşarp	eşarp+Noun+A3sg+Pnon+Nom
tesettür	tesettür+Noun+A3sg+Pnon+Nom
füzyon	füzyon+Noun+A3sg+Pnon+Nom
global	global+Adj
b	b+Noun+A3sg+Pnon+Nom
cesur	cesur+Adj
drape	drape+Noun+A3sg+Pnon+Nom
etnik	etnik+Adj
bej	bej+Adj
ekru	ekru+Noun+A3sg+Pnon+Nom
baştançıkarıcı	baştançıkarıcı+Adj
fütüristik	fütüristik+Adj
puantiye	puantiye+Noun+A3sg+Pnon+Nom
straplez	straplez+Noun+A3sg+Pnon+Nom
vintage	vintage+Noun+A3sg+Pnon+Nom
casual	casual+Noun+A3sg+Pnon+Nom
sıradışı	sıradışı+Adj
fermuar	fermuar+Noun+A3sg+Pnon+Nom
romantizm	romantizm+Noun+A3sg+Pnon+Nom
tekno	tekno+Noun+A3sg+Pnon+Nom
dinamizm	dinamizm+Noun+A3sg+Pnon+Nom
haki	haki+Noun+A3sg+Pnon+Nom
lycra	lycra+Noun+A3sg+Pnon+Nom
lila	lila+Noun+A3sg+Pnon+Nom
turkuaz	turkuaz+Noun+A3sg+Pnon+Nom
kombinlemek	kombinlemek+Noun+A3sg+Pnon+Nom
kargo	kargo+Noun+A3sg+Pnon+Nom
bermuda	bermuda+Noun+A3sg+Pnon+Nom
penye	penye+Noun+A3sg+Pnon+Nom
koton	koton+Noun+A3sg+Pnon+Nom
pastel	pastel+Noun+A3sg+Pnon+Nom
koleksiyon	koleksiyon+Noun+A3sg+Pnon+Nom
ofis	ofis+Noun+A3sg+Pnon+Nom
timsah	timsah+Noun+A3sg+Pnon+Nom
jarse	jarse+Adj
indigo	indigo+Noun+A3sg+Pnon+Nom
japon	japon+Noun+A3sg+Pnon+Nom
kırışık	kırışık+Noun+A3sg+Pnon+Nom
oranj	oranj+Noun+A3sg+Pnon+Nom
antrasit	antrasit+Noun+A3sg+Pnon+Nom
asit	asit+Noun+A3sg+Pnon+Nom
triko	triko+Noun+A3sg+Pnon+Nom
polo	polo+Noun+A3sg+Pnon+Nom
yaka	yaka+Noun+A3sg+Pnon+Nom
kruvaze	kruvaze+Adj
enerjik	enerjik+Adj
ödün	ödün+Noun+A3sg+Pnon+Nom
blazer	blazer+Noun+A3sg+Pnon+Nom
moka	moka+Noun+A3sg+Pnon+Nom
fildişi	fildişi+Noun+A3sg+P3sg+Nom
plaj	plaj+Noun+A3sg+Pnon+Nom
komplo	komplo+Noun+A3sg+Pnon+Nom
manşet	manşet+Noun+A3sg+Pnon+Nom
objektif	objektif+Adj
the	the+Noun+A3sg+Pnon+Nom
record	record+Noun+A3sg+Pnon+Nom
minicik	minicik+Adj
ultra	ultra+Adj
bikini	bikini+Noun+A3sg+Pnon+Nom
streç	streç+Adj
festival	festival+Noun+A3sg+Pnon+Nom
pant	pant+Noun+A3sg+Pnon+Nom
etek	etek+Noun+A3sg+Pnon+Nom
babet	babet+Noun+A3sg+Pnon+Nom
disko	disko+Noun+A3sg+Pnon+Nom
metalik	metalik+Adj
neon	neon+Noun+A3sg+Pnon+Nom
kloş	kloş+Adj
otuzbeş	otuzbeş+Noun+A3sg+Pnon+Nom
kayakçı	kayakçı+Noun+A3sg+Pnon+Nom
pul	pul+Adj
otoriter	otoriter+Adj
balıkçı	balıkçı+Noun+A3sg+Pnon+Nom
popstar	popstar+Noun+A3sg+Pnon+Nom
hayati	hayati+Adj
dönemeç	dönemeç+Noun+A3sg+Pnon+Nom
tişört	tişört+Noun+A3sg+Pnon+Nom
stiletto	stiletto+Noun+A3sg+Pnon+Nom
bluz	bluz+Noun+A3sg+Pnon+Nom
yüzük	yüzük+Noun+A3sg+Pnon+Nom
bluzlarve	bluzlarve+Noun+A3sg+Pnon+Nom
hint	hint+Noun+A3sg+Pnon+Nom
gitar	gitar+Noun+A3sg+Pnon+Nom
yedinci	yedinci+Num+Ord
dadı	dadı+Noun+A3sg+Pnon+Nom
erik	erik+Noun+A3sg+Pnon+Nom
kiraz	kiraz+Noun+A3sg+Pnon+Nom
günlerce	günlerce+Adverb
kalça	kalça+Noun+A3sg+Pnon+Nom
röportaj	röportaj+Noun+A3sg+Pnon+Nom
sempatik	sempatik+Adj
altıncı	altıncı+Num+Ord
kürtaj	kürtaj+Noun+A3sg+Pnon+Nom
itfaiyeci	itfaiyeci+Noun+A3sg+Pnon+Nom
titiz	titiz+Adj
aşama	aşama+Noun+A3sg+Pnon+Nom
yadediyor	yadediyor+Noun+A3sg+Pnon+Nom
minare	minare+Noun+A3sg+Pnon+Nom
istimlak	istimlak+Noun+A3sg+Pnon+Nom
kılık	kılık+Noun+A3sg+Pnon+Nom
traktör	traktör+Noun+A3sg+Pnon+Nom
patlak	patlak+Noun+A3sg+Pnon+Nom
atılım	atılım+Noun+A3sg+Pnon+Nom
hiçkimse	hiçkimse+Noun+A3sg+Pnon+Nom
sarp	sarp+Adj
komposto	komposto+Noun+A3sg+Pnon+Nom
konserve	konserve+Noun+A3sg+Pnon+Nom
manga	manga+Noun+A3sg+Pnon+Nom
onbir	onbir+Num+Card
poker	poker+Noun+A3sg+Pnon+Nom
tıkırtı	tıkırtı+Noun+A3sg+Pnon+Nom
akü	akü+Noun+A3sg+Pnon+Nom
etraf	etraf+Noun+A3sg+Pnon+Nom
tevkif	tevkif+Noun+A3sg+Pnon+Nom
tınnn	tınnn+Noun+A3sg+Pnon+Nom
tınnnn	tınnnn+Noun+A3sg+Pnon+Nom
keşif	keşif+Noun+A3sg+Pnon+Nom
havan	havan+Noun+A3sg+Pnon+Nom
er	er+Noun+A3sg+Pnon+Nom
mevzi	mevzi+Noun+A3sg+Pnon+Nom
bereket	bereket+Noun+A3sg+Pnon+Nom
asır	asır+Noun+A3sg+Pnon+Nom
şeyn	şeyn+Noun+A3sg+Pnon+Nom
mugayir	mugayir+Noun+A3sg+Pnon+Nom
düzyazı	düzyazı+Noun+A3sg+Pnon+Nom
gazap	gazap+Noun+A3sg+Pnon+Nom
hüdhüd	hüdhüd+Noun+A3sg+Pnon+Nom
tasa	tasa+Noun+A3sg+Pnon+Nom
alaturka	alaturka+Adj
musiki	musiki+Noun+A3sg+Pnon+Nom
kibir	kibir+Noun+A3sg+Pnon+Nom
zilli	zilli+Adj
def	def+Noun+A3sg+Pnon+Nom
akbaba	akbaba+Noun+A3sg+Pnon+Nom
fidan	fidan+Noun+A3sg+Pnon+Nom
hatt	hatt+Noun+A3sg+Pnon+Nom
meh	meh+Noun+A3sg+Pnon+Nom
yortu	yortu+Noun+A3sg+Pnon+Nom
arak	arak+Noun+A3sg+Pnon+Nom
eşcinsel	eşcinsel+Adj
ithaf	ithaf+Noun+A3sg+Pnon+Nom
servi	servi+Noun+A3sg+Pnon+Nom
profesör	profesör+Noun+A3sg+Pnon+Nom
kütüphane	kütüphane+Noun+A3sg+Pnon+Nom
ağabey	ağabey+Noun+A3sg+Pnon+Nom
besteci	besteci+Noun+A3sg+Pnon+Nom
ufuk	ufuk+Noun+A3sg+Pnon+Nom
dişli	dişli+Noun+A3sg+Pnon+Nom
paşa	paşa+Noun+A3sg+Pnon+Nom
kunduracılık	kunduracılık+Noun+A3sg+Pnon+Nom
kovboy	kovboy+Noun+A3sg+Pnon+Nom
meze	meze+Noun+A3sg+Pnon+Nom
terhis	terhis+Noun+A3sg+Pnon+Nom
garson	garson+Noun+A3sg+Pnon+Nom
hıyar	hıyar+Noun+A3sg+Pnon+Nom
konsomatrist	konsomatrist+Noun+A3sg+Pnon+Nom
bıçkın	bıçkın+Adj
tentene	tentene+Noun+A3sg+Pnon+Nom
bürümcek	bürümcek+Noun+A3sg+Pnon+Nom
topuk	topuk+Noun+A3sg+Pnon+Nom
tak	tak+Noun+A3sg+Pnon+Nom
köstek	köstek+Noun+A3sg+Pnon+Nom
şakşak	şakşak+Noun+A3sg+Pnon+Nom
fes	fes+Noun+A3sg+Pnon+Nom
perçem	perçem+Noun+A3sg+Pnon+Nom
mülk	mülk+Noun+A3sg+Pnon+Nom
konstantre	konstantre+Noun+A3sg+Pnon+Nom
incilmez	incilmez+Noun+A3sg+Pnon+Nom
dandini	dandini+Noun+A3sg+Pnon+Nom
bıcır	bıcır+Noun+A3sg+Pnon+Nom
laptop	laptop+Noun+A3sg+Pnon+Nom
kadınsı	kadınsı+Adj
kademe	kademe+Noun+A3sg+Pnon+Nom
havuç	havuç+Noun+A3sg+Pnon+Nom
va	va+Noun+A3sg+Pnon+Nom
star	star+Noun+A3sg+Pnon+Nom
hırs	hırs+Noun+A3sg+Pnon+Nom
teyzemler	teyzemler+Noun+A3pl+P1sg+Nom
konuk	konuk+Noun+A3sg+Pnon+Nom
başrol	başrol+Noun+A3sg+Pnon+Nom
silikon	silikon+Noun+A3sg+Pnon+Nom
dedikodu	dedikodu+Noun+A3sg+Pnon+Nom
sabuk	sabuk+Dup
esrarangiz	esrarangiz+Noun+A3sg+Pnon+Nom
entelektüel	entelektüel+Noun+A3sg+Pnon+Nom
merci	merci+Noun+A3sg+Pnon+Nom
marifet	marifet+Noun+A3sg+Pnon+Nom
aleni	aleni+Adj
media	media+Noun+A3sg+Pnon+Nom
yamuk	yamuk+Adj
ifrit	ifrit+Noun+A3sg+Pnon+Nom
göreceli	göreceli+Adj
feci	feci+Adj
usturuplu	usturuplu+Adj
makarna	makarna+Noun+A3sg+Pnon+Nom
car	car+Noun+A3sg+Pnon+Nom
mastürbasyon	mastürbasyon+Noun+A3sg+Pnon+Nom
empati	empati+Noun+A3sg+Pnon+Nom
yegane	yegane+Adj
pekçok	pekçok+Noun+A3sg+Pnon+Nom
metazori	metazori+Adj
prodüksiyon	prodüksiyon+Noun+A3sg+Pnon+Nom
cıncık	cıncık+Noun+A3sg+Pnon+Nom
apayrı	apayrı+Adj
ibare	ibare+Noun+A3sg+Pnon+Nom
hadise	hadise+Noun+A3sg+Pnon+Nom
paranoyak	paranoyak+Adj
laubali	laubali+Adj
mix	mix+Noun+A3sg+Pnon+Nom
dan	dan+Noun+A3sg+Pnon+Nom
ateist	ateist+Noun+A3sg+Pnon+Nom
iftar	iftar+Noun+A3sg+Pnon+Nom
istismar	istismar+Noun+A3sg+Pnon+Nom
elçilik	elçilik+Noun+A3sg+Pnon+Nom
ajitatif	ajitatif+Noun+A3sg+Pnon+Nom
yanılsama	yanılsama+Noun+A3sg+Pnon+Nom
kompozitör	kompozitör+Noun+A3sg+Pnon+Nom
yarışma	yarışma+Noun+A3sg+Pnon+Nom
kalsiyum	kalsiyum+Noun+A3sg+Pnon+Nom
zincirleme	zincirleme+Adj
üstüste	üstüste+Adj
durağan	durağan+Adj
ortaokul	ortaokul+Noun+A3sg+Pnon+Nom
ti	ti+Noun+A3sg+Pnon+Nom
araştırmacı	araştırmacı+Noun+A3sg+Pnon+Nom
aktüel	aktüel+Adj
icra	icra+Noun+A3sg+Pnon+Nom
tumba	tumba+Noun+A3sg+Pnon+Nom
darbuka	darbuka+Noun+A3sg+Pnon+Nom
tef	tef+Noun+A3sg+Pnon+Nom
beste	beste+Noun+A3sg+Pnon+Nom
enstrüman	enstrüman+Noun+A3sg+Pnon+Nom
doğaçlama	doğaçlama+Noun+A3sg+Pnon+Nom
klarnet	klarnet+Noun+A3sg+Pnon+Nom
sound	sound+Noun+A3sg+Pnon+Nom
prova	prova+Noun+A3sg+Pnon+Nom
vokal	vokal+Noun+A3sg+Pnon+Nom
deneysel	deneysel+Adj
davul	davul+Noun+A3sg+Pnon+Nom
elektro	elektro+Noun+A3sg+Pnon+Nom
müzikal	müzikal+Noun+A3sg+Pnon+Nom
konservatuar	konservatuar+Noun+A3sg+Pnon+Nom
viyolonsel	viyolonsel+Noun+A3sg+Pnon+Nom
mart	mart+Noun+A3sg+Pnon+Nom
start	start+Noun+A3sg+Pnon+Nom
mülteci	mülteci+Noun+A3sg+Pnon+Nom
açlık	açlık+Noun+A3sg+Pnon+Nom
kızamık	kızamık+Noun+A3sg+Pnon+Nom
tetanoz	tetanoz+Noun+A3sg+Pnon+Nom
yeryüzü	yeryüzü+Noun+A3sg+P3sg+Nom
kesit	kesit+Noun+A3sg+Pnon+Nom
cinsiyet	cinsiyet+Noun+A3sg+Pnon+Nom
sıtma	sıtma+Noun+A3sg+Pnon+Nom
öğrenim	öğrenim+Noun+A3sg+Pnon+Nom
vakıf	vakıf+Noun+A3sg+Pnon+Nom
ücretli	ücretli+Noun+A3sg+Pnon+Nom
pekiyi	pekiyi+Noun+A3sg+Pnon+Nom
felç	felç+Noun+A3sg+Pnon+Nom
yumurtalık	yumurtalık+Noun+A3sg+Pnon+Nom
forma	forma+Noun+A3sg+Pnon+Nom
kırtasiye	kırtasiye+Noun+A3sg+Pnon+Nom
lolipop	lolipop+Noun+A3sg+Pnon+Nom
ayrımış	ayrımış+Noun+A3sg+Pnon+Nom
sönük	sönük+Adj
ergonomik	ergonomik+Adj
makbul	makbul+Adj
zihinsel	zihinsel+Adj
okullu	okullu+Adj
kemancı	kemancı+Noun+A3sg+Pnon+Nom
periyodik	periyodik+Adj
birliktelik	birliktelik+Noun+A3sg+Pnon+Nom
solist	solist+Noun+A3sg+Pnon+Nom
fen	fen+Noun+A3sg+Pnon+Nom
denizcilik	denizcilik+Noun+A3sg+Pnon+Nom
oyuncak	oyuncak+Noun+A3sg+Pnon+Nom
kağnı	kağnı+Noun+A3sg+Pnon+Nom
penny	penny+Noun+A3sg+Pnon+Nom
farthing	farthing+Noun+A3sg+Pnon+Nom
tahlisiye	tahlisiye+Noun+A3sg+Pnon+Nom
sandal	sandal+Noun+A3sg+Pnon+Nom
semafor	semafor+Noun+A3sg+Pnon+Nom
akran	akran+Noun+A3sg+Pnon+Nom
hop	hop+Interj
plaza	plaza+Noun+A3sg+Pnon+Nom
kurs	kurs+Noun+A3sg+Pnon+Nom
kaban	kaban+Noun+A3sg+Pnon+Nom
kazak	kazak+Noun+A3sg+Pnon+Nom
kılıf	kılıf+Noun+A3sg+Pnon+Nom
devalüasyon	devalüasyon+Noun+A3sg+Pnon+Nom
enflasyonist	enflasyonist+Adj
finansman	finansman+Noun+A3sg+Pnon+Nom
konjonktürel	konjonktürel+Noun+A3sg+Pnon+Nom
tesadüfi	tesadüfi+Adverb
gayrimenkul	gayrimenkul+Noun+A3sg+Pnon+Nom
balon	balon+Noun+A3sg+Pnon+Nom
likit	likit+Noun+A3sg+Pnon+Nom
maliye	maliye+Noun+A3sg+Pnon+Nom
feragat	feragat+Noun+A3sg+Pnon+Nom
ivedilikle	ivedilikle+Adverb
disiplin	disiplin+Noun+A3sg+Pnon+Nom
enkaz	enkaz+Noun+A3pl+Pnon+Nom
prefabrik	prefabrik+Adj
brifing	brifing+Noun+A3sg+Pnon+Nom
atıl	atıl+Adj
işlerlik	işlerlik+Noun+A3sg+Pnon+Nom
yöresel	yöresel+Adj
direk	direk+Noun+A3sg+Pnon+Nom
mağdur	mağdur+Adj
tirajikomik	tirajikomik+Noun+A3sg+Pnon+Nom
trajikomik	trajikomik+Noun+A3sg+Pnon+Nom
cezai	cezai+Adj
söylenti	söylenti+Noun+A3sg+Pnon+Nom
efektif	efektif+Noun+A3sg+Pnon+Nom
gidişat	gidişat+Noun+A3sg+Pnon+Nom
eğitimci	eğitimci+Noun+A3sg+Pnon+Nom
yaptırım	yaptırım+Noun+A3sg+Pnon+Nom
taciz	taciz+Noun+A3sg+Pnon+Nom
veli	veli+Noun+A3sg+Pnon+Nom
şehit	şehit+Noun+A3sg+Pnon+Nom
şahıs	şahıs+Noun+A3sg+Pnon+Nom
itham	itham+Noun+A3sg+Pnon+Nom
hakkaniyet	hakkaniyet+Noun+A3sg+Pnon+Nom
yassı	yassı+Adj
fındık	fındık+Noun+A3sg+Pnon+Nom
bayramki	bayramki+Noun+A3sg+Pnon+Nom
dağıtım	dağıtım+Noun+A3sg+Pnon+Nom
hümanist	hümanist+Noun+A3sg+Pnon+Nom
tevhid	tevhid+Noun+A3sg+Pnon+Nom
tedrisat	tedrisat+Noun+A3sg+Pnon+Nom
vahşet	vahşet+Noun+A3sg+Pnon+Nom
kariptos	kariptos+Noun+A3sg+Pnon+Nom
referandum	referandum+Noun+A3sg+Pnon+Nom
tasvir	tasvir+Noun+A3sg+Pnon+Nom
şiirsel	şiirsel+Adj
tefekkür	tefekkür+Noun+A3sg+Pnon+Nom
otoban	otoban+Noun+A3sg+Pnon+Nom
yürü	yürü+Verb+Pos+Imp+A2sg
kafir	kafir+Noun+A3sg+Pnon+Nom
çatal	çatal+Noun+A3sg+Pnon+Nom
mekruh	mekruh+Adj
mastika	mastika+Noun+A3sg+Pnon+Nom
mütareke	mütareke+Noun+A3sg+Pnon+Nom
sure	sure+Noun+A3sg+Pnon+Nom
umre	umre+Noun+A3sg+Pnon+Nom
nitelik	nitelik+Noun+A3sg+Pnon+Nom
baraj	baraj+Noun+A3sg+Pnon+Nom
balıkçılık	balıkçılık+Noun+A3sg+Pnon+Nom
butik	butik+Noun+A3sg+Pnon+Nom
hayvancılık	hayvancılık+Noun+A3sg+Pnon+Nom
yatırımcı	yatırımcı+Noun+A3sg+Pnon+Nom
çevresel	çevresel+Adj
keçe	keçe+Noun+A3sg+Pnon+Nom
sedef	sedef+Noun+A3sg+Pnon+Nom
titanyum	titanyum+Noun+A3sg+Pnon+Nom
avize	avize+Noun+A3sg+Pnon+Nom
onyx	onyx+Noun+A3sg+Pnon+Nom
kristal	kristal+Noun+A3sg+Pnon+Nom
abanoz	abanoz+Noun+A3sg+Pnon+Nom
vuslat	vuslat+Noun+A3sg+Pnon+Nom
arus	arus+Noun+A3sg+Pnon+Nom
tören	tören+Noun+A3sg+Pnon+Nom
sema	sema+Noun+A3sg+Pnon+Nom
mutrıp	mutrıp+Noun+A3sg+Pnon+Nom
tasavvuf	tasavvuf+Noun+A3sg+Pnon+Nom
mesnevi	mesnevi+Noun+A3sg+Pnon+Nom
ebru	ebru+Noun+A3sg+Pnon+Nom
kompozisyon	kompozisyon+Noun+A3sg+Pnon+Nom
makale	makale+Noun+A3sg+Pnon+Nom
mevlevihane	mevlevihane+Noun+A3sg+Pnon+Nom
yadigar	yadigar+Noun+A3sg+Pnon+Nom
mescid	mescid+Noun+A3sg+Pnon+Nom
mitoloji	mitoloji+Noun+A3sg+Pnon+Nom
egzotik	egzotik+Adj
destansı	destansı+Adj
volkanik	volkanik+Adj
dikili	dikili+Adj
konuksever	konuksever+Adj
etnografik	etnografik+Adj
tahrip	tahrip+Noun+A3sg+Pnon+Nom
kraliyet	kraliyet+Noun+A3sg+Pnon+Nom
hac	hac+Noun+A3sg+Pnon+Nom
tütsü	tütsü+Noun+A3sg+Pnon+Nom
bambu	bambu+Noun+A3sg+Pnon+Nom
çömlek	çömlek+Noun+A3sg+Pnon+Nom
göçebe	göçebe+Noun+A3sg+Pnon+Nom
insanımsılar	insanımsılar+Noun+A3pl+Pnon+Nom
hominid	hominid+Noun+A3sg+Pnon+Nom
buluntu	buluntu+Noun+A3sg+Pnon+Nom
with	with+Noun+A3sg+Pnon+Nom
homo	homo+Noun+A3sg+Pnon+Nom
animist	animist+Noun+A3sg+Pnon+Nom
plato	plato+Noun+A3sg+Pnon+Nom
akciğer	akciğer+Noun+A3sg+Pnon+Nom
linç	linç+Noun+A3sg+Pnon+Nom
bayrak	bayrak+Noun+A3sg+Pnon+Nom
gözaltı	gözaltı+Noun+A3sg+Pnon+Nom
cıvıl	cıvıl+Dup
yanıtlılyor	yanıtlılyor+Noun+A3sg+Pnon+Nom
milliyetçilik	milliyetçilik+Noun+A3sg+Pnon+Nom
iktisadi	iktisadi+Adj
küresel	küresel+Adj
dışsal	dışsal+Adj
çağrı	çağrı+Noun+A3sg+Pnon+Nom
ülkücü	ülkücü+Noun+A3sg+Pnon+Nom
nizam	nizam+Noun+A3sg+Pnon+Nom
füze	füze+Noun+A3sg+Pnon+Nom
tatbikat	tatbikat+Noun+A3sg+Pnon+Nom
uranyum	uranyum+Noun+A3sg+Pnon+Nom
hardal	hardal+Noun+A3sg+Pnon+Nom
gazi	gazi+Noun+A3sg+Pnon+Nom
nükleer	nükleer+Adj
yasadışı	yasadışı+Adj
alenen	alenen+Adverb
haraç	haraç+Noun+A3sg+Pnon+Nom
mezat	mezat+Noun+A3sg+Pnon+Nom
yanlı	yanlı+Adj
tümör	tümör+Noun+A3sg+Pnon+Nom
diyaliz	diyaliz+Noun+A3sg+Pnon+Nom
suni	suni+Adj
tan	tan+Noun+A3sg+Pnon+Nom
paranoya	paranoya+Noun+A3sg+Pnon+Nom
mücevher	mücevher+Noun+A3sg+Pnon+Nom
çıkardıkler	çıkardıkler+Noun+A3sg+Pnon+Nom
metropol	metropol+Noun+A3sg+Pnon+Nom
houte	houte+Noun+A3sg+Pnon+Nom
couture	couture+Noun+A3sg+Pnon+Nom
öncü	öncü+Noun+A3sg+Pnon+Nom
vizyon	vizyon+Noun+A3sg+Pnon+Nom
kaldıraç	kaldıraç+Noun+A3sg+Pnon+Nom
parfüm	parfüm+Noun+A3sg+Pnon+Nom
meydan	meydan+Noun+A3sg+Pnon+Nom
refah	refah+Noun+A3sg+Pnon+Nom
ermeni	ermeni+Noun+A3sg+Pnon+Nom
söylediğ	söylediğ+Noun+A3sg+Pnon+Nom
ast	ast+Adj
taktir	taktir+Noun+A3sg+Pnon+Nom
roaming	roaming+Noun+A3sg+Pnon+Nom
doruk	doruk+Noun+A3sg+Pnon+Nom
network	network+Noun+A3sg+Pnon+Nom
bilişim	bilişim+Noun+A3sg+Pnon+Nom
sertifikasyon	sertifikasyon+Noun+A3sg+Pnon+Nom
dizayn	dizayn+Noun+A3sg+Pnon+Nom
kurumsal	kurumsal+Adj
önkoşul	önkoşul+Noun+A3sg+Pnon+Nom
dokümantasyon	dokümantasyon+Noun+A3sg+Pnon+Nom
potansiyel	potansiyel+Noun+A3sg+Pnon+Nom
barkod	barkod+Noun+A3sg+Pnon+Nom
gofret	gofret+Noun+A3sg+Pnon+Nom
prezervatif	prezervatif+Noun+A3sg+Pnon+Nom
tıraş	tıraş+Noun+A3sg+Pnon+Nom
kalifiye	kalifiye+Adj
operasyonel	operasyonel+Adj
astronomik	astronomik+Adj
vs	vs+Noun+A3sg+Pnon+Nom
repo	repo+Noun+A3sg+Pnon+Nom
müracat	müracat+Noun+A3sg+Pnon+Nom
sual	sual+Noun+A3sg+Pnon+Nom
bal	bal+Noun+A3sg+Pnon+Nom
işbirlikçi	işbirlikçi+Noun+A3sg+Pnon+Nom
rant	rant+Noun+A3sg+Pnon+Nom
ideoloji	ideoloji+Noun+A3sg+Pnon+Nom
hüner	hüner+Noun+A3sg+Pnon+Nom
elzem	elzem+Adj
vatandaş	vatandaş+Noun+A3sg+Pnon+Nom
aşina	aşina+Adj
d	d+Noun+A3sg+Pnon+Nom
hazım	hazım+Noun+A3sg+Pnon+Nom
birey	birey+Noun+A3sg+Pnon+Nom
tümden	tümden+Adverb
gelim	gelim+Noun+A3sg+Pnon+Nom
beğeni	beğeni+Noun+A3sg+Pnon+Nom
çapkın	çapkın+Adj
mühendis	mühendis+Noun+A3sg+Pnon+Nom
ceberut	ceberut+Noun+A3sg+Pnon+Nom
adap	adap+Noun+A3sg+Pnon+Nom
vaka	vaka+Noun+A3sg+Pnon+Nom
bilgiişlem	bilgiişlem+Noun+A3sg+Pnon+Nom
sallapati	sallapati+Adj
öğlen	öğlen+Noun+A3sg+Pnon+Nom
arsa	arsa+Noun+A3sg+Pnon+Nom
kooperatif	kooperatif+Noun+A3sg+Pnon+Nom
münhasıran	münhasıran+Adverb
kazanç	kazanç+Noun+A3sg+Pnon+Nom
ayni	ayni+Adj
tapu	tapu+Noun+A3sg+Pnon+Nom
şerh	şerh+Noun+A3sg+Pnon+Nom
muafiyet	muafiyet+Noun+A3sg+Pnon+Nom
muz	muz+Noun+A3sg+Pnon+Nom
trilyonlarca	trilyonlarca+Num+Card
evrak	evrak+Noun+A3sg+Pnon+Nom
tevşvik	tevşvik+Noun+A3sg+Pnon+Nom
minübüs	minübüs+Noun+A3sg+Pnon+Nom
zula	zula+Noun+A3sg+Pnon+Nom
mazot	mazot+Noun+A3sg+Pnon+Nom
şayet	şayet+Conj
lot	lot+Noun+A3sg+Pnon+Nom
kapkaççı	kapkaççı+Noun+A3sg+Pnon+Nom
kapkaç	kapkaç+Noun+A3sg+Pnon+Nom
siber	siber+Adj
telematik	telematik+Noun+A3sg+Pnon+Nom
beygir	beygir+Noun+A3sg+Pnon+Nom
ralli	ralli+Noun+A3sg+Pnon+Nom
co	co+Noun+A3sg+Pnon+Nom
kaz	kaz+Noun+A3sg+Pnon+Nom
vatandaşlık	vatandaşlık+Noun+A3sg+Pnon+Nom
çark	çark+Noun+A3sg+Pnon+Nom
sokun	sokun+Noun+A3sg+Pnon+Nom
lokantacı	lokantacı+Noun+A3sg+Pnon+Nom
harç	harç+Noun+A3sg+Pnon+Nom
keriz	keriz+Noun+A3sg+Pnon+Nom
tekerlek	tekerlek+Noun+A3sg+Pnon+Nom
polen	polen+Noun+A3sg+Pnon+Nom
far	far+Noun+A3sg+Pnon+Nom
reziztans	reziztans+Noun+A3sg+Pnon+Nom
rot	rot+Noun+A3sg+Pnon+Nom
balans	balans+Noun+A3sg+Pnon+Nom
kalorifer	kalorifer+Noun+A3sg+Pnon+Nom
klima	klima+Noun+A3sg+Pnon+Nom
kaporta	kaporta+Noun+A3sg+Pnon+Nom
hidrolik	hidrolik+Noun+A3sg+Pnon+Nom
diferansiyel	diferansiyel+Noun+A3sg+Pnon+Nom
şanzıman	şanzıman+Noun+A3sg+Pnon+Nom
amortisör	amortisör+Noun+A3sg+Pnon+Nom
rezistans	rezistans+Noun+A3sg+Pnon+Nom
motorize	motorize+Adj
malesef	malesef+Noun+A3sg+Pnon+Nom
sinerji	sinerji+Noun+A3sg+Pnon+Nom
yurtiçi	yurtiçi+Adj
minimum	minimum+Adj
road	road+Noun+A3sg+Pnon+Nom
dekore	dekore+Adj
kırılgan	kırılgan+Adj
guvaş	guvaş+Noun+A3sg+Pnon+Nom
karakalem	karakalem+Noun+A3sg+Pnon+Nom
yağlıboya	yağlıboya+Noun+A3sg+Pnon+Nom
mısır	mısır+Noun+A3sg+Pnon+Nom
turşu	turşu+Noun+A3sg+Pnon+Nom
biyografi	biyografi+Noun+A3sg+Pnon+Nom
grafiker	grafiker+Noun+A3sg+Pnon+Nom
desinatör	desinatör+Noun+A3sg+Pnon+Nom
tuval	tuval+Noun+A3sg+Pnon+Nom
pano	pano+Noun+A3sg+Pnon+Nom
yıldırım	yıldırım+Noun+A3sg+Pnon+Nom
reyting	reyting+Noun+A3sg+Pnon+Nom
tez	tez+Noun+A3sg+Pnon+Nom
alem	alem+Noun+A3sg+Pnon+Nom
politikacı	politikacı+Noun+A3sg+Pnon+Nom
solo	solo+Noun+A3sg+Pnon+Nom
gitarist	gitarist+Noun+A3sg+Pnon+Nom
piyanist	piyanist+Noun+A3sg+Pnon+Nom
arpist	arpist+Noun+A3sg+Pnon+Nom
soprano	soprano+Noun+A3sg+Pnon+Nom
mezzo	mezzo+Noun+A3sg+Pnon+Nom
yapım	yapım+Noun+A3sg+Pnon+Nom
yayıncı	yayıncı+Noun+A3sg+Pnon+Nom
dia	dia+Noun+A3sg+Pnon+Nom
dinleti	dinleti+Noun+A3sg+Pnon+Nom
interaktif	interaktif+Noun+A3sg+Pnon+Nom
panel	panel+Noun+A3sg+Pnon+Nom
söyleşi	söyleşi+Noun+A3sg+Pnon+Nom
cafe	cafe+Noun+A3sg+Pnon+Nom
çiklet	çiklet+Noun+A3sg+Pnon+Nom
house	house+Noun+A3sg+Pnon+Nom
prograsiv	prograsiv+Noun+A3sg+Pnon+Nom
akım	akım+Noun+A3sg+Pnon+Nom
hatun	hatun+Noun+A3sg+Pnon+Nom
gay	gay+Noun+A3sg+Pnon+Nom
şarkıcı	şarkıcı+Noun+A3sg+Pnon+Nom
dobra	dobra+Dup
tabu	tabu+Noun+A3sg+Pnon+Nom
puzzle	puzzle+Noun+A3sg+Pnon+Nom
ortaoyunu	ortaoyunu+Noun+A3sg+P3sg+Nom
mastır	mastır+Noun+A3sg+Pnon+Nom
esrar	esrar+Noun+A3sg+Pnon+Nom
hobi	hobi+Noun+A3sg+Pnon+Nom
medyatik	medyatik+Adj
mamül	mamül+Adj
platform	platform+Noun+A3sg+Pnon+Nom
taşeron	taşeron+Noun+A3sg+Pnon+Nom
