eski	eski	Adj	Adj
yoğunuz	yok	Adj	Noun
üzgün	üzgün	Adj	Adj
lazım	lazım	Adj	Adj
duygusal	duygusal	Adj	Adj
iyileşen	iyi	Adj	Adj
ciddi	ciddi	Adj	Adj
ibaret	ibaret	Adj	Adj
aptalca	aptal	Adj	Adj
muhteşem	muhteşem	Adj	Adj
harika	harika	Adj	Adj
emin	emin	Adj	Adj
kadınlığın	kadın	Adj	Noun
hayvanlaştırdığı	hayvan	Adj	Adj
uzaklaştıran	uzak	Adj	Adj
mecbur	mecbur	Adj	Adj
fevkalade	fevkalade	Adj	Adj
kötü	kötü	Adj	Adj
hazır	hazır	Adj	Adj
koyu	koyu	Adj	Adj
bulanık	bulanık	Adj	Adj
fazlaca	fazla	Adj	Adj
güzelleşen	güzel	Adj	Adj
solgun	solgun	Adj	Adj
suniydi	suni	Adj	Verb
kökleşmişti	kök	Adj	Verb
zorlaşacak	zor	Adj	Adj
mümkün	mümkün	Adj	Adj
doğrusunu	doğru	Adj	Noun
memnundu	memnu	Adj	Verb
büyük	büyük	Adj	Adj
dolu	dolu	Adj	Adj
yerindeyse	yerinde	Adj	Verb
peltekleşmişti	peltek	Adj	Verb
belli	belli	Adj	Adj
parlak	parlak	Adj	Adj
aziz	aziz	Adj	Adj
sapsarı	sapsarı	Adj	Adj
bitkin	bitkin	Adj	Adj
yumuşak	yumuşak	Adj	Adj
genç	genç	Adj	Adj
temiz	temiz	Adj	Adj
düşüncelisiniz	düşüncel	Adj	Verb
saf	saf	Adj	Adj
çıplak	çıplak	Adj	Adj
sertçe	sert	Adj	Adj
sakin	sakin	Adj	Adj
bambaşka	bambaşka	Adj	Adj
karmaşık	karmaşık	Adj	Adj
geniş	geniş	Adj	Adj
başkasına	başka	Adj	Noun
düşkün	düşkün	Adj	Adj
şaşkın	şaşkın	Adj	Adj
alışkanlığım	alışkan	Adj	Noun
öyledir	öyle	Adj	Verb
razı	razı	Adj	Adj
yalnızlığımı	yalnız	Adj	Noun
ıslak	ıslak	Adj	Adj
donuk	donuk	Adj	Adj
açıktaki	açık	Adj	Adj
yavaş	yavaş	Adj	Adj
garip	garip	Adj	Adj
yabancı	yabancı	Adj	Adj
nasılsın	nasıl	Adj	Verb
kutsal	kutsal	Adj	Adj
beter	beter	Adj	Adj
delikanlılar	delikanlı	Adj	Noun
kaba	kaba	Adj	Adj
bol	bol	Adj	Adj
sağlam	sağlam	Adj	Adj
beraberiz	beraber	Adj	Verb
gergin	gergin	Adj	Adj
huysuzlaşıyor	huysuz	Adj	Verb
kapalı	kapalı	Adj	Adj
ilginç	ilginç	Adj	Adj
yoksun	yoksun	Adj	Adj
soğuk	soğuk	Adj	Adj
hoş	hoş	Adj	Adj
ana	ana	Adj	Adj
uyanık	uyanık	Adj	Adj
aşikar	aşikar	Adj	Adj
aynı	aynı	Adj	Adj
uzunlu	uzun	Adj	Adj
tedirgin	tedirgin	Adj	Adj
yakındaki	yakın	Adj	Adj
egemen	egemen	Adj	Adj
ürkek	ürkek	Adj	Adj
ağırlaştığı	ağır	Adj	Adj
kamburlaşmıştı	kambur	Adj	Verb
seyrek	seyrek	Adj	Adj
zayıf	zayıf	Adj	Adj
nazik	nazik	Adj	Adj
mahkum	mahkum	Adj	Adj
tombul	tombul	Adj	Adj
siyahımsı	siyah	Adj	Adj
çirkin	çirkin	Adj	Adj
bitişik	bitişik	Adj	Adj
ters	ters	Adj	Adj
dönük	dönük	Adj	Adj
topaldı	topal	Adj	Verb
göreceli	göreceli	Adj	Adj
alışık	alışık	Adj	Adj
deli	deli	Adj	Adj
adil	adil	Adj	Adj
şişkosunuz	şişko	Adj	Verb
bön	bön	Adj	Adj
böylesi	böyle	Adj	Noun
zengin	zengin	Adj	Adj
kolay	kolay	Adj	Adj
yoğunlaştıran	yoğun	Adj	Adj
karmakarışık	karmakarışık	Adj	Adj
meşgul	meşgul	Adj	Adj
tekli	tek	Adj	Adj
bayağıydı	bayağı	Adj	Verb
kıpkırmızıydı	kıpkırmızı	Adj	Verb
benzeri	benzeri	Adj	Adj
sahte	sahte	Adj	Adj
dayanıklı	dayanıklı	Adj	Adj
iğrenç	iğrenç	Adj	Adj
bozuk	bozuk	Adj	Adj
has	has	Adj	Adj
bembeyaz	bembeyaz	Adj	Adj
çatlak	çatlak	Adj	Adj
aksi	aksi	Adj	Adj
çok	çok	Adj	Adj
kahverengi	kahverengi	Adj	Adj
buçuk	buçuk	Adj	Adj
yeterli	yeterli	Adj	Adj
esnek	esnek	Adj	Adj
inatçı	inatçı	Adj	Adj
yetersiz	yetersiz	Adj	Adj
alçakça	alçak	Adj	Adj
kabarık	kabarık	Adj	Adj
karanlık	karanlık	Adj	Adj
yuvarlak	yuvarlak	Adj	Adj
hantallaşmıştı	hantal	Adj	Verb
silikleşiyordu	silik	Adj	Verb
kör	kör	Adj	Adj
boş	boş	Adj	Adj
ağırbaşlı	ağırbaşlı	Adj	Adj
birinde	bir	Adj	Noun
serbestçe	serbest	Adj	Adj
yaygınlaştığı	yaygın	Adj	Adj
değişik	değişik	Adj	Adj
mutlu	mutlu	Adj	Adj
düşmanca	düşman	Adj	Adj
dobralık	dobra	Adj	Noun
basit	basit	Adj	Adj
kırık	kırık	Adj	Adj
diğer	diğer	Adj	Adj
kesinleşen	kesin	Adj	Adj
bencillik	bencil	Adj	Noun
gülünç	gülünç	Adj	Adj
sevgili	sevgili	Adj	Adj
yanlışlığı	yanlış	Adj	Noun
bireyciliğin	bireyci	Adj	Noun
standart	standart	Adj	Adj
pişman	pişman	Adj	Adj
kızıl	kızıl	Adj	Adj
bunaklığından	bunak	Adj	Noun
zavallı	zavallı	Adj	Adj
küstahlığında	küstah	Adj	Noun
duyarlı	duyarlı	Adj	Adj
acayip	acayip	Adj	Adj
ihtiyar	ihtiyar	Adj	Adj
kürk	kürk	Adj	Adj
budalaca	budala	Adj	Adj
açgözlülük	açgözlü	Adj	Noun
kepazeliği	kepaze	Adj	Noun
ıssızlaşan	ıssız	Adj	Adj
asil	asil	Adj	Adj
áşık	aşık	Adj	Adj
kibar	kibar	Adj	Adj
saçma	saçma	Adj	Adj
adi	adi	Adj	Adj
alan	ala	Adj	Noun
hoşnutsuzluğu	hoşnutsuz	Adj	Noun
ahmak	ahmak	Adj	Adj
fedakar	fedakar	Adj	Adj
hesaplı	hesaplı	Adj	Adj
enayi	enayi	Adj	Adj
acele	acele	Adj	Adj
kalma	kalma	Adj	Adj
sade	sade	Adj	Adj
dağınık	dağınık	Adj	Adj
yeşil	yeşil	Adj	Adj
kızgın	kızgın	Adj	Adj
azmanı	azman	Adj	Noun
düzleştiren	düz	Adj	Adj
kasıla	kasıl	Adj	Noun
saygın	saygın	Adj	Adj
revan	reva	Adj	Noun
durgun	durgun	Adj	Adj
geçenleri	geçen	Adj	Noun
sarı	sarı	Adj	Adj
yorgun	yorgun	Adj	Adj
derinleşen	derin	Adj	Adj
körpecik	körpe	Adj	Noun
failini	fail	Adj	Noun
ölgünlüğüne	ölgün	Adj	Noun
çeviklikle	çevik	Adj	Noun
üstündeki	üstün	Adj	Adj
alınganlık	alıngan	Adj	Noun
sıkılgan	sıkılgan	Adj	Adj
çekingen	çekingen	Adj	Adj
aşırı	aşırı	Adj	Adj
aydın	aydın	Adj	Adj
çifte	çifte	Adj	Adj
rahatça	rahat	Adj	Adj
pis	pis	Adj	Adj
bütün	bütün	Adj	Adj
pul	pul	Adj	Adj
batı	batı	Adj	Adj
ince	ince	Adj	Adj
haylazlıktan	haylaz	Adj	Noun
kurak	kurak	Adj	Adj
yükseklikteki	yüksek	Adj	Adj
memnun	memnun	Adj	Adj
normal	normal	Adj	Adj
olgun	olgun	Adj	Adj
özgürce	özgür	Adj	Adj
kısa	kısa	Adj	Adj
ekonomik	ekonomik	Adj	Adj
sosyal	sosyal	Adj	Adj
somut	somut	Adj	Adj
aykırı	aykırı	Adj	Adj
muazzam	muazzam	Adj	Adj
dakik	dakik	Adj	Adj
karışık	karışık	Adj	Adj
evli	evli	Adj	Adj
berbat	berbat	Adj	Adj
peyda	peyda	Adj	Adj
dramatik	dramatik	Adj	Adj
küçük	küçük	Adj	Adj
şahsi	şahsi	Adj	Adj
yeni	yeni	Adj	Adj
resmi	resmi	Adj	Adj
ufak	ufak	Adj	Adj
herhangi	herhangi	Adj	Adj
ahlaki	ahlaki	Adj	Adj
cömert	cömert	Adj	Adj
organize	organize	Adj	Adj
safi	safi	Adj	Adj
alicenap	alicenap	Adj	Adj
aşağılık	aşağılık	Adj	Adj
ani	ani	Adj	Adj
olağanüstü	olağanüstü	Adj	Adj
yakışıklı	yakışıklı	Adj	Adj
rengarenk	rengarenk	Adj	Adj
kadife	kadife	Adj	Adj
dar	dar	Adj	Adj
çapraz	çapraz	Adj	Adj
zarif	zarif	Adj	Adj
kırmızılı	kırmızı	Adj	Adj
nefis	nefis	Adj	Adj
enfes	enfes	Adj	Adj
beyazlı	beyaz	Adj	Adj
reşit	reşit	Adj	Adj
layık	layık	Adj	Adj
şöyle	şöyle	Adj	Adj
modern	modern	Adj	Adj
sadık	sadık	Adj	Adj
gür	gür	Adj	Adj
hırçın	hırçın	Adj	Adj
bağnaz	bağnaz	Adj	Adj
korkunç	korkunç	Adj	Adj
medeni	medeni	Adj	Adj
nüktedan	nüktedan	Adj	Adj
tabii	tabii	Adj	Adj
benzersiz	benzersiz	Adj	Adj
gümüş	gümüş	Adj	Adj
kayıp	kayıp	Adj	Adj
şişman	şişman	Adj	Adj
devasa	devasa	Adj	Adj
tiz	tiz	Adj	Adj
uygun	uygun	Adj	Adj
hassas	hassas	Adj	Adj
manevi	manevi	Adj	Adj
sefil	sefil	Adj	Adj
sevimli	sevimli	Adj	Adj
utangaç	utangaç	Adj	Adj
ayan	ayan	Adj	Adj
yapay	yapay	Adj	Adj
harcıalem	harcıalem	Adj	Adj
buruk	buruk	Adj	Adj
müthiş	müthiş	Adj	Adj
gizli	gizli	Adj	Adj
rezil	rezil	Adj	Adj
tatlı	tatlı	Adj	Adj
kuytu	kuytu	Adj	Adj
türlü	türlü	Adj	Adj
eşit	eşit	Adj	Adj
sıcak	sıcak	Adj	Adj
kalın	kalın	Adj	Adj
özel	özel	Adj	Adj
yüce	yüce	Adj	Adj
paramparça	paramparça	Adj	Adj
kıvrak	kıvrak	Adj	Adj
cici	cici	Adj	Adj
ufacık	ufacık	Adj	Adj
coşkun	coşkun	Adj	Adj
mağrur	mağrur	Adj	Adj
bunca	bunca	Adj	Adj
mükemmel	mükemmel	Adj	Adj
taze	taze	Adj	Adj
çekici	çekici	Adj	Adj
dizüstü	dizüstü	Adj	Adj
olanca	olanca	Adj	Adj
hangi	hangi	Adj	Adj
diri	diri	Adj	Adj
dimdik	dimdik	Adj	Adj
eğik	eğik	Adj	Adj
müspet	müspet	Adj	Adj
belirsiz	belirsiz	Adj	Adj
haftalık	haftalık	Adj	Adj
zamansız	zamansız	Adj	Adj
terbiyeli	terbiyeli	Adj	Adj
soğukkanlı	soğukkanlı	Adj	Adj
nail	nail	Adj	Adj
dalgın	dalgın	Adj	Adj
altın	altın	Adj	Adj
kişisel	kişisel	Adj	Adj
belirli	belirli	Adj	Adj
samimi	samimi	Adj	Adj
mahsus	mahsus	Adj	Adj
mavi	mavi	Adj	Adj
meşhur	meşhur	Adj	Adj
mühim	mühim	Adj	Adj
keskin	keskin	Adj	Adj
başlıca	başlıca	Adj	Adj
öbür	öbür	Adj	Adj
ertesi	ertesi	Adj	Adj
romantik	romantik	Adj	Adj
ahşap	ahşap	Adj	Adj
çevrili	çevrili	Adj	Adj
sayın	sayın	Adj	Adj
binbir	binbir	Adj	Adj
kocaman	kocaman	Adj	Adj
yetişkin	yetişkin	Adj	Adj
sağır	sağır	Adj	Adj
tıknaz	tıknaz	Adj	Adj
yemyeşil	yemyeşil	Adj	Adj
taptaze	taptaze	Adj	Adj
sarımtırak	sarımtırak	Adj	Adj
sipsivri	sipsivri	Adj	Adj
ölümcül	ölümcül	Adj	Adj
adamakıllı	adamakıllı	Adj	Adj
dümdüz	dümdüz	Adj	Adj
vahşi	vahşi	Adj	Adj
içgüdüsel	içgüdüsel	Adj	Adj
sıkı	sıkı	Adj	Adj
olası	olası	Adj	Adj
girişken	girişken	Adj	Adj
bezgin	bezgin	Adj	Adj
mini	mini	Adj	Adj
zalimce	zalim	Adj	Adj
acımasızca	acımasız	Adj	Adj
dürüst	dürüst	Adj	Adj
ayırt	ayırt	Adj	Adj
sınırsız	sınırsız	Adj	Adj
ortak	ortak	Adj	Adj
hafifçe	hafif	Adj	Adj
evcil	evcil	Adj	Adj
aylak	aylak	Adj	Adj
leziz	leziz	Adj	Adj
incecik	incecik	Adj	Adj
yabani	yabani	Adj	Adj
esas	esas	Adj	Adj
yalın	yalın	Adj	Adj
koskoca	koskoca	Adj	Adj
başıboş	başıboş	Adj	Adj
oynak	oynak	Adj	Adj
restore	restore	Adj	Adj
kagir	kagir	Adj	Adj
iri	iri	Adj	Adj
acıklı	acıklı	Adj	Adj
ruhsal	ruhsal	Adj	Adj
küçücük	küçücük	Adj	Adj
düzgün	düzgün	Adj	Adj
sıcakkanlı	sıcakkanlı	Adj	Adj
şaşmaz	şaşmaz	Adj	Adj
köhne	köhne	Adj	Adj
ilahi	ilahi	Adj	Adj
cılız	cılız	Adj	Adj
geçer	geçer	Adj	Adj
paralel	paralel	Adj	Adj
züppe	züppe	Adj	Adj
seçkin	seçkin	Adj	Adj
zekice	zeki	Adj	Adj
narin	narin	Adj	Adj
yapayalnız	yapayalnız	Adj	Adj
çift	çift	Adj	Adj
kaçık	kaçık	Adj	Adj
girgin	girgin	Adj	Adj
peşindeki	peşin	Adj	Adj
uygunsuz	uygunsuz	Adj	Adj
apaçık	apaçık	Adj	Adj
gevrek	gevrek	Adj	Adj
çinko	çinko	Adj	Adj
yırtık	yırtık	Adj	Adj
mızmız	mızmız	Adj	Adj
haşarı	haşarı	Adj	Adj
müstehcen	müstehcen	Adj	Adj
dinç	dinç	Adj	Adj
ayrı	ayrı	Adj	Adj
sinsi	sinsi	Adj	Adj
muzip	muzip	Adj	Adj
günahkar	günahkar	Adj	Adj
ziyade	ziyade	Adj	Adj
koskocaman	koskocaman	Adj	Adj
gebe	gebe	Adj	Adj
fena	fena	Adj	Adj
kısık	kısık	Adj	Adj
rastgele	rastgele	Adj	Adj
yığılı	yığılı	Adj	Adj
yıkık	yıkık	Adj	Adj
çırılçıplak	çırılçıplak	Adj	Adj
püskü	püskü	Adj	Adj
porselen	porselen	Adj	Adj
şeftalili	şeftali	Adj	Adj
çürük	çürük	Adj	Adj
kötümser	kötümser	Adj	Adj
şeytani	şeytani	Adj	Adj
değişmez	değişmez	Adj	Adj
alışkın	alışkın	Adj	Adj
kurnaz	kurnaz	Adj	Adj
yarım	yarım	Adj	Adj
sımsıkı	sımsıkı	Adj	Adj
mütereddit	mütereddit	Adj	Adj
loş	loş	Adj	Adj
kaskatı	kaskatı	Adj	Adj
konuşkan	konuşkan	Adj	Adj
doğal	doğal	Adj	Adj
şık	şık	Adj	Adj
kopuk	kopuk	Adj	Adj
kesik	kesik	Adj	Adj
kupkuru	kupkuru	Adj	Adj
sevecen	sevecen	Adj	Adj
asabi	asabi	Adj	Adj
musallat	musallat	Adj	Adj
muvaffak	muvaffak	Adj	Adj
özgü	özgü	Adj	Adj
sırtüstü	sırtüstü	Adj	Adj
bariz	bariz	Adj	Adj
masum	masum	Adj	Adj
cahil	cahil	Adj	Adj
elimdeki	elim	Adj	Adj
genelindeki	genel	Adj	Adj
sarıklı	sarıklı	Adj	Adj
pitoresk	pitoresk	Adj	Adj
dağlık	dağlık	Adj	Adj
usluca	uslu	Adj	Adj
ebedi	ebedi	Adj	Adj
örtülü	örtülü	Adj	Adj
allak	allak	Adj	Adj
bullak	bullak	Adj	Adj
sapık	sapık	Adj	Adj
amansız	amansız	Adj	Adj
gaddar	gaddar	Adj	Adj
nalet	nalet	Adj	Adj
katı	katı	Adj	Adj
siyasal	siyasal	Adj	Adj
dışındaki	dışı	Adj	Adj
dinsel	dinsel	Adj	Adj
felsefi	felsefi	Adj	Adj
alegorik	alegorik	Adj	Adj
belgesel	belgesel	Adj	Adj
toplumsal	toplumsal	Adj	Adj
insancıl	insancıl	Adj	Adj
doğrudan	doğrudan	Adj	Adj
etkinleştirildiği	etkin	Adj	Adj
eleştirel	eleştirel	Adj	Adj
eşsiz	eşsiz	Adj	Adj
yapıcı	yapıcı	Adj	Adj
boğuk	boğuk	Adj	Adj
simsiyah	simsiyah	Adj	Adj
asık	asık	Adj	Adj
kapkara	kapkara	Adj	Adj
aciz	aciz	Adj	Adj
tekdüze	tekdüze	Adj	Adj
armonik	armonik	Adj	Adj
olağan	olağan	Adj	Adj
nemrut	nemrut	Adj	Adj
akim	akim	Adj	Adj
sivri	sivri	Adj	Adj
maruz	maruz	Adj	Adj
aralıksız	aralıksız	Adj	Adj
çatık	çatık	Adj	Adj
gücenik	gücenik	Adj	Adj
hoşnut	hoşnut	Adj	Adj
zıt	zıt	Adj	Adj
kaçınılmaz	kaçınılmaz	Adj	Adj
günlüğündeki	günlük	Adj	Adj
gencecik	gencecik	Adj	Adj
belirgin	belirgin	Adj	Adj
tabi	tabi	Adj	Adj
kafalı	kafalı	Adj	Adj
çorak	çorak	Adj	Adj
titrek	titrek	Adj	Adj
deşik	deşik	Adj	Adj
sarılı	sarılı	Adj	Adj
sırılsıklam	sırılsıklam	Adj	Adj
tehditkar	tehditkar	Adj	Adj
yatay	yatay	Adj	Adj
sarışın	sarışın	Adj	Adj
babacan	babacan	Adj	Adj
muzdarip	muzdarip	Adj	Adj
ketum	ketum	Adj	Adj
yaklaşık	yaklaşık	Adj	Adj
gevşek	gevşek	Adj	Adj
hayali	hayali	Adj	Adj
profesyonel	profesyonel	Adj	Adj
şairane	şairane	Adj	Adj
geçerli	geçerli	Adj	Adj
milli	milli	Adj	Adj
mutlak	mutlak	Adj	Adj
düşük	düşük	Adj	Adj
mütevazi	mütevazi	Adj	Adj
senelik	senelik	Adj	Adj
kem	kem	Adj	Adj
melez	melez	Adj	Adj
kıpkızıl	kıpkızıl	Adj	Adj
sabit	sabit	Adj	Adj
mesut	mesut	Adj	Adj
ucuz	ucuz	Adj	Adj
hayırlı	hayırlı	Adj	Adj
şen	şen	Adj	Adj
bitirim	bitirim	Adj	Adj
tuzlu	tuzlu	Adj	Adj
divane	divane	Adj	Adj
evvelsi	evvelsi	Adj	Adj
daim	daim	Adj	Adj
hor	hor	Adj	Adj
uysal	uysal	Adj	Adj
amade	amade	Adj	Adj
hatırşinas	hatırşinas	Adj	Adj
ihmalkar	ihmalkar	Adj	Adj
nadir	nadir	Adj	Adj
görmemiş	görmemiş	Adj	Adj
şahane	şahane	Adj	Adj
engin	engin	Adj	Adj
ticari	ticari	Adj	Adj
takma	takma	Adj	Adj
şişkin	şişkin	Adj	Adj
acil	acil	Adj	Adj
sömürgeci	sömürgeci	Adj	Adj
mutsuz	mutsuz	Adj	Adj
lüks	lüks	Adj	Adj
ödünç	ödünç	Adj	Adj
mütevazı	mütevazı	Adj	Adj
fiziksel	fiziksel	Adj	Adj
değişkenlerdeki	değişken	Adj	Adj
pespembe	pespembe	Adj	Adj
berrak	berrak	Adj	Adj
zorlu	zorlu	Adj	Adj
kalıtsal	kalıtsal	Adj	Adj
kindar	kindar	Adj	Adj
ılık	ılık	Adj	Adj
çarpık	çarpık	Adj	Adj
buruşuk	buruşuk	Adj	Adj
gönüllü	gönüllü	Adj	Adj
çakırkeyif	çakırkeyif	Adj	Adj
bedbaht	bedbaht	Adj	Adj
organik	organik	Adj	Adj
çocuksu	çocuksu	Adj	Adj
sıcacık	sıcacık	Adj	Adj
sıkkın	sıkkın	Adj	Adj
mahzun	mahzun	Adj	Adj
mezun	mezun	Adj	Adj
mesleki	mesleki	Adj	Adj
soyut	soyut	Adj	Adj
emekli	emekli	Adj	Adj
zinde	zinde	Adj	Adj
kayıtsız	kayıtsız	Adj	Adj
minik	minik	Adj	Adj
uyuşuk	uyuşuk	Adj	Adj
akıllıca	akıllıca	Adj	Adj
düzenbaz	düzenbaz	Adj	Adj
yapışkan	yapışkan	Adj	Adj
seyyar	seyyar	Adj	Adj
insanüstü	insanüstü	Adj	Adj
salim	salim	Adj	Adj
ekstra	ekstra	Adj	Adj
çocukça	çocukça	Adj	Adj
bomboş	bomboş	Adj	Adj
dopdolu	dopdolu	Adj	Adj
tertemiz	tertemiz	Adj	Adj
çın	çın	Adj	Adj
şakrak	şakrak	Adj	Adj
tok	tok	Adj	Adj
yersiz	yersiz	Adj	Adj
muhtemel	muhtemel	Adj	Adj
mahir	mahir	Adj	Adj
içli	içli	Adj	Adj
perişan	perişan	Adj	Adj
gaddarca	gaddarca	Adj	Adj
duyarsız	duyarsız	Adj	Adj
harap	harap	Adj	Adj
otobiyografik	otobiyografik	Adj	Adj
radikal	radikal	Adj	Adj
edebi	edebi	Adj	Adj
cinsel	cinsel	Adj	Adj
ahlaksal	ahlaksal	Adj	Adj
şehla	şehla	Adj	Adj
gayrimeşru	gayrimeşru	Adj	Adj
cazip	cazip	Adj	Adj
döşeli	döşeli	Adj	Adj
gözalıcı	gözalıcı	Adj	Adj
saçık	saçık	Adj	Adj
siyasi	siyasi	Adj	Adj
rahmetli	rahmetli	Adj	Adj
esrarengiz	esrarengiz	Adj	Adj
olumlu	olumlu	Adj	Adj
nazır	nazır	Adj	Adj
menkul	menkul	Adj	Adj
dayalı	dayalı	Adj	Adj
naçiz	naçiz	Adj	Adj
müteveffa	müteveffa	Adj	Adj
tutarlı	tutarlı	Adj	Adj
yerel	yerel	Adj	Adj
yapısal	yapısal	Adj	Adj
pozitif	pozitif	Adj	Adj
negatif	negatif	Adj	Adj
otomatikleştiremediğiniz	otomatik	Adj	Adj
bağımsız	bağımsız	Adj	Adj
bireysel	bireysel	Adj	Adj
bağımlı	bağımlı	Adj	Adj
çizili	çizi	Adj	Adj
italik	italik	Adj	Adj
dikey	dikey	Adj	Adj
geçici	geçici	Adj	Adj
toplu	toplu	Adj	Adj
karşıt	karşıt	Adj	Adj
elektronik	elektronik	Adj	Adj
yerleşik	yerleşik	Adj	Adj
çevrimiçi	çevrimiçi	Adj	Adj
masaüstünüzdeki	masaüstü	Adj	Adj
geçersiz	geçersiz	Adj	Adj
yönetimsel	yönetimsel	Adj	Adj
dinamik	dinamik	Adj	Adj
birincil	birincil	Adj	Adj
mantıksal	mantıksal	Adj	Adj
sezgisel	sezgisel	Adj	Adj
sanal	sanal	Adj	Adj
karma	karma	Adj	Adj
dijital	dijital	Adj	Adj
sayısal	sayısal	Adj	Adj
aritmetik	aritmetik	Adj	Adj
zorunlu	zorunlu	Adj	Adj
güncelleştirildiği	güncel	Adj	Adj
sağındaki	sağın	Adj	Adj
itici	itici	Adj	Adj
görsel	görsel	Adj	Adj
işlevsel	işlevsel	Adj	Adj
teknik	teknik	Adj	Adj
istatistiksel	istatistiksel	Adj	Adj
ortalama	ortalama	Adj	Adj
eşdeğer	eşdeğer	Adj	Adj
zorlama	zorlama	Adj	Adj
asimetrik	asimetrik	Adj	Adj
muaf	muaf	Adj	Adj
kısmi	kısmi	Adj	Adj
gezici	gezici	Adj	Adj
hiyerarşik	hiyerarşik	Adj	Adj
çoklu	çoklu	Adj	Adj
hiperbolik	hiperbolik	Adj	Adj
ardışık	ardışık	Adj	Adj
hurda	hurda	Adj	Adj
işlemsel	işlemsel	Adj	Adj
geometrik	geometrik	Adj	Adj
doğrusal	doğrusal	Adj	Adj
konur	konur	Adj	Adj
özgün	özgün	Adj	Adj
otonom	otonom	Adj	Adj
çizik	çizik	Adj	Adj
saklı	saklı	Adj	Adj
basılı	basılı	Adj	Adj
alfabetik	alfabetik	Adj	Adj
cari	cari	Adj	Adj
tekil	tekil	Adj	Adj
mobil	mobil	Adj	Adj
atık	atık	Adj	Adj
nötr	nötr	Adj	Adj
statik	statik	Adj	Adj
stratejik	stratejik	Adj	Adj
mor	mor	Adj	Adj
mali	mali	Adj	Adj
geleneksel	geleneksel	Adj	Adj
dahili	dahili	Adj	Adj
kategorize	kategorize	Adj	Adj
kümülatif	kümülatif	Adj	Adj
saydam	saydam	Adj	Adj
tutucu	tutucu	Adj	Adj
örtük	örtük	Adj	Adj
asal	asal	Adj	Adj
tümleşik	tümleşik	Adj	Adj
demokratik	demokratik	Adj	Adj
kırsal	kırsal	Adj	Adj
vahim	vahim	Adj	Adj
özürlü	özürlü	Adj	Adj
amatör	amatör	Adj	Adj
elverişsiz	elverişsiz	Adj	Adj
taburcu	taburcu	Adj	Adj
akut	akut	Adj	Adj
popüler	popüler	Adj	Adj
erkeksi	erkeksi	Adj	Adj
tipik	tipik	Adj	Adj
mikro	mikro	Adj	Adj
sevimsiz	sevimsiz	Adj	Adj
şirin	şirin	Adj	Adj
mukannen	mukannen	Adj	Adj
müslüman	müslüman	Adj	Adj
laik	laik	Adj	Adj
kültürel	kültürel	Adj	Adj
gözde	gözde	Adj	Adj
fahri	fahri	Adj	Adj
ulusal	ulusal	Adj	Adj
sonuncu	sonuncu	Adj	Adj
barışcıl	barışçıl	Adj	Adj
zanlı	zanlı	Adj	Adj
olumsuz	olumsuz	Adj	Adj
politik	politik	Adj	Adj
ikiyüzlü	ikiyüzlü	Adj	Adj
bedava	bedava	Adj	Adj
uyduruk	uyduruk	Adj	Adj
sanatsever	sanatsever	Adj	Adj
antik	antik	Adj	Adj
şeffaf	şeffaf	Adj	Adj
bilimsel	bilimsel	Adj	Adj
filan	filan	Adj	Adj
cimri	cimri	Adj	Adj
çiğ	çiğ	Adj	Adj
turistikleşen	turistik	Adj	Adj
yerli	yerli	Adj	Adj
klasik	klasik	Adj	Adj
çağdaş	çağdaş	Adj	Adj
bonkör	bonkör	Adj	Adj
fanatik	fanatik	Adj	Adj
apar	apar	Adj	Adj
uygarca	uygar	Adj	Adj
orijinal	orijinal	Adj	Adj
müteşebbis	müteşebbis	Adj	Adj
perakende	perakende	Adj	Adj
kanserojen	kanserojen	Adj	Adj
batık	batık	Adj	Adj
yumuşacık	yumuşacık	Adj	Adj
atmosferik	atmosferik	Adj	Adj
rutin	rutin	Adj	Adj
manyetik	manyetik	Adj	Adj
alakart	alakart	Adj	Adj
stabilize	stabilize	Adj	Adj
yurtdışı	yurtdışı	Adj	Adj
modernize	modernize	Adj	Adj
mimari	mimari	Adj	Adj
merkezindeki	merkezi	Adj	Adj
ender	ender	Adj	Adj
panoramik	panoramik	Adj	Adj
bakir	bakir	Adj	Adj
kumsal	kumsal	Adj	Adj
tük	tük	Adj	Adj
kentsel	kentsel	Adj	Adj
idari	idari	Adj	Adj
azami	azami	Adj	Adj
mustarip	mustarip	Adj	Adj
girift	girift	Adj	Adj
abuk	abuk	Adj	Adj
empoze	empoze	Adj	Adj
kombine	kombine	Adj	Adj
nafile	nafile	Adj	Adj
gözüpek	gözüpek	Adj	Adj
makul	makul	Adj	Adj
peşpeşe	peşpeşe	Adj	Adj
lacivertli	lacivert	Adj	Adj
fast	fast	Adj	Adj
güzelim	güzelim	Adj	Adj
içiçe	içiçe	Adj	Adj
konsantre	konsantre	Adj	Adj
tutuk	tutuk	Adj	Adj
efsanevi	efsanevi	Adj	Adj
altüst	altüst	Adj	Adj
motive	motive	Adj	Adj
maddi	maddi	Adj	Adj
adapte	adapte	Adj	Adj
uçuk	uçuk	Adj	Adj
mağlup	mağlup	Adj	Adj
sportif	sportif	Adj	Adj
ferdi	ferdi	Adj	Adj
teorik	teorik	Adj	Adj
çalışkan	çalışkan	Adj	Adj
itaatkar	itaatkar	Adj	Adj
kritik	kritik	Adj	Adj
acizane	acizane	Adj	Adj
tecavüzkar	tecavüzkar	Adj	Adj
yanık	yanık	Adj	Adj
mümtaz	mümtaz	Adj	Adj
endüstriyel	endüstriyel	Adj	Adj
tektip	tektip	Adj	Adj
fukara	fukara	Adj	Adj
yasal	yasal	Adj	Adj
kaçıncı	kaçıncı	Adj	Adj
suskun	suskun	Adj	Adj
özerk	özerk	Adj	Adj
anti	anti	Adj	Adj
parasal	parasal	Adj	Adj
matematiksel	matematiksel	Adj	Adj
izole	izole	Adj	Adj
mahrum	mahrum	Adj	Adj
erotik	erotik	Adj	Adj
abes	abes	Adj	Adj
tarihindeki	tarihi	Adj	Adj
habis	habis	Adj	Adj
turuncu	turuncu	Adj	Adj
bedensel	bedensel	Adj	Adj
ferah	ferah	Adj	Adj
müstakil	müstakil	Adj	Adj
dekoratif	dekoratif	Adj	Adj
yaşamsal	yaşamsal	Adj	Adj
hormonal	hormonal	Adj	Adj
aktif	aktif	Adj	Adj
yanal	yanal	Adj	Adj
filanca	filanca	Adj	Adj
fotojenik	fotojenik	Adj	Adj
fiziki	fiziki	Adj	Adj
birebir	birebir	Adj	Adj
pop	pop	Adj	Adj
entegre	entegre	Adj	Adj
evrensel	evrensel	Adj	Adj
hukuki	hukuki	Adj	Adj
evrimsel	evrimsel	Adj	Adj
yatkın	yatkın	Adj	Adj
bitap	bitap	Adj	Adj
obez	obez	Adj	Adj
kuduz	kuduz	Adj	Adj
hayvansal	hayvansal	Adj	Adj
kamusal	kamusal	Adj	Adj
revize	revize	Adj	Adj
anormal	anormal	Adj	Adj
büyükbaş	büyükbaş	Adj	Adj
haram	haram	Adj	Adj
müzeyyen	müzeyyen	Adj	Adj
mahcup	mahcup	Adj	Adj
kimyevi	kimyevi	Adj	Adj
mecazi	mecazi	Adj	Adj
muhterem	muhterem	Adj	Adj
illegal	illegal	Adj	Adj
asimile	asimile	Adj	Adj
tepkisel	tepkisel	Adj	Adj
polisiye	polisiye	Adj	Adj
insani	insani	Adj	Adj
akademik	akademik	Adj	Adj
topluca	topluca	Adj	Adj
tarihsel	tarihsel	Adj	Adj
deşifre	deşifre	Adj	Adj
beşeri	beşeri	Adj	Adj
islami	islami	Adj	Adj
fiili	fiili	Adj	Adj
meçhul	meçhul	Adj	Adj
faal	faal	Adj	Adj
örgütsel	örgütsel	Adj	Adj
hukuksal	hukuksal	Adj	Adj
asgari	asgari	Adj	Adj
meşru	meşru	Adj	Adj
köklü	köklü	Adj	Adj
kılpayı	kılpayı	Adj	Adj
ilkel	ilkel	Adj	Adj
sistematik	sistematik	Adj	Adj
rafine	rafine	Adj	Adj
sosyolojik	sosyolojik	Adj	Adj
müttefik	müttefik	Adj	Adj
reel	reel	Adj	Adj
yepyeni	yepyeni	Adj	Adj
alafranga	alafranga	Adj	Adj
üniter	üniter	Adj	Adj
iyimser	iyimser	Adj	Adj
hazin	hazin	Adj	Adj
demokratça	demokrat	Adj	Adj
akli	akli	Adj	Adj
daimi	daimi	Adj	Adj
atletik	atletik	Adj	Adj
simgesel	simgesel	Adj	Adj
düşünsel	düşünsel	Adj	Adj
ütopik	ütopik	Adj	Adj
agresif	agresif	Adj	Adj
mahsur	mahsur	Adj	Adj
spesifik	spesifik	Adj	Adj
alkolik	alkolik	Adj	Adj
elverişli	elverişli	Adj	Adj
bölgesel	bölgesel	Adj	Adj
bağışık	bağışık	Adj	Adj
barışık	barışık	Adj	Adj
inandırıcı	inandırıcı	Adj	Adj
kimyasal	kimyasal	Adj	Adj
müsrif	müsrif	Adj	Adj
gecelik	gecelik	Adj	Adj
şayan	şayan	Adj	Adj
ılımlı	ılımlı	Adj	Adj
diplomatik	diplomatik	Adj	Adj
sosyetik	sosyetik	Adj	Adj
plastik	plastik	Adj	Adj
global	global	Adj	Adj
cesur	cesur	Adj	Adj
etnik	etnik	Adj	Adj
bej	bej	Adj	Adj
baştançıkarıcı	baştançıkarıcı	Adj	Adj
fütüristik	fütüristik	Adj	Adj
sıradışı	sıradışı	Adj	Adj
jarse	jarse	Adj	Adj
kruvaze	kruvaze	Adj	Adj
enerjik	enerjik	Adj	Adj
objektif	objektif	Adj	Adj
minicik	minicik	Adj	Adj
ultra	ultra	Adj	Adj
streç	streç	Adj	Adj
metalik	metalik	Adj	Adj
kloş	kloş	Adj	Adj
otoriter	otoriter	Adj	Adj
hayati	hayati	Adj	Adj
sempatik	sempatik	Adj	Adj
titiz	titiz	Adj	Adj
sarp	sarp	Adj	Adj
şád	şad	Adj	Adj
alaturka	alaturka	Adj	Adj
zilli	zilli	Adj	Adj
eşcinsel	eşcinsel	Adj	Adj
bıçkın	bıçkın	Adj	Adj
kadınsı	kadınsı	Adj	Adj
aleni	aleni	Adj	Adj
yamuk	yamuk	Adj	Adj
feci	feci	Adj	Adj
usturuplu	usturuplu	Adj	Adj
yegane	yegane	Adj	Adj
metazori	metazori	Adj	Adj
apayrı	apayrı	Adj	Adj
paranoyak	paranoyak	Adj	Adj
laubali	laubali	Adj	Adj
zincirleme	zincirleme	Adj	Adj
üstüste	üstüste	Adj	Adj
durağan	durağan	Adj	Adj
aktüel	aktüel	Adj	Adj
deneysel	deneysel	Adj	Adj
sönük	sönük	Adj	Adj
ergonomik	ergonomik	Adj	Adj
makbul	makbul	Adj	Adj
zihinsel	zihinsel	Adj	Adj
okullu	okullu	Adj	Adj
periyodik	periyodik	Adj	Adj
enflasyonist	enflasyonist	Adj	Adj
prefabrik	prefabrik	Adj	Adj
atıl	atıl	Adj	Adj
yöresel	yöresel	Adj	Adj
mağdur	mağdur	Adj	Adj
cezai	cezai	Adj	Adj
gerçekleştiren	gerçek	Noun	Adj
yaşlarındaki	yaş	Noun	Adj
babasız	baba	Noun	Adj
centilmen	centilmen	Noun	Noun
bağlı	bağ	Noun	Adj
duygulandığı	duygu	Noun	Adj
alışkındı	alışkı	Noun	Verb
farklı	fark	Noun	Adj
yandaki	yan	Noun	Adj
sahibiyle	sahip	Noun	Noun
renkteki	renk	Noun	Adj
gayemdeki	gaye	Noun	Adj
insansı	insan	Noun	Adj
korkusuz	korku	Noun	Adj
pembeleşen	pembe	Noun	Adj
sinirlenen	sinir	Noun	Adj
pratik	pratik	Noun	Noun
yemin	yemin	Noun	Noun
hayıflanıyorum	hayıf	Noun	Verb
şeyimiz	şey	Noun	Noun
sınavıdır	sınav	Noun	Verb
işaretsiz	işaret	Noun	Adj
temsilcisi	temsilci	Noun	Noun
durumsuz	durum	Noun	Adj
imtiyazıdır	imtiyaz	Noun	Verb
belasız	bela	Noun	Adj
çeşitli	çeşit	Noun	Adj
heyecanlı	heyecan	Noun	Adj
düşüncesiz	düşünce	Noun	Adj
kalabalığın	kalabalık	Noun	Noun
ahenkli	ahenk	Noun	Adj
başlı	baş	Noun	Adj
tinselleştirir	tinsel	Noun	Verb
katlardaki	kat	Noun	Adj
anındaki	an	Noun	Adj
rüyalarında	rüya	Noun	Noun
suskundu	susku	Noun	Verb
şerefli	şeref	Noun	Adj
başarılı	başarı	Noun	Adj
gergindi	gergi	Noun	Verb
boyardı	boyar	Noun	Verb
hakimdi	haki	Noun	Verb
oyunları	oyun	Noun	Noun
sanatçısının	sanatçı	Noun	Noun
üstteki	üst	Noun	Adj
sonuçlanan	sonuç	Noun	Adj
canlanan	can	Noun	Adj
halindeki	hal	Noun	Adj
em	em	Noun	Noun
sabırsızca	sabır	Noun	Adj
sebebin	sebep	Noun	Noun
kaftandı	kaftan	Noun	Verb
düşkündü	düşkü	Noun	Verb
ahlaklı	ahlak	Noun	Adj
özelliklerindeki	özellik	Noun	Adj
neşeli	neşe	Noun	Adj
kızlı	kız	Noun	Adj
üzüntülü	üzüntü	Noun	Adj
köyündeki	köy	Noun	Adj
alev	alev	Noun	Noun
arkadaşları	arkadaş	Noun	Noun
komik	komik	Noun	Noun
şarkılar	şarkı	Noun	Noun
zamanlı	zaman	Noun	Adj
tuhafı	tuhaf	Noun	Noun
örnekteki	örnek	Noun	Adj
annesiz	anne	Noun	Adj
melek	melek	Noun	Noun
şartlı	şart	Noun	Adj
sesindeki	ses	Noun	Adj
kanlı	kan	Noun	Adj
haklı	hak	Noun	Adj
ölümlüyüz	ölümlü	Noun	Verb
şahit	şahit	Noun	Noun
kuvvetli	kuvvet	Noun	Adj
kurbanısınız	kurban	Noun	Verb
aşksız	aşk	Noun	Adj
çıkarınızı	çıkar	Noun	Noun
tecrübeli	tecrübe	Noun	Adj
onurlu	onur	Noun	Adj
ekli	ek	Noun	Adj
hiddetli	hiddet	Noun	Adj
kanatlı	kanat	Noun	Adj
karlı	kar	Noun	Adj
evdeki	ev	Noun	Adj
göstergeleriydi	gösterge	Noun	Verb
dehşetli	dehşet	Noun	Adj
endişeli	endişe	Noun	Adj
gerisindeki	geri	Noun	Adj
köpeklere	köpek	Noun	Noun
engelli	engel	Noun	Adj
güçsüz	güç	Noun	Adj
kurtlar	kurt	Noun	Noun
felaket	felaket	Noun	Noun
teláşlı	telaş	Noun	Adj
öfkeli	öfke	Noun	Adj
tetikteydi	tetik	Noun	Verb
aradaki	ara	Noun	Adj
faydalanan	fayda	Noun	Adj
çocuklu	çocuk	Noun	Adj
efendilerce	efendi	Noun	Noun
malını	mal	Noun	Noun
tarifsiz	tarif	Noun	Adj
kısmetliydi	kısmet	Noun	Verb
hücum	hücum	Noun	Noun
kurlardaki	kur	Noun	Adj
hırslı	hırs	Noun	Adj
üzerimdeki	üzer	Noun	Adj
uçlu	uç	Noun	Adj
nedenli	neden	Noun	Adj
kurumlu	kurum	Noun	Adj
dostluğunuza	dost	Noun	Noun
günkü	gün	Noun	Adj
rıhtım	rıh	Noun	Verb
esmer	esmer	Noun	Noun
kollu	kol	Noun	Adj
vaziyette	vaziyet	Noun	Noun
tutumlu	tutum	Noun	Adj
dinle	din	Noun	Noun
görevlendirilen	görev	Noun	Adj
kalçalarının	kalça	Noun	Noun
parçalı	parça	Noun	Adj
biçimdeki	biçim	Noun	Adj
şefkatli	şefkat	Noun	Adj
ilgisiz	ilgi	Noun	Adj
sınırındaki	sınır	Noun	Adj
buradaki	bura	Noun	Adj
adamların	adam	Noun	Noun
yaramazsın	yaramaz	Noun	Verb
solundaki	sol	Noun	Adj
eşyanın	eşya	Noun	Noun
bay	bay	Noun	Noun
yaşıyacağız	yaşıyacağ	Noun	Verb
tenekesidir	teneke	Noun	Verb
sobalar	soba	Noun	Noun
yıllıktır	yıllık	Noun	Verb
domuz	domuz	Noun	Noun
şanssız	şans	Noun	Adj
yerinizdeki	yer	Noun	Adj
gevezeliğinin	geveze	Noun	Noun
yasaklı	yasak	Noun	Adj
tüysüz	tüy	Noun	Adj
adetini	adet	Noun	Noun
papazdan	papaz	Noun	Noun
hareketlenen	hareket	Noun	Adj
koridordaki	koridor	Noun	Adj
önünüzdeki	ön	Noun	Adj
alemsin	alem	Noun	Verb
çukurdu	çukur	Noun	Verb
oralı	ora	Noun	Adj
havadaki	hava	Noun	Adj
odamdaki	oda	Noun	Adj
masasındaki	masa	Noun	Adj
mantarlı	mantar	Noun	Adj
olaylı	olay	Noun	Adj
beyi	bey	Noun	Noun
sıhhati	sıhhat	Noun	Noun
yukarıdaki	yukarı	Noun	Adj
metanet	metanet	Noun	Noun
yarışındaki	yarış	Noun	Adj
omuzlu	omuz	Noun	Adj
direktti	direkt	Noun	Verb
beyefendi	beyefendi	Noun	Noun
huzursuz	huzur	Noun	Adj
sandalyeler	sandalye	Noun	Noun
bahane	bahane	Noun	Noun
örtüsünün	örtü	Noun	Noun
örülüdür	örü	Noun	Verb
paslı	pas	Noun	Adj
dokunaklı	dokunak	Noun	Adj
erkeklerdeki	erkek	Noun	Adj
yemeğindeki	yemek	Noun	Adj
değerlendirdiğiniz	değer	Noun	Adj
hazinesiydi	hazine	Noun	Verb
çiçekli	çiçek	Noun	Adj
nezleymiş	nezle	Noun	Verb
fetholunmuş	fetholun	Noun	Verb
hüzünlü	hüzün	Noun	Adj
manastır	manas	Noun	Verb
eser	eser	Noun	Noun
karışımıdır	karışım	Noun	Verb
yoksulluğun	yoksul	Noun	Noun
adlandırıldığı	ad	Noun	Adj
yapıtlarındaki	yapıt	Noun	Adj
üslubudur	üslup	Noun	Verb
çoğunluğunun	çoğunluk	Noun	Noun
realizmdir	realizm	Noun	Verb
pelteleşmiş	pelte	Noun	Verb
ustabaşılar	ustabaşı	Noun	Verb
mutlulukları	mut	Noun	Noun
koyardı	koyar	Noun	Verb
redetti	redet	Noun	Verb
kederli	keder	Noun	Adj
toparlamayamıyordu	toparlamayamıyor	Noun	Verb
olursan	olur	Noun	Verb
yıllardaki	yıl	Noun	Adj
alttaki	alt	Noun	Adj
tüccara	tüccar	Noun	Noun
karısının	karı	Noun	Noun
hatıralarını	hatıra	Noun	Noun
mezar	mezar	Noun	Noun
bataklıktaki	batak	Noun	Adj
nehirdeki	nehir	Noun	Adj
denizdeki	deniz	Noun	Adj
keserim	keser	Noun	Verb
çizgili	çizgi	Noun	Adj
kulesiydi	kule	Noun	Verb
korsanmış	korsan	Noun	Verb
keskindi	keski	Noun	Verb
boyundaki	boy	Noun	Adj
değnekti	değnek	Noun	Verb
akranımmış	akran	Noun	Verb
dakikadaki	dakika	Noun	Adj
ekmeğin	ekmek	Noun	Noun
kişiler	kişi	Noun	Noun
arifesiydi	arife	Noun	Verb
nezaketsiz	nezaket	Noun	Adj
soylu	soy	Noun	Adj
sabahki	sabah	Noun	Adj
nemli	nem	Noun	Adj
şapkalı	şapka	Noun	Adj
bataryadaydım	batarya	Noun	Verb
eğlenceli	eğlence	Noun	Adj
dirençliyimdir	direnç	Noun	Verb
aklındaki	akıl	Noun	Adj
idmanlıdır	idman	Noun	Verb
çelikleştirir	çelik	Noun	Verb
nedimmiş	nedim	Noun	Verb
formüldeki	formül	Noun	Adj
sıkıntılı	sıkıntı	Noun	Adj
biberli	biber	Noun	Adj
tasalanmayın	tasa	Noun	Verb
metresiniz	metre	Noun	Verb
usuldendir	usul	Noun	Verb
kafesin	kafes	Noun	Noun
ellerindeki	el	Noun	Adj
işsiz	iş	Noun	Adj
uzmansam	uzman	Noun	Verb
erbapsın	erbap	Noun	Verb
şüpheli	şüphe	Noun	Adj
emrindeki	emir	Noun	Adj
dişsiz	diş	Noun	Adj
kokulu	koku	Noun	Adj
dantelasındandı	dantela	Noun	Verb
isli	is	Noun	Adj
süslü	süs	Noun	Adj
lordu	lor	Noun	Verb
tahminlerinin	tahmin	Noun	Noun
oğlunuz	oğul	Noun	Noun
öteki	öte	Noun	Adj
net	net	Noun	Noun
rüzgarlı	rüzgar	Noun	Adj
senedir	sene	Noun	Verb
eksikli	eksik	Noun	Adj
tedbirli	tedbir	Noun	Adj
ayaklı	ayak	Noun	Adj
misafirleri	misafir	Noun	Noun
taşralı	taşra	Noun	Adj
avukatımdı	avukat	Noun	Verb
gözündeki	göz	Noun	Adj
dolabındaki	dolap	Noun	Adj
hiçe	hiç	Noun	Noun
kaplanmış	kaplan	Noun	Verb
franktı	frank	Noun	Verb
borçlu	borç	Noun	Adj
aylarındaki	ay	Noun	Adj
saatlerindeki	saat	Noun	Adj
şaheserler	şaheser	Noun	Noun
ülkemdeki	ülke	Noun	Adj
kayıttaki	kayıt	Noun	Adj
generalle	general	Noun	Noun
ihtimal	ihtimal	Noun	Noun
topraklardaki	toprak	Noun	Adj
yüzyılda	yüzyıl	Noun	Noun
dengidir	denk	Noun	Verb
hain	hain	Noun	Noun
toptan	top	Noun	Noun
nöbetteki	nöbet	Noun	Adj
doktordu	doktor	Noun	Verb
sayısındaki	sayı	Noun	Adj
ölümdür	ölüm	Noun	Verb
uslu	us	Noun	Adj
dikkatli	dikkat	Noun	Adj
durultmuştu	durultmuş	Noun	Verb
yararlanan	yarar	Noun	Adj
yaslı	yas	Noun	Adj
yönündeki	yön	Noun	Adj
veremdi	vere	Noun	Verb
asılıydı	ası	Noun	Verb
derindi	deri	Noun	Verb
hastalıklı	hastalık	Noun	Adj
gürültülü	gürültü	Noun	Adj
konumundaki	konum	Noun	Adj
hızlıca	hız	Noun	Adj
kentli	kent	Noun	Adj
önemlice	önem	Noun	Adj
yürekli	yürek	Noun	Adj
hastaneydi	hastane	Noun	Verb
teğmendi	teğmen	Noun	Verb
sorumluluk	sorumlu	Noun	Noun
imkansız	imkan	Noun	Adj
karşımdaki	karşı	Noun	Adj
mucize	mucize	Noun	Noun
ağlacaktı	ağlacak	Noun	Verb
kaygılı	kaygı	Noun	Adj
köşelerindeki	köşe	Noun	Adj
parasız	para	Noun	Adj
soluksuz	soluk	Noun	Adj
sonundaki	son	Noun	Adj
muhtaç	muhtaç	Noun	Noun
sözüyordu	sözüyor	Noun	Verb
birlikteydiler	birlik	Noun	Verb
haftaki	hafta	Noun	Adj
avans	avans	Noun	Noun
hesapsızca	hesap	Noun	Adj
liraya	lira	Noun	Noun
ödemelerinin	ödeme	Noun	Noun
döviz	döviz	Noun	Noun
rezervlerindeki	rezerv	Noun	Adj
dolarlı	dolar	Noun	Adj
kaynaklı	kaynak	Noun	Adj
tutarını	tutar	Noun	Noun
bilançosuna	bilanço	Noun	Noun
varlığından	varlık	Noun	Noun
ölçülü	ölçü	Noun	Adj
toplamı	toplam	Noun	Noun
kredilerin	kredi	Noun	Noun
yolundaki	yol	Noun	Adj
piyasalara	piyasa	Noun	Noun
likiditenin	likidite	Noun	Noun
etkisiz	etki	Noun	Adj
itibarlı	itibar	Noun	Adj
düzeyindeki	düzey	Noun	Adj
emisyon	emisyon	Noun	Noun
miktarda	miktar	Noun	Noun
verilerindeki	veri	Noun	Adj
tarihli	tarih	Noun	Adj
kamu	kamu	Noun	Noun
kuruluştaki	kuruluş	Noun	Adj
şoku	şok	Noun	Noun
petrol	petrol	Noun	Noun
boru	boru	Noun	Noun
hatlarının	hat	Noun	Noun
fiyatlarındaki	fiyat	Noun	Adj
kotanın	kota	Noun	Noun
firmadaki	firma	Noun	Adj
sözleşme	sözleşme	Noun	Noun
iptal	iptal	Noun	Noun
gıdaya	gıda	Noun	Noun
izinli	izin	Noun	Adj
yönetimindeki	yönetim	Noun	Adj
talebini	talep	Noun	Noun
üyesi	üye	Noun	Noun
diplomatları	diplomat	Noun	Noun
aylık	aylık	Noun	Noun
süresiz	süre	Noun	Adj
gözönüne	gözönü	Noun	Noun
unlu	un	Noun	Adj
dünyamızdaki	dünya	Noun	Adj
şirkette	şirket	Noun	Noun
parametreler	parametre	Noun	Noun
hacimdeki	hacim	Noun	Adj
yarısındaki	yarı	Noun	Adj
sinyalini	sinyal	Noun	Noun
sendikacı	sendikacı	Noun	Noun
suçlu	suç	Noun	Adj
duyurusunda	duyuru	Noun	Noun
hakaretlerden	hakaret	Noun	Noun
gerekçeli	gerekçe	Noun	Adj
dilekçesinde	dilekçe	Noun	Noun
ifadeyle	ifade	Noun	Noun
tazminat	tazminat	Noun	Noun
istemiyle	istem	Noun	Noun
davası	dava	Noun	Noun
duruşması	duruşma	Noun	Noun
hedeflerine	hedef	Noun	Noun
rektörlerini	rektör	Noun	Noun
türbanlı	türban	Noun	Adj
girişimlerin	girişim	Noun	Noun
kriz	kriz	Noun	Noun
raporundaki	rapor	Noun	Adj
üniversiteli	üniversite	Noun	Adj
başörtülü	başörtü	Noun	Adj
ortadaki	orta	Noun	Adj
öğretim	öğretim	Noun	Noun
merkezdeki	merkez	Noun	Adj
gençlikte	gençlik	Noun	Noun
örgütü	örgüt	Noun	Noun
bilgiye	bilgi	Noun	Noun
öğrenciye	öğrenci	Noun	Noun
yasasında	yasa	Noun	Noun
fakültelerinden	fakülte	Noun	Noun
tepkisiz	tepki	Noun	Adj
imzalı	imza	Noun	Adj
dün	dün	Noun	Noun
temelsiz	temel	Noun	Adj
boyutlu	boyut	Noun	Adj
arkamızdaki	arka	Noun	Adj
kıyafetler	kıyafet	Noun	Noun
devrimlerine	devrim	Noun	Noun
sözden	söz	Noun	Noun
nefretiyle	nefret	Noun	Noun
cevapsız	cevap	Noun	Adj
yardımıyla	yardım	Noun	Noun
çöplerin	çöp	Noun	Noun
evraklarım	evrak	Noun	Noun
kahramanlı	kahraman	Noun	Adj
zararlı	zarar	Noun	Adj
kardeşi	kardeş	Noun	Noun
oğlanla	oğlan	Noun	Noun
omnibüslerin	omnibüs	Noun	Noun
yakın	yakı	Noun	Noun
istirahat	istirahat	Noun	Noun
ısrarlı	ısrar	Noun	Adj
kalıptan	kalıp	Noun	Noun
sahneyi	sahne	Noun	Noun
türündeki	tür	Noun	Adj
kalpli	kalp	Noun	Adj
nebze	nebze	Noun	Noun
kıskançlık	kıskanç	Noun	Noun
boynundaki	boyun	Noun	Adj
parmağındaki	parmak	Noun	Adj
muhabbetle	muhabbet	Noun	Noun
aşağıdaki	aşağı	Noun	Adj
şikayet	şikayet	Noun	Noun
sofranıza	sofra	Noun	Noun
etrafımdaki	etraf	Noun	Adj
binek	binek	Noun	Noun
arabasındaki	araba	Noun	Adj
patırtısız	patırtı	Noun	Adj
azıya	azı	Noun	Noun
vaktim	vakit	Noun	Noun
tabaklarını	tabak	Noun	Noun
habersiz	haber	Noun	Adj
dudaklı	dudak	Noun	Adj
makineli	makine	Noun	Adj
pırtık	pırtık	Noun	Noun
dantel	dantel	Noun	Noun
mendil	mendil	Noun	Noun
kapıdaki	kapı	Noun	Adj
merhametli	merhamet	Noun	Adj
sorusuna	soru	Noun	Noun
geceki	gece	Noun	Adj
açıdan	açı	Noun	Noun
hüsran	hüsran	Noun	Noun
şekilsiz	şekil	Noun	Adj
deneyimsiz	deneyim	Noun	Adj
hayattaki	hayat	Noun	Adj
hayret	hayret	Noun	Noun
yanıtsız	yanıt	Noun	Adj
yumruğumda	yumruk	Noun	Noun
temin	temin	Noun	Noun
aleyhindeki	aleyh	Noun	Adj
ağzındaki	ağız	Noun	Adj
küfürlerle	küfür	Noun	Noun
sınıf	sınıf	Noun	Noun
ailesindeki	aile	Noun	Adj
mensup	mensup	Noun	Noun
kadının	kadı	Noun	Noun
utancından	utanç	Noun	Noun
hislerini	his	Noun	Noun
evladımın	evlat	Noun	Noun
izini	iz	Noun	Noun
mübalağaya	mübalağa	Noun	Noun
eşleşmeyen	eş	Noun	Adj
çılgınca	çılgın	Noun	Noun
canlılar	canlı	Noun	Noun
atmosfere	atmosfer	Noun	Noun
kez	kez	Noun	Noun
takdirle	takdir	Noun	Noun
tonlarındaki	ton	Noun	Adj
devamlı	devam	Noun	Adj
kontrollü	kontrol	Noun	Adj
uşağa	uşak	Noun	Noun
bagaj	bagaj	Noun	Noun
detaylı	detay	Noun	Adj
esnada	esna	Noun	Noun
camlı	cam	Noun	Adj
hayalimizdeki	hayal	Noun	Adj
fırsatı	fırsat	Noun	Noun
ziyan	ziyan	Noun	Noun
tesellisi	teselli	Noun	Noun
cümle	cümle	Noun	Noun
rica	rica	Noun	Noun
tehdide	tehdit	Noun	Noun
akşamki	akşam	Noun	Adj
ceketiyle	ceket	Noun	Noun
garsonun	garson	Noun	Noun
umarsız	umar	Noun	Adj
mesele	mesele	Noun	Noun
badanalı	badana	Noun	Adj
kaşları	kaş	Noun	Noun
aktris	aktris	Noun	Noun
sıralarındaki	sıra	Noun	Adj
nikáhlı	nikah	Noun	Adj
haricinde	hariç	Noun	Noun
şakaya	şaka	Noun	Noun
evliliğe	evlilik	Noun	Noun
anı	anı	Noun	Noun
nişanlılığa	nişanlı	Noun	Noun
variyetini	variyet	Noun	Noun
tabiatlı	tabiat	Noun	Adj
ifsat	ifsat	Noun	Noun
vermut	vermut	Noun	Noun
portakalları	portakal	Noun	Noun
kokteylini	kokteyl	Noun	Noun
portresi	portre	Noun	Noun
yetenekli	yetenek	Noun	Adj
hususiyetler	hususiyet	Noun	Noun
tesirini	tesir	Noun	Noun
randevu	randevu	Noun	Noun
konudaki	konu	Noun	Adj
önyargılarımızı	önyargı	Noun	Noun
şahsiyetin	şahsiyet	Noun	Noun
tercih	tercih	Noun	Noun
piyesine	piyes	Noun	Noun
teklifte	teklif	Noun	Noun
taraftarı	taraftar	Noun	Noun
mahzuru	mahzur	Noun	Noun
mizaçlar	mizaç	Noun	Noun
egosunu	ego	Noun	Noun
insanoğlunun	insanoğlu	Noun	Noun
varoluş	varoluş	Noun	Noun
hayranlık	hayran	Noun	Noun
kelimeleri	kelime	Noun	Noun
hükmü	hüküm	Noun	Noun
komşusu	komşu	Noun	Noun
erdemleri	erdem	Noun	Noun
umutlu	umut	Noun	Adj
bankerleri	banker	Noun	Noun
cüzdanlarındaki	cüzdan	Noun	Adj
soygunculuk	soyguncu	Noun	Noun
teşvik	teşvik	Noun	Noun
cazibesini	cazibe	Noun	Noun
saten	saten	Noun	Noun
pelerinli	pelerin	Noun	Adj
ömür	ömür	Noun	Noun
ümitli	ümit	Noun	Adj
haberdar	haberdar	Noun	Noun
laf	laf	Noun	Noun
aşçıbaşımın	aşçıbaşı	Noun	Noun
marifetlerini	marifet	Noun	Noun
restoranda	restoran	Noun	Noun
tiyatrosuz	tiyatro	Noun	Adj
gömleğini	gömlek	Noun	Noun
yeleğini	yelek	Noun	Noun
pantolonlu	pantolon	Noun	Adj
şahin	şahin	Noun	Noun
atölyende	atölye	Noun	Noun
heykeli	heykel	Noun	Noun
zarafet	zarafet	Noun	Noun
yapraklı	yaprak	Noun	Adj
locada	loca	Noun	Noun
kimseyi	kimse	Noun	Noun
ormanınızdaki	orman	Noun	Adj
hazdan	haz	Noun	Noun
nilüfer	nilüfer	Noun	Noun
sırlarını	sır	Noun	Noun
pençe	pençe	Noun	Noun
fikirli	fikir	Noun	Adj
kulağa	kulak	Noun	Noun
tavırlı	tavır	Noun	Adj
şampanya	şampanya	Noun	Noun
hususunda	husus	Noun	Noun
mukavelesi	mukavele	Noun	Noun
önerisinde	öneri	Noun	Noun
bizlerden	biz	Noun	Noun
ekseriyetle	ekseriyet	Noun	Noun
meraklı	merak	Noun	Adj
teorilerimin	teori	Noun	Noun
iflah	iflah	Noun	Noun
yazık	yazık	Noun	Noun
kaide	kaide	Noun	Noun
dalgalı	dalga	Noun	Adj
inançlı	inanç	Noun	Adj
salata	salata	Noun	Noun
kuram	kuram	Noun	Noun
iddialı	iddia	Noun	Adj
onayın	onay	Noun	Noun
demeti	demet	Noun	Noun
kastın	kast	Noun	Noun
kadehteki	kadeh	Noun	Adj
uyumsuz	uyum	Noun	Adj
yargıya	yargı	Noun	Noun
amaçlı	amaç	Noun	Adj
anlayışlı	anlayış	Noun	Adj
çağındaki	çağ	Noun	Adj
kabulünü	kabul	Noun	Noun
gelenekçi	gelenekçi	Noun	Noun
farz	farz	Noun	Noun
bedelini	bedel	Noun	Noun
ressamın	ressam	Noun	Noun
şimdiki	şimdi	Noun	Adj
derecedeki	derece	Noun	Adj
fakirlerin	fakir	Noun	Noun
trajedisi	trajedi	Noun	Noun
feragattan	feragat	Noun	Noun
satın	satın	Noun	Noun
günah	günah	Noun	Noun
velev	velev	Noun	Noun
ıstıraplardan	ıstırap	Noun	Noun
ortaçağa	ortaçağ	Noun	Noun
sanattan	sanat	Noun	Noun
modası	moda	Noun	Noun
romanlar	roman	Noun	Noun
barbar	barbar	Noun	Noun
meyvelerle	meyve	Noun	Noun
tanrılarına	tanrı	Noun	Noun
dileğiyle	dilek	Noun	Noun
mücevherli	mücevher	Noun	Adj
göğsünün	göğüs	Noun	Noun
azarı	azar	Noun	Noun
galeyana	galeyan	Noun	Noun
ilham	ilham	Noun	Noun
mani	mani	Noun	Noun
kahvenin	kahve	Noun	Noun
sigaralarını	sigara	Noun	Noun
tanesi	tane	Noun	Noun
puro	puro	Noun	Noun
içmeni	içme	Noun	Noun
tasvip	tasvip	Noun	Noun
keyiflenen	keyif	Noun	Adj
cüretli	cüret	Noun	Adj
temsil	temsil	Noun	Noun
ejderha	ejderha	Noun	Noun
çakmak	çakmak	Noun	Noun
ateşli	ateş	Noun	Adj
ideale	ideal	Noun	Noun
kupa	kupa	Noun	Noun
kişiliği	kişilik	Noun	Noun
takiplerinden	takip	Noun	Noun
kasvetli	kasvet	Noun	Adj
merdivendeki	merdiven	Noun	Adj
ışıklı	ışık	Noun	Adj
caddelerindeki	cadde	Noun	Adj
edálı	eda	Noun	Adj
lobilerine	lobi	Noun	Noun
şiir	şiir	Noun	Noun
dehasının	deha	Noun	Noun
hararet	hararet	Noun	Noun
taç	taç	Noun	Noun
yıldızlı	yıldız	Noun	Adj
kenarlarındaki	kenar	Noun	Adj
şişeyle	şişe	Noun	Noun
tanrıça	tanrıça	Noun	Noun
ağınızdaki	ağ	Noun	Adj
seyircisiz	seyirci	Noun	Adj
keman	keman	Noun	Noun
opera	opera	Noun	Noun
dürbünle	dürbün	Noun	Noun
salonundaki	salon	Noun	Adj
ruhumdaki	ruh	Noun	Adj
uğurlu	uğur	Noun	Adj
gözyaşlarına	gözyaşı	Noun	Noun
orkestra	orkestra	Noun	Noun
perdeler	perde	Noun	Noun
alkış	alkış	Noun	Noun
tufanı	tufan	Noun	Noun
mahlûklardan	mahluk	Noun	Noun
yavrum	yavru	Noun	Noun
ceylanı	ceylan	Noun	Noun
yanaklı	yanak	Noun	Adj
aynalı	ayna	Noun	Adj
adımlar	adım	Noun	Noun
içerisindeki	içeri	Noun	Adj
dans	dans	Noun	Noun
aktörlerle	aktör	Noun	Noun
bedenim	beden	Noun	Noun
sudaki	su	Noun	Adj
kıvrımlarına	kıvrım	Noun	Noun
zambağın	zambak	Noun	Noun
fildişinden	fildişi	Noun	Noun
sevinçli	sevinç	Noun	Adj
alameti	alamet	Noun	Noun
sözcüğünü	sözcük	Noun	Noun
hacıların	hacı	Noun	Noun
ibadeti	ibadet	Noun	Noun
avuç	avuç	Noun	Noun
diyalog	diyalog	Noun	Noun
iniş	iniş	Noun	Noun
cesaretini	cesaret	Noun	Noun
oyunculu	oyuncu	Noun	Adj
acemi	acem	Noun	Noun
balkondaki	balkon	Noun	Adj
bölümündeki	bölüm	Noun	Adj
inkar	inkar	Noun	Noun
pasajı	pasaj	Noun	Noun
okul	okul	Noun	Noun
hassasiyetle	hassasiyet	Noun	Noun
metindeki	metin	Noun	Adj
hitabet	hitabet	Noun	Noun
ezbere	ezber	Noun	Noun
dizesindeki	dize	Noun	Adj
anii	anii	Noun	Noun
şimşek	şimşek	Noun	Noun
tomurcuğu	tomurcuk	Noun	Noun
nefese	nefes	Noun	Noun
galeri	galeri	Noun	Noun
uğultu	uğultu	Noun	Noun
müdürünün	müdür	Noun	Noun
ıslık	ıslık	Noun	Noun
paltosunu	palto	Noun	Noun
rolündeki	rol	Noun	Adj
özür	özür	Noun	Noun
hasta	hasta	Noun	Noun
formları	form	Noun	Noun
tasarı	tasarı	Noun	Noun
sakat	sakat	Noun	Noun
planlı	plan	Noun	Adj
badirelerden	badire	Noun	Noun
yalan	yalan	Noun	Noun
tarafsız	taraf	Noun	Adj
dağlar	dağ	Noun	Noun
kutsallığına	kut	Noun	Noun
ürpertiler	ürperti	Noun	Noun
fıçı	fıçı	Noun	Noun
taslak	taslak	Noun	Noun
ayrıntılı	ayrıntı	Noun	Adj
ihtiyaçları	ihtiyaç	Noun	Noun
seviyeli	seviye	Noun	Adj
hemşerilerinden	hemşeri	Noun	Noun
hanımefendi	hanımefendi	Noun	Noun
muhit	muhit	Noun	Noun
şehirlerarası	şehir	Noun	Adj
herkesle	herkes	Noun	Noun
niyetli	niyet	Noun	Adj
pazarı	pazar	Noun	Noun
satıcıların	satıcı	Noun	Noun
dükkan	dükkan	Noun	Noun
tezgahtarlarının	tezgahtar	Noun	Noun
gelecekteki	gelecek	Noun	Adj
önsezi	önsezi	Noun	Noun
söylentilere	söylenti	Noun	Noun
ortalıkta	ortalık	Noun	Noun
pasaportsuz	pasaport	Noun	Adj
emellerinin	emel	Noun	Noun
nüfuzlu	nüfuz	Noun	Adj
münasebetsizliğe	münasebet	Noun	Noun
havadis	havadis	Noun	Noun
asıllı	asıl	Noun	Adj
başlangıçtaki	başlangıç	Noun	Adj
incelikle	incelik	Noun	Noun
taşralıların	taşralı	Noun	Noun
muhafaza	muhafaza	Noun	Noun
psikolog	psikolog	Noun	Noun
bilgini	bilgin	Noun	Noun
eşek	eşek	Noun	Noun
süratiyle	sürat	Noun	Noun
gökleri	gök	Noun	Noun
rezaletlerinin	rezalet	Noun	Noun
milyoner	milyoner	Noun	Noun
dul	dul	Noun	Noun
dükle	dük	Noun	Noun
valisi	vali	Noun	Noun
il	il	Noun	Noun
tahammülsüz	tahammül	Noun	Adj
kafanızdaki	kafa	Noun	Adj
tuzağa	tuzak	Noun	Noun
barın	bar	Noun	Noun
geleni	geleni	Noun	Noun
yüzde	yüzde	Noun	Noun
kilitteki	kilit	Noun	Adj
bugünlerdeki	bugün	Noun	Adj
bayanlardaki	bayan	Noun	Adj
bacadan	baca	Noun	Noun
dahice	dahi	Noun	Noun
ihmal	ihmal	Noun	Noun
hikayelerini	hikaye	Noun	Noun
sokaklarındaki	sokak	Noun	Adj
dibindeki	dip	Noun	Adj
zerrece	zerre	Noun	Noun
entrikalarına	entrika	Noun	Noun
bozguna	bozgun	Noun	Noun
arzu	arzu	Noun	Noun
rakibesinin	rakibe	Noun	Noun
itirazlarına	itiraz	Noun	Noun
kurallardaki	kural	Noun	Adj
esprili	espri	Noun	Adj
gırla	gır	Noun	Noun
inat	inat	Noun	Noun
suratlı	surat	Noun	Adj
takımlardaki	takım	Noun	Adj
cenaze	cenaze	Noun	Noun
törensiz	tören	Noun	Adj
lanetinin	lanet	Noun	Noun
kazığa	kazık	Noun	Noun
samimiyetsiz	samimiyet	Noun	Adj
kibirli	kibir	Noun	Adj
sitemlerle	sitem	Noun	Noun
gelişimde	gelişim	Noun	Noun
çayını	çay	Noun	Noun
öğle	öğle	Noun	Noun
uykusuz	uyku	Noun	Adj
idarenin	idare	Noun	Noun
intihardan	intihar	Noun	Noun
vaftiz	vaftiz	Noun	Noun
vasiyetinde	vasiyet	Noun	Noun
ziyaret	ziyaret	Noun	Noun
ahbab	ahbap	Noun	Noun
mujiğin	mujik	Noun	Noun
meyhanecilerle	meyhane	Noun	Noun
bodrumlarda	bodrum	Noun	Noun
kanaate	kanaat	Noun	Noun
saygılı	saygı	Noun	Adj
hoşçakalın	hoşçakal	Noun	Noun
mazeretimi	mazeret	Noun	Noun
revoir	revoir	Noun	Noun
au	au	Noun	Noun
antreye	antre	Noun	Noun
deminden	demin	Noun	Noun
nişansız	nişan	Noun	Adj
vedalaşmasını	veda	Noun	Noun
keklik	keklik	Noun	Noun
peşinde	peş	Noun	Noun
komedi	komedi	Noun	Noun
tongaya	tonga	Noun	Noun
numaralı	numara	Noun	Adj
midem	mide	Noun	Noun
anlamsız	anlam	Noun	Adj
bakana	bakan	Noun	Noun
ihanet	ihanet	Noun	Noun
delikli	delik	Noun	Adj
cepli	cep	Noun	Adj
koyunları	koyun	Noun	Noun
nazlı	naz	Noun	Adj
yarığa	yarık	Noun	Noun
şakakları	şakak	Noun	Noun
alanınızdaki	alan	Noun	Adj
toplantıdaki	toplantı	Noun	Adj
iftihar	iftihar	Noun	Noun
çenemi	çene	Noun	Noun
vet	vet	Noun	Noun
fev	fev	Noun	Noun
ka	ka	Noun	Noun
la	la	Noun	Noun
le	le	Noun	Noun
lun	lu	Noun	Noun
komedyanızda	komedya	Noun	Noun
yaldızlı	yaldız	Noun	Adj
cehennemlik	cehennem	Noun	Noun
arısı	arı	Noun	Noun
yuvasındaki	yuva	Noun	Adj
kemikli	kemik	Noun	Adj
vakasını	vaka	Noun	Noun
dedikoducu	dedikodu	Noun	Noun
ikram	ikram	Noun	Noun
aralığındaki	aralık	Noun	Adj
dışardaki	dışarı	Noun	Adj
şekerli	şeker	Noun	Adj
asaletinden	asalet	Noun	Noun
nuz	nuz	Noun	Noun
nor	nor	Noun	Noun
belle	bel	Noun	Noun
zevkli	zevk	Noun	Adj
vücutlu	vücut	Noun	Adj
kızcağıza	kızcağız	Noun	Noun
dördünde	dördün	Noun	Noun
ge	ge	Noun	Noun
li	li	Noun	Noun
şi	şi	Noun	Noun
ci	ci	Noun	Noun
gözlüğüyle	gözlük	Noun	Noun
quelle	uel	Noun	Noun
charmante	charmante	Noun	Noun
artist	artist	Noun	Noun
piyano	piyano	Noun	Noun
manalı	mana	Noun	Adj
bakımlı	bakım	Noun	Adj
konteslerden	kontes	Noun	Noun
müş	müş	Noun	Noun
aşçısıyla	aşçı	Noun	Noun
ru	ru	Noun	Noun
kont	kont	Noun	Noun
unvan	unvan	Noun	Noun
bıyıklı	bıyık	Noun	Adj
kavgalı	kavga	Noun	Adj
charmant	charmant	Noun	Noun
zi	zi	Noun	Noun
ği	ği	Noun	Noun
taşkın	taşkın	Noun	Noun
burunlu	burun	Noun	Adj
enfiyeden	enfiye	Noun	Noun
rış	rış	Noun	Noun
tı	tı	Noun	Noun
rım	rı	Noun	Noun
rum	rum	Noun	Noun
defasında	defa	Noun	Noun
şövalyeler	şövalye	Noun	Noun
şarklı	şark	Noun	Adj
şatolar	şato	Noun	Noun
turnuvalar	turnuva	Noun	Noun
tır	tır	Noun	Noun
modda	mod	Noun	Noun
notayı	nota	Noun	Noun
heykeltıraşın	heykeltıraş	Noun	Noun
müzik	müzik	Noun	Noun
mem	me	Noun	Noun
ravissez	ravissez	Noun	Noun
ma	ma	Noun	Noun
enfant	enfant	Noun	Noun
yaşamındaki	yaşam	Noun	Adj
tabir	tabir	Noun	Noun
toplumdaki	toplum	Noun	Adj
kocası	koca	Noun	Noun
personne	personne	Noun	Noun
ü	ü	Noun	Noun
asilzadeliğin	asilzade	Noun	Noun
kralı	kral	Noun	Noun
sarayındaki	saray	Noun	Adj
dilberlerinden	dilber	Noun	Noun
görünün	görü	Noun	Noun
zümresinin	zümre	Noun	Noun
gururlu	gurur	Noun	Adj
gazetesini	gazete	Noun	Noun
yazılı	yazı	Noun	Adj
kı	kı	Noun	Noun
yım	yı	Noun	Noun
te	te	Noun	Noun
ri	ri	Noun	Noun
isteksiz	istek	Noun	Adj
chatelaine	chatelain	Noun	Noun
lat	lat	Noun	Noun
nız	nız	Noun	Noun
vikontesle	vikontes	Noun	Noun
düetler	düet	Noun	Noun
feda	feda	Noun	Noun
lar	lar	Noun	Noun
ler	ler	Noun	Noun
tiksinti	tiksinti	Noun	Noun
pı	pı	Noun	Noun
huşu	huşu	Noun	Noun
lı	lı	Noun	Noun
ayıp	ayıp	Noun	Noun
tahkir	tahkir	Noun	Noun
iftira	iftira	Noun	Noun
düğün	düğün	Noun	Noun
nolu	no	Noun	Adj
pa	pa	Noun	Noun
kor	kor	Noun	Noun
ku	ku	Noun	Noun
du	du	Noun	Noun
canavar	canavar	Noun	Noun
koltuğunun	koltuk	Noun	Noun
ba	ba	Noun	Noun
hi	hi	Noun	Noun
ğen	ğe	Noun	Noun
miş	miş	Noun	Noun
ğıt	ğıt	Noun	Noun
paz	paz	Noun	Noun
zım	zı	Noun	Noun
u	u	Noun	Noun
zan	zan	Noun	Noun
ter	ter	Noun	Noun
ziz	ziz	Noun	Noun
joli	joli	Noun	Noun
re	re	Noun	Noun
cher	cher	Noun	Noun
nu	nü	Noun	Noun
ni	ni	Noun	Noun
selamlaşmaya	selam	Noun	Noun
eşiğe	eşik	Noun	Noun
ağırlıklı	ağırlık	Noun	Adj
isimsiz	isim	Noun	Adj
yedekli	yedek	Noun	Adj
lüzumsuz	lüzum	Noun	Adj
ortamlardaki	ortam	Noun	Adj
zekadan	zeka	Noun	Noun
ahlarımızı	ah	Noun	Noun
şahım	şahım	Noun	Noun
bahtınızın	baht	Noun	Noun
sırtları	sırt	Noun	Noun
selameti	selamet	Noun	Noun
zihnime	zihin	Noun	Noun
halttan	halt	Noun	Noun
hanımı	hanım	Noun	Noun
çeyrek	çeyrek	Noun	Noun
hitap	hitap	Noun	Noun
gözcü	gözcü	Noun	Noun
toy	toy	Noun	Noun
kabahat	kabahat	Noun	Noun
delili	delil	Noun	Noun
terbiye	terbiye	Noun	Noun
güçlük	güçlük	Noun	Noun
çaresiz	çare	Noun	Adj
otoritemi	otorite	Noun	Noun
kuyumu	kuyu	Noun	Noun
devlet	devlet	Noun	Noun
kuşlar	kuş	Noun	Noun
servetin	servet	Noun	Noun
izdivacı	izdivaç	Noun	Noun
azabı	azap	Noun	Noun
noktalarındaki	nokta	Noun	Adj
mert	mert	Noun	Noun
sihirli	sihir	Noun	Adj
dayanağı	dayanak	Noun	Noun
yoldaşı	yoldaş	Noun	Noun
sevgisiz	sevgi	Noun	Adj
gurubu	gurup	Noun	Noun
cennetteki	cennet	Noun	Adj
rahibe	rahip	Noun	Noun
güvercinlerden	güvercin	Noun	Noun
vicdanındaki	vicdan	Noun	Adj
menfaat	menfaat	Noun	Noun
defterindeki	defter	Noun	Adj
kere	kere	Noun	Noun
payını	pay	Noun	Noun
kıt	kıt	Noun	Noun
dışlı	dış	Noun	Adj
deyim	deyim	Noun	Noun
bıçak	bıçak	Noun	Noun
manzaralı	manzara	Noun	Adj
burjuvazide	burjuvazi	Noun	Noun
baloda	balo	Noun	Noun
sütunlardaki	sütun	Noun	Adj
nağmeleri	nağme	Noun	Noun
sosyeteye	sosyete	Noun	Noun
mersinlerin	mersin	Noun	Noun
limon	limon	Noun	Noun
öpücük	öpücük	Noun	Noun
diyarda	diyar	Noun	Noun
mevkie	mevki	Noun	Noun
kadersiz	kader	Noun	Adj
akrabasının	akraba	Noun	Noun
şahısların	şahıs	Noun	Noun
sayede	saye	Noun	Noun
rütbeler	rütbe	Noun	Noun
düzendeki	düzen	Noun	Adj
taşkınlığınızdan	taşkınlık	Noun	Noun
gönlünü	gönül	Noun	Noun
sağlıklı	sağlık	Noun	Adj
duayı	dua	Noun	Noun
gündüzünü	gündüz	Noun	Noun
saadeti	saadet	Noun	Noun
pamuk	pamuk	Noun	Noun
ipliğine	ip	Noun	Noun
başkente	başkent	Noun	Noun
tuz	tuz	Noun	Noun
emanet	emanet	Noun	Noun
zafer	zafer	Noun	Noun
damarına	damar	Noun	Noun
çirkefin	çirkef	Noun	Noun
yüzüstü	yüzüst	Noun	Noun
tehlikeli	tehlike	Noun	Adj
namuslu	namus	Noun	Adj
kinli	kin	Noun	Adj
yakasındaki	yaka	Noun	Adj
yastıklara	yastık	Noun	Noun
dirseklerinden	dirsek	Noun	Noun
tutam	tutam	Noun	Noun
çekeceği	çekecek	Noun	Noun
vaad	vaad	Noun	Noun
vız	vız	Noun	Noun
ilerki	ileri	Noun	Adj
polisteki	polis	Noun	Adj
icabı	icap	Noun	Noun
macera	macera	Noun	Noun
sarhoş	sarhoş	Noun	Noun
kıyamet	kıyamet	Noun	Noun
mat	mat	Noun	Noun
tarzdaki	tarz	Noun	Adj
davet	davet	Noun	Noun
reisinin	reis	Noun	Noun
kilometrelik	kilometre	Noun	Noun
arabacı	arabacı	Noun	Noun
binalara	bina	Noun	Noun
pencereli	pencere	Noun	Adj
ıhlamur	ıhlamur	Noun	Noun
ağacındaki	ağaç	Noun	Adj
kasırga	kasırga	Noun	Noun
tembel	tembel	Noun	Noun
havlunun	havlu	Noun	Noun
hamamdan	hamam	Noun	Noun
beyin	beyin	Noun	Noun
semaverin	semaver	Noun	Noun
panik	panik	Noun	Noun
makasla	makas	Noun	Noun
bekle	bek	Noun	Noun
icat	icat	Noun	Noun
kıvırcık	kıvırcık	Noun	Noun
kulübelerde	kulübe	Noun	Noun
barakaların	baraka	Noun	Noun
yeller	yel	Noun	Noun
otomobil	otomobil	Noun	Noun
yüklü	yük	Noun	Adj
vaşaklar	vaşak	Noun	Noun
çığlığa	çığ	Noun	Noun
hakimiyeti	hakimiyet	Noun	Noun
yabandan	yaban	Noun	Noun
karınca	karınca	Noun	Noun
kalabalığı	kalaba	Noun	Noun
gereksinim	gereksinim	Noun	Noun
karabasan	karabasan	Noun	Noun
kabus	kabus	Noun	Noun
çantamdaki	çanta	Noun	Adj
bavul	bavul	Noun	Noun
yığınındaki	yığın	Noun	Adj
curcuna	curcuna	Noun	Noun
terk	terk	Noun	Noun
sandık	sandık	Noun	Noun
güneşlenen	güneş	Noun	Adj
meydanındaki	meydan	Noun	Adj
düşmancıl	düşmancıl	Noun	Noun
saldırılarına	saldırı	Noun	Noun
diken	diken	Noun	Noun
bindi	bindi	Noun	Noun
tekerlekli	tekerlek	Noun	Adj
bahçeli	bahçe	Noun	Adj
kestane	kestane	Noun	Noun
çatısı	çatı	Noun	Noun
çimenlerin	çimen	Noun	Noun
şuradaki	şura	Noun	Adj
meşe	meşe	Noun	Noun
tarlaların	tarla	Noun	Noun
tezat	tezat	Noun	Noun
tepedeki	tepe	Noun	Adj
otlakları	otlak	Noun	Noun
terasta	teras	Noun	Noun
çoban	çoban	Noun	Noun
hamle	hamle	Noun	Noun
zar	zar	Noun	Noun
çabasındaki	çaba	Noun	Adj
dengeli	denge	Noun	Adj
kıç	kıç	Noun	Noun
dişinin	dişi	Noun	Noun
kanundaki	kanun	Noun	Adj
içgüdüleri	içgüdü	Noun	Noun
bilinçaltına	bilinçaltı	Noun	Noun
seferki	sefer	Noun	Adj
babacığım	babacığım	Noun	Noun
kavisle	kavis	Noun	Noun
çayıra	çayır	Noun	Noun
hilelerinden	hile	Noun	Noun
çakıllı	çakıl	Noun	Adj
gemi	gem	Noun	Noun
gölgeli	gölge	Noun	Adj
tazının	tazı	Noun	Noun
gırtlağına	gırtlak	Noun	Noun
çapulcu	çapulcu	Noun	Noun
yaratığa	yaratık	Noun	Noun
kutbundan	kutup	Noun	Noun
geçmişimdeki	geçmiş	Noun	Adj
korkak	korkak	Noun	Noun
hatalı	hata	Noun	Adj
topuklu	topuk	Noun	Adj
homurtuda	homurtu	Noun	Noun
kozlarını	koz	Noun	Noun
pusuya	pusu	Noun	Noun
yaradılış	yaradılış	Noun	Noun
çevresindeki	çevre	Noun	Adj
yolculuğumuza	yolculuk	Noun	Noun
çiftliklerine	çiftlik	Noun	Noun
mekanını	mekan	Noun	Noun
dersin	ders	Noun	Noun
ahıra	ahır	Noun	Noun
cinsi	cins	Noun	Noun
öç	öç	Noun	Noun
olanaksız	olanak	Noun	Adj
zindan	zindan	Noun	Noun
öncesindeki	önce	Noun	Adj
intikamını	intikam	Noun	Noun
siper	siper	Noun	Noun
bireyleriyle	birey	Noun	Noun
yatak	yatak	Noun	Noun
çadır	çadır	Noun	Noun
alakalı	alaka	Noun	Adj
şamarı	şamar	Noun	Noun
falan	falan	Noun	Noun
parıltıları	parıltı	Noun	Noun
yargıç	yargıç	Noun	Noun
iltifatla	iltifat	Noun	Noun
mırıltı	mırıltı	Noun	Noun
ikna	ikna	Noun	Noun
hizmetçim	hizmetçi	Noun	Noun
yardımcı	yardımcı	Noun	Noun
mülkü	mülk	Noun	Noun
antlaşma	antlaşma	Noun	Noun
barış	barış	Noun	Noun
bulaşık	bulaşık	Noun	Noun
araziye	arazi	Noun	Noun
karayoluna	karayolu	Noun	Noun
çitlerle	çit	Noun	Noun
ilişkilerindeki	ilişki	Noun	Adj
kullanımlar	kullanım	Noun	Noun
gözlem	gözlem	Noun	Noun
eğitimli	eğitim	Noun	Adj
faktör	faktör	Noun	Noun
fiskesi	fiske	Noun	Noun
dayaklardan	dayak	Noun	Noun
muamelesini	muamele	Noun	Noun
ihtarlara	ihtar	Noun	Noun
sözlü	sözlü	Noun	Noun
uyarısı	uyarı	Noun	Noun
pusula	pusula	Noun	Noun
tamam	tamam	Noun	Noun
avla	av	Noun	Noun
kümeslerinde	kümes	Noun	Noun
tavuğa	tavuk	Noun	Noun
iştahlı	iştah	Noun	Adj
lezzetli	lezzet	Noun	Adj
civardaki	civar	Noun	Adj
imdadına	imdat	Noun	Noun
hevesi	heves	Noun	Noun
kursağında	kursak	Noun	Noun
silahlı	silah	Noun	Adj
kırbaca	kırbaç	Noun	Noun
sopasını	sopa	Noun	Noun
feryat	feryat	Noun	Noun
seyislerin	seyis	Noun	Noun
ödü	öd	Noun	Noun
müdahale	müdahale	Noun	Noun
cezalı	ceza	Noun	Adj
ciddiyet	ciddiyet	Noun	Noun
tabanlı	taban	Noun	Adj
suçüstü	suçüst	Noun	Noun
kümesindeki	küme	Noun	Adj
odun	odun	Noun	Noun
ölüsü	ölü	Noun	Noun
leşini	leş	Noun	Noun
anlık	anlık	Noun	Noun
tatsız	tat	Noun	Adj
gökyüzüne	gökyüzü	Noun	Noun
bucaksız	bucak	Noun	Adj
halkının	halk	Noun	Noun
yazlıkta	yazlık	Noun	Noun
içimdeki	içim	Noun	Adj
fırtınalı	fırtına	Noun	Adj
rıhtımda	rıhtım	Noun	Noun
hergün	hergün	Noun	Noun
sağdaki	sağ	Noun	Adj
bastonuyla	baston	Noun	Noun
tanışıklığımız	tanışık	Noun	Noun
şükür	şükür	Noun	Noun
tamir	tamir	Noun	Noun
kül	kül	Noun	Noun
mimar	mimar	Noun	Noun
hatırını	hatır	Noun	Noun
caniler	cani	Noun	Noun
demirsiz	demir	Noun	Adj
pervazlarına	pervaz	Noun	Noun
semte	semt	Noun	Noun
duvarın	duvar	Noun	Noun
örümcekler	örümcek	Noun	Noun
iskemleli	iskemle	Noun	Adj
çileli	çile	Noun	Adj
kadıncağız	kadıncağız	Noun	Noun
hazırlıklı	hazırlık	Noun	Adj
çiçekçiye	çiçekçi	Noun	Noun
giysi	giysi	Noun	Noun
alıcı	alıç	Noun	Noun
kılıklarıyla	kılık	Noun	Noun
belil	belil	Noun	Noun
kervanlarına	kervan	Noun	Noun
tanımlı	tanım	Noun	Adj
statüleri	statü	Noun	Noun
hengamenin	hengame	Noun	Noun
çağrısıyla	çağrı	Noun	Noun
köprüyü	köprü	Noun	Noun
otların	ot	Noun	Noun
tebessüm	tebessüm	Noun	Noun
belirtisi	belirti	Noun	Noun
bayırlarıyla	bayır	Noun	Noun
tutkulu	tutku	Noun	Adj
sineler	sine	Noun	Noun
coşkuyla	coşku	Noun	Noun
ışıltılarının	ışıltı	Noun	Noun
serüvene	serüven	Noun	Noun
kanalındaki	kanal	Noun	Adj
atkılı	atkı	Noun	Adj
istifini	istif	Noun	Noun
hıçkırıklarını	hıçkırık	Noun	Noun
romancılarımız	romancı	Noun	Noun
telaffuzundaki	telaffuz	Noun	Adj
tereddütsüz	tereddüt	Noun	Adj
kaldırıma	kaldırım	Noun	Noun
yaya	yaya	Noun	Noun
kaldırımınında	kaldırımının	Noun	Noun
fraklı	frak	Noun	Adj
boşlukta	boşluk	Noun	Noun
minnet	minnet	Noun	Noun
teşekkürünü	teşekkür	Noun	Noun
gözucuyla	gözucu	Noun	Noun
kirpiklerinin	kirpik	Noun	Noun
kaçamak	kaçamak	Noun	Noun
gelimi	gelim	Noun	Noun
sıkılgınlık	sıkılgın	Noun	Noun
lütuflu	lütuf	Noun	Adj
kulu	kul	Noun	Noun
ustalıkla	ustalık	Noun	Noun
günü	günü	Noun	Noun
kaleme	kale	Noun	Noun
tasavvur	tasavvur	Noun	Noun
sahibelerimi	sahibe	Noun	Noun
safiyetle	safiyet	Noun	Noun
içtenlikle	içtenlik	Noun	Noun
şanlı	şan	Noun	Adj
kızkardeş	kızkardeş	Noun	Noun
arkadaşlığa	arkadaşlık	Noun	Noun
daracık	dara	Noun	Noun
saniye	saniye	Noun	Noun
nimet	nimet	Noun	Noun
düşümde	düşüm	Noun	Noun
tanığı	tanık	Noun	Noun
kesinkes	kesinkes	Noun	Noun
barut	barut	Noun	Noun
mücadele	mücadele	Noun	Noun
barkından	bark	Noun	Noun
yurdumuzdan	yurt	Noun	Noun
kapakları	kapak	Noun	Noun
pırıltı	pırıltı	Noun	Noun
büyükanneye	büyükanne	Noun	Noun
herşey	herşey	Noun	Noun
peksimetleri	peksimet	Noun	Noun
tavayı	tava	Noun	Noun
müddetçe	müddet	Noun	Noun
büyükbabalarının	büyükbaba	Noun	Noun
bacaklarından	bacak	Noun	Noun
düğmeli	düğme	Noun	Adj
iliklerini	ilik	Noun	Noun
pantalon	pantalo	Noun	Noun
grimsi	gri	Noun	Adj
çamaşır	çamaşır	Noun	Noun
askılı	askı	Noun	Adj
tokasını	toka	Noun	Noun
muhalefet	muhalefet	Noun	Noun
öyküsel	öykü	Noun	Adj
alaycı	alaycı	Noun	Noun
ayinden	ayin	Noun	Noun
namlusuyla	namlu	Noun	Noun
santim	santim	Noun	Noun
böcekler	böcek	Noun	Noun
işkenceleri	işkence	Noun	Noun
elbisesi	elbise	Noun	Noun
harp	harp	Noun	Noun
narasını	nara	Noun	Noun
bilmiyenler	bilmiyen	Noun	Noun
tatmin	tatmin	Noun	Noun
birşeyler	birşey	Noun	Noun
forsepsi	forseps	Noun	Noun
ebe	ebe	Noun	Noun
ayrık	ayrık	Noun	Noun
okur	okur	Noun	Noun
hınzır	hınzır	Noun	Noun
habercilerdeki	haberci	Noun	Adj
hapiste	hapis	Noun	Noun
hırsız	hırsız	Noun	Noun
herif	herif	Noun	Noun
hapishaneden	hapishane	Noun	Noun
parmaklıklı	parmaklık	Noun	Adj
boğalara	boğa	Noun	Noun
karnımda	karın	Noun	Noun
durağı	durak	Noun	Noun
kamyonlar	kamyon	Noun	Noun
salça	salça	Noun	Noun
kasesinin	kase	Noun	Noun
sinekleri	sinek	Noun	Noun
daikka	daikka	Noun	Noun
deposundaki	depo	Noun	Adj
etmen	etmen	Noun	Noun
mutfaklarda	mutfak	Noun	Noun
kahvaltılarını	kahvaltı	Noun	Noun
vaz	vaz	Noun	Noun
gidi	gidi	Noun	Noun
keçi	keçi	Noun	Noun
göbeğinin	göbek	Noun	Noun
suretle	suret	Noun	Noun
hakikati	hakikat	Noun	Noun
çöle	çöl	Noun	Noun
dertlerimizi	dert	Noun	Noun
neticeye	netice	Noun	Noun
min	mi	Noun	Noun
fasılalarına	fasıla	Noun	Noun
yiyecek	yiyecek	Noun	Noun
giyecek	giyecek	Noun	Noun
lokmaları	lokma	Noun	Noun
minnettarım	minnettar	Noun	Noun
mevcut	mevcut	Noun	Noun
köpürtüsü	köpürtü	Noun	Noun
yudumunu	yudum	Noun	Noun
karyolalar	karyola	Noun	Noun
pervane	pervane	Noun	Noun
tahtasındaki	tahta	Noun	Adj
motorlu	motor	Noun	Adj
teke	teke	Noun	Noun
sevine	sevi	Noun	Noun
açıkhava	açıkhava	Noun	Noun
serseriler	serseri	Noun	Noun
üzümleri	üzüm	Noun	Noun
sepet	sepet	Noun	Noun
bebeğini	bebek	Noun	Noun
mil	mil	Noun	Noun
süpapları	süpap	Noun	Noun
lastikli	lastik	Noun	Adj
şoseye	şose	Noun	Noun
bezi	bez	Noun	Noun
telin	tel	Noun	Noun
yaygarayı	yaygara	Noun	Noun
tozlu	toz	Noun	Adj
tetkik	tetkik	Noun	Noun
kaskete	kasket	Noun	Noun
ayakkabılarıyla	ayakkabı	Noun	Noun
güneşliğini	güneşlik	Noun	Noun
tasdik	tasdik	Noun	Noun
kuyruğunu	kuyruk	Noun	Noun
horoz	horoz	Noun	Noun
kabara	kabara	Noun	Noun
ağabeyimin	ağabey	Noun	Noun
yaşıtları	yaşıt	Noun	Noun
kürek	kürek	Noun	Noun
külhanbeyi	külhanbeyi	Noun	Noun
sırık	sırık	Noun	Noun
fasulyası	fasulya	Noun	Noun
tın	tın	Noun	Noun
yolculağa	yolculağ	Noun	Noun
tohum	tohum	Noun	Noun
makinanın	makina	Noun	Noun
çapalar	çapa	Noun	Noun
sent	sent	Noun	Noun
traktörler	traktör	Noun	Noun
doru	doru	Noun	Noun
kişniyerek	kişniyerek	Noun	Noun
perçemlerini	perçem	Noun	Noun
yelelerini	yele	Noun	Noun
örmeğe	örmeğ	Noun	Noun
kurdelasını	kurdela	Noun	Noun
tay	tay	Noun	Noun
çekerler	çeker	Noun	Noun
bayram	bayram	Noun	Noun
emeğini	emek	Noun	Noun
prim	prim	Noun	Noun
içki	içki	Noun	Noun
alkolsüz	alkol	Noun	Adj
meyva	meyva	Noun	Noun
sel	sel	Noun	Noun
ızdırap	ızdırap	Noun	Noun
ordunuzdaki	ordu	Noun	Adj
istikamette	istikamet	Noun	Noun
terör	terör	Noun	Noun
leğene	leğen	Noun	Noun
kovalar	kova	Noun	Noun
vazo	vazo	Noun	Noun
tencereye	tencere	Noun	Noun
yorganlar	yorgan	Noun	Noun
lamba	lamba	Noun	Noun
kanaviçe	kanaviçe	Noun	Noun
gaz	gaz	Noun	Noun
römorkun	römork	Noun	Noun
şiltenin	şilte	Noun	Noun
testere	testere	Noun	Noun
mengene	mengene	Noun	Noun
kıskaç	kıskaç	Noun	Noun
balta	balta	Noun	Noun
oku	ok	Noun	Noun
olırım	olır	Noun	Noun
kitaplığınızdaki	kitap	Noun	Adj
pipolarını	pipo	Noun	Noun
zifir	zifir	Noun	Noun
resmindeki	resim	Noun	Adj
evvelki	evvel	Noun	Adj
sergisinden	sergi	Noun	Noun
mektup	mektup	Noun	Noun
söğüt	söğüt	Noun	Noun
döşeğin	döşek	Noun	Noun
aletlerinin	alet	Noun	Noun
somyalar	somya	Noun	Noun
samanlığa	saman	Noun	Noun
saçak	saçak	Noun	Noun
sabunlu	sabun	Noun	Adj
köpükleri	köpük	Noun	Noun
ensesine	ense	Noun	Noun
ilan	ilan	Noun	Noun
yinede	yine	Noun	Noun
yazar	yazar	Noun	Noun
harfli	harf	Noun	Adj
küplere	küp	Noun	Noun
haritanızdaki	harita	Noun	Adj
kartpostal	kartpostal	Noun	Noun
yarını	yarın	Noun	Noun
kamplarda	kamp	Noun	Noun
kağıt	kağıt	Noun	Noun
zahmetli	zahmet	Noun	Adj
parlıyan	parlıya	Noun	Noun
hizalı	hiza	Noun	Adj
tulumlarla	tulum	Noun	Noun
hayalarının	haya	Noun	Noun
pantalonumun	pantalon	Noun	Noun
alaylı	alaylı	Noun	Noun
teknesi	tekne	Noun	Noun
paçalı	paça	Noun	Adj
kerata	kerata	Noun	Noun
hergele	hergele	Noun	Noun
atımı	atım	Noun	Noun
ocak	ocak	Noun	Noun
görüntülü	görüntü	Noun	Adj
dumanın	duma	Noun	Noun
bardaklardan	bardak	Noun	Noun
cumartesi	cumartesi	Noun	Noun
romun	rom	Noun	Noun
mezarlıklar	mezarlık	Noun	Noun
kilise	kilise	Noun	Noun
tabureye	tabure	Noun	Noun
gezinti	gezinti	Noun	Noun
saçı	saçı	Noun	Noun
kıyısındaki	kıyı	Noun	Adj
çingene	çingene	Noun	Noun
kaçak	kaçak	Noun	Noun
ufaklığın	ufaklık	Noun	Noun
soyadı	soyad	Noun	Noun
baskılı	baskı	Noun	Adj
gösterisi	gösteri	Noun	Noun
muhatabı	muhatap	Noun	Noun
bendim	bent	Noun	Noun
kaşık	kaşık	Noun	Noun
eğenin	eğe	Noun	Noun
şalgamlardan	şalgam	Noun	Noun
şilinlik	şilin	Noun	Noun
aval	aval	Noun	Noun
gayret	gayret	Noun	Noun
tanıdığa	tanıdık	Noun	Noun
ablamı	abla	Noun	Noun
muzaffer	muzaffer	Noun	Noun
banknottan	banknot	Noun	Noun
sığır	sığır	Noun	Noun
çaydanlığın	çaydanlık	Noun	Noun
anlaşmalı	anlaşma	Noun	Adj
çarşamba	çarşamba	Noun	Noun
zil	zil	Noun	Noun
mumla	mum	Noun	Noun
kare	kare	Noun	Noun
zeminli	zemin	Noun	Adj
avluda	avlu	Noun	Noun
bira	bira	Noun	Noun
imalathanesinin	imalathane	Noun	Noun
kasıtlı	kasıt	Noun	Adj
lahana	lahana	Noun	Noun
şimşir	şimşir	Noun	Noun
pudinge	puding	Noun	Noun
kadarıyla	kadar	Noun	Noun
dalkavuk	dalkavuk	Noun	Noun
tipler	tip	Noun	Noun
izlenimini	izlenim	Noun	Noun
vasıflı	vasıf	Noun	Adj
yordamdaki	yordam	Noun	Adj
sistemindeki	sistem	Noun	Adj
yağmura	yağmur	Noun	Noun
tokat	tokat	Noun	Noun
kıyım	kıyım	Noun	Noun
sakallı	sakal	Noun	Adj
favorilerinin	favori	Noun	Noun
tuvalet	tuvalet	Noun	Noun
şöminenin	şömine	Noun	Noun
dumanlı	duman	Noun	Adj
bataklıkta	bataklık	Noun	Noun
rafta	raf	Noun	Noun
küf	küf	Noun	Noun
lime	lime	Noun	Noun
obje	obje	Noun	Noun
ziyafet	ziyafet	Noun	Noun
tıkırtılar	tıkırtı	Noun	Noun
karafatmalar	karafatma	Noun	Noun
cadıya	cadı	Noun	Noun
balmumundan	balmumu	Noun	Noun
pastayı	pasta	Noun	Noun
taklit	taklit	Noun	Noun
yapılı	yapı	Noun	Adj
zencefil	zencefil	Noun	Noun
amonyum	amonyum	Noun	Noun
karbonatlara	karbonat	Noun	Noun
sindirim	sindirim	Noun	Noun
ceviz	ceviz	Noun	Noun
kabuklarından	kabuk	Noun	Noun
kediye	kedi	Noun	Noun
etekli	etek	Noun	Adj
kanepeye	kanepe	Noun	Noun
akortçusunun	akort	Noun	Noun
boğazına	boğaz	Noun	Noun
oluşumların	oluşum	Noun	Noun
beklentisi	beklenti	Noun	Noun
kimyasını	kimya	Noun	Noun
eninde	en	Noun	Noun
melankoliyle	melankoli	Noun	Noun
mazur	mazur	Noun	Noun
doğumlu	doğum	Noun	Adj
müsaade	müsaade	Noun	Noun
gelirler	gelir	Noun	Noun
teşebbüs	teşebbüs	Noun	Noun
fare	fare	Noun	Noun
gelinliğimin	gelinlik	Noun	Noun
gerdanında	gerdan	Noun	Noun
tenezzül	tenezzül	Noun	Noun
düzine	düzine	Noun	Noun
kavunla	kavun	Noun	Noun
salatalık	salatalık	Noun	Noun
yumru	yumru	Noun	Noun
serayı	sera	Noun	Noun
pat	pat	Noun	Noun
mürekkebi	mürekkep	Noun	Noun
gezmene	gezmen	Noun	Noun
sirke	sirke	Noun	Noun
süngeri	sünger	Noun	Noun
sivilceler	sivilce	Noun	Noun
bilekleri	bilek	Noun	Noun
kısmındaki	kısım	Noun	Adj
mekanik	mekanik	Noun	Noun
maharet	maharet	Noun	Noun
sürpriz	sürpriz	Noun	Noun
bere	bere	Noun	Noun
anahtarlarla	anahtar	Noun	Noun
vadeli	vade	Noun	Adj
kısıtlı	kısıt	Noun	Adj
çapındaki	çap	Noun	Adj
melodramlardaki	melodram	Noun	Adj
huysuz	huy	Noun	Adj
şiddetlenen	şiddet	Noun	Adj
kirlenen	kir	Noun	Adj
ihtiraslı	ihtiras	Noun	Adj
astarlı	astar	Noun	Adj
kapüşonlu	kapüşon	Noun	Adj
kıymetli	kıymet	Noun	Adj
doyumsuz	doyum	Noun	Adj
tumturaklı	tumturak	Noun	Adj
parterdeki	parter	Noun	Adj
çehreli	çehre	Noun	Adj
çerçeveli	çerçeve	Noun	Adj
kıpırtısız	kıpırtı	Noun	Adj
ihtiyatlı	ihtiyat	Noun	Adj
isabetli	isabet	Noun	Adj
iğneli	iğne	Noun	Adj
drahomasız	drahoma	Noun	Adj
nüfuslu	nüfus	Noun	Adj
kusursuz	kusur	Noun	Adj
ünlü	ün	Noun	Adj
namlı	nam	Noun	Adj
azametli	azamet	Noun	Adj
kravatlı	kravat	Noun	Adj
ferli	fer	Noun	Adj
devimsi	dev	Noun	Adj
elektrikli	elektrik	Noun	Adj
çöreklenen	çörek	Noun	Adj
kuşkulandığınız	kuşku	Noun	Adj
butlu	but	Noun	Adj
karşılaşmalarımızdaki	karşılaşma	Noun	Adj
görünümünüzdeki	görünüm	Noun	Adj
nezdinizdeki	nezit	Noun	Adj
salyalı	salya	Noun	Adj
edepsiz	edep	Noun	Adj
çilli	çil	Noun	Adj
tavanlı	tavan	Noun	Adj
işlemeli	işleme	Noun	Adj
tenli	ten	Noun	Adj
köstekli	köstek	Noun	Adj
benekli	benek	Noun	Adj
şuursuzca	şuur	Noun	Adj
benizli	beniz	Noun	Adj
hünerli	hüner	Noun	Adj
heybetli	heybet	Noun	Adj
mantıklı	mantık	Noun	Adj
sonrasındaki	sonra	Noun	Adj
verimli	verim	Noun	Adj
fizyolojik	fizyoloji	Noun	Adj
zarflı	zarf	Noun	Adj
iltihaplı	iltihap	Noun	Adj
kuzeyindeki	kuzey	Noun	Adj
niteliğindeki	nitelik	Noun	Adj
edebiyatındaki	edebiyat	Noun	Adj
öğretisindeki	öğreti	Noun	Adj
dönemindeki	dönem	Noun	Adj
dolaylı	dolay	Noun	Adj
kolalı	kola	Noun	Adj
fabrikadaki	fabrika	Noun	Adj
sedasız	seda	Noun	Adj
ikircikli	ikircik	Noun	Adj
yeryüzündeki	yeryüzü	Noun	Adj
dizisindeki	dizi	Noun	Adj
uzunluğundaki	uzunluk	Noun	Adj
kapsamındaki	kapsam	Noun	Adj
uzaklıktaki	uzaklık	Noun	Adj
çelimsiz	çelim	Noun	Adj
ufuktaki	ufuk	Noun	Adj
kasnaksız	kasnak	Noun	Adj
zincirsiz	zincir	Noun	Adj
gizemli	gizem	Noun	Adj
tereyağlı	tereyağı	Noun	Adj
böreksiz	börek	Noun	Adj
sisli	sis	Noun	Adj
dahaki	daha	Noun	Adj
kabiliyetli	kabiliyet	Noun	Adj
espirili	espiri	Noun	Adj
beceriksiz	becerik	Noun	Adj
katmerli	katmer	Noun	Adj
hareli	hare	Noun	Adj
pahalı	paha	Noun	Adj
tahsilli	tahsil	Noun	Adj
markalı	marka	Noun	Adj
çamurlu	çamur	Noun	Adj
kalitesiz	kalite	Noun	Adj
ayrıcalıklı	ayrıcalık	Noun	Adj
ödüllü	ödül	Noun	Adj
pürüzsüz	pürüz	Noun	Adj
engebeli	engebe	Noun	Adj
dolambaçlı	dolambaç	Noun	Adj
hummalı	humma	Noun	Adj
bilinçli	bilinç	Noun	Adj
cilalı	cila	Noun	Adj
sahanlıktaki	sahan	Noun	Adj
alacalı	alaca	Noun	Adj
astımlı	astım	Noun	Adj
filizlendirdiği	filiz	Noun	Adj
riyasız	riya	Noun	Adj
kültürlü	kültür	Noun	Adj
karşılıksız	karşılık	Noun	Adj
cezaevindeki	cezaevi	Noun	Adj
ıztıraplı	ıztırap	Noun	Adj
adaleli	adale	Noun	Adj
ütülü	ütü	Noun	Adj
imalı	ima	Noun	Adj
ebatlardaki	ebat	Noun	Adj
jandarmasız	jandarma	Noun	Adj
cüsseli	cüsse	Noun	Adj
zehirli	zehir	Noun	Adj
bilgisayarlarındaki	bilgisayar	Noun	Adj
takılardaki	takı	Noun	Adj
listelerdeki	liste	Noun	Adj
klasörünüzdeki	klasör	Noun	Adj
etkileşimli	etkileşim	Noun	Adj
bölgesindeki	bölge	Noun	Adj
veritabanındaki	veritabanı	Noun	Adj
tablosundaki	tablo	Noun	Adj
sayfadaki	sayfa	Noun	Adj
gruptaki	grup	Noun	Adj
seçili	seçi	Noun	Adj
çubuğundaki	çubuk	Noun	Adj
diskli	disk	Noun	Adj
dağıtımlı	dağıtım	Noun	Adj
kutusundaki	kutu	Noun	Adj
şeritli	şerit	Noun	Adj
yetkisiz	yetki	Noun	Adj
şablonundaki	şablon	Noun	Adj
sertifikalı	sertifika	Noun	Adj
birimindeki	birim	Noun	Adj
eşzamanlı	eşzaman	Noun	Adj
satırlardaki	satır	Noun	Adj
kılavuzundaki	kılavuz	Noun	Adj
şifreli	şifre	Noun	Adj
dizindeki	dizin	Noun	Adj
nesnedeki	nesne	Noun	Adj
ücretsiz	ücret	Noun	Adj
sunucudaki	sunucu	Noun	Adj
hücresindeki	hücre	Noun	Adj
girdideki	girdi	Noun	Adj
aşamalı	aşama	Noun	Adj
kablosuz	kablo	Noun	Adj
kodlu	kod	Noun	Adj
etiketli	etiket	Noun	Adj
koşulsuz	koşul	Noun	Adj
grafiklendiği	grafik	Noun	Adj
ekranlı	ekran	Noun	Adj
başvurudaki	başvuru	Noun	Adj
kesirli	kesir	Noun	Adj
dağılımlı	dağılım	Noun	Adj
sihirbazındaki	sihirbaz	Noun	Adj
ofisteki	ofis	Noun	Adj
kimliğindeki	kimlik	Noun	Adj
paketindeki	paket	Noun	Adj
ilkeli	ilke	Noun	Adj
katmanındaki	katman	Noun	Adj
istasyonundaki	istasyon	Noun	Adj
öğeli	öğe	Noun	Adj
hasarlı	hasar	Noun	Adj
sitedeki	site	Noun	Adj
mesafedeki	mesafe	Noun	Adj
ayarlarınızdaki	ayar	Noun	Adj
dosyasındaki	dosya	Noun	Adj
oranlı	oran	Noun	Adj
seçimli	seçim	Noun	Adj
başlıklı	başlık	Noun	Adj
sorunlu	sorun	Noun	Adj
üslü	üs	Noun	Adj
devresel	devre	Noun	Adj
işlevsiz	işlev	Noun	Adj
işlemcili	işlemci	Noun	Adj
eğimli	eğim	Noun	Adj
uzantılı	uzantı	Noun	Adj
blögesel	blöge	Noun	Adj
simgedeki	simge	Noun	Adj
menüsündeki	menü	Noun	Adj
programlı	program	Noun	Adj
işyerinizdeki	işyeri	Noun	Adj
eksenli	eksen	Noun	Adj
sakıncalı	sakınca	Noun	Adj
ağımdaki	ağım	Noun	Adj
orantılı	orantı	Noun	Adj
bayraklı	bayrak	Noun	Adj
nottaki	not	Noun	Adj
aygıttaki	aygıt	Noun	Adj
slaytlardaki	slayt	Noun	Adj
kartındaki	kart	Noun	Adj
kalanındaki	kalan	Noun	Adj
serisindeki	seri	Noun	Adj
cetveldeki	cetvel	Noun	Adj
ölçekli	ölçek	Noun	Adj
bağlantısız	bağlantı	Noun	Adj
belgedeki	belge	Noun	Adj
tırtıklı	tırtık	Noun	Adj
kategorisindeki	kategori	Noun	Adj
sürücüsündeki	sürücü	Noun	Adj
paylaşımlı	paylaşım	Noun	Adj
öncelikli	öncelik	Noun	Adj
komutundaki	komut	Noun	Adj
konsolsuz	konsol	Noun	Adj
içeriklerindeki	içerik	Noun	Adj
çıktıdaki	çıktı	Noun	Adj
yürürlükteki	yürürlük	Noun	Adj
uluslararası	ulus	Noun	Adj
memeli	meme	Noun	Adj
mürettebatlı	mürettebat	Noun	Adj
ovadaki	ova	Noun	Adj
palmiyeli	palmiye	Noun	Adj
çilekli	çilek	Noun	Adj
peynirimsi	peynir	Noun	Adj
soslu	sos	Noun	Adj
midyeli	midye	Noun	Adj
çivili	çivi	Noun	Adj
sorumsuz	sorum	Noun	Adj
bulutlu	bulut	Noun	Adj
ihbarlı	ihbar	Noun	Adj
sayısındadaki	sayısında	Noun	Adj
kökenli	köken	Noun	Adj
istikrarsız	istikrar	Noun	Adj
kılıflı	kılıf	Noun	Adj
menzilindeki	menzil	Noun	Adj
riskli	risk	Noun	Adj
kazalı	kaza	Noun	Adj
üniformalı	üniforma	Noun	Adj
önderliğindeki	önder	Noun	Adj
bazlı	baz	Noun	Adj
mahalleli	mahalle	Noun	Adj
otelindeki	otel	Noun	Adj
mahsullü	mahsul	Noun	Adj
turizmdeki	turizm	Noun	Adj
sektöründeki	sektör	Noun	Adj
taksitli	taksit	Noun	Adj
desilebeli	desilebe	Noun	Adj
ideolojik	ideoloji	Noun	Adj
kapasiteli	kapasite	Noun	Adj
çanağındaki	çanak	Noun	Adj
sahilindeki	sahil	Noun	Adj
kucağındaki	kucak	Noun	Adj
güneydeki	güney	Noun	Adj
konserdeki	konser	Noun	Adj
tabancalı	tabanca	Noun	Adj
torbadaki	torba	Noun	Adj
ekolojik	ekoloji	Noun	Adj
iyotlu	iyot	Noun	Adj
meteorolojik	meteoroloji	Noun	Adj
haneli	hane	Noun	Adj
sütlü	süt	Noun	Adj
macunlu	macun	Noun	Adj
boncuklu	boncuk	Noun	Adj
simli	sim	Noun	Adj
fıstıklı	fıstık	Noun	Adj
görkemli	görkem	Noun	Adj
konforlu	konfor	Noun	Adj
vadideki	vadi	Noun	Adj
biyolojik	biyoloji	Noun	Adj
domatesli	domates	Noun	Adj
soğanlı	soğan	Noun	Adj
kaşarlı	kaşar	Noun	Adj
yamaçlarındaki	yamaç	Noun	Adj
özenli	özen	Noun	Adj
gişesindeki	gişe	Noun	Adj
şifalı	şifa	Noun	Adj
doğusundaki	doğu	Noun	Adj
kesintisiz	kesinti	Noun	Adj
depremdeki	deprem	Noun	Adj
felçli	felç	Noun	Adj
ağaçlıklı	ağaçlık	Noun	Adj
logosundaki	logo	Noun	Adj
hologramlı	hologram	Noun	Adj
indirimli	indirim	Noun	Adj
standlardaki	stand	Noun	Adj
yelkenli	yelken	Noun	Adj
armalı	arma	Noun	Adj
sırmalı	sırma	Noun	Adj
buzlu	buz	Noun	Adj
mevsimlerdeki	mevsim	Noun	Adj
krokanlı	krokan	Noun	Adj
haşmetli	haşmet	Noun	Adj
sezondaki	sezon	Noun	Adj
madalyalı	madalya	Noun	Adj
iddalı	idda	Noun	Adj
karakterli	karakter	Noun	Adj
puanlı	puan	Noun	Adj
tenisteki	tenis	Noun	Adj
lisanslı	lisans	Noun	Adj
müjdeli	müjde	Noun	Adj
stresli	stres	Noun	Adj
futbolsuz	futbol	Noun	Adj
kamuoyundaki	kamuoyu	Noun	Adj
golsüz	gol	Noun	Adj
maçtaki	maç	Noun	Adj
avantajlı	avantaj	Noun	Adj
stattaki	stat	Noun	Adj
tribünlerdeki	tribün	Noun	Adj
sahadaki	saha	Noun	Adj
psikolojik	psikoloji	Noun	Adj
trefli	tref	Noun	Adj
taktiksel	taktik	Noun	Adj
ribauntlardaki	ribaunt	Noun	Adj
otoparklı	otopark	Noun	Adj
mülkiyetli	mülkiyet	Noun	Adj
peşinatsız	peşinat	Noun	Adj
havuzlardaki	havuz	Noun	Adj
izolasyonlu	izolasyon	Noun	Adj
bordürlü	bordür	Noun	Adj
teknolojik	teknoloji	Noun	Adj
talihsiz	talih	Noun	Adj
basınçlı	basınç	Noun	Adj
zamlı	zam	Noun	Adj
klorlu	klor	Noun	Adj
atılımlı	atılım	Noun	Adj
kıdemli	kıdem	Noun	Adj
bankalardaki	banka	Noun	Adj
yokuşlu	yokuş	Noun	Adj
mezbahalardaki	mezbaha	Noun	Adj
ruhsatlı	ruhsat	Noun	Adj
alımlı	alım	Noun	Adj
ojeli	oje	Noun	Adj
tasmasız	tasma	Noun	Adj
sanayileşen	sanayi	Noun	Adj
şubesindeki	şube	Noun	Adj
vurgunundaki	vurgun	Noun	Adj
vefalı	vefa	Noun	Adj
fıkradaki	fıkra	Noun	Adj
zirvesindeki	zirve	Noun	Adj
hafızalardaki	hafıza	Noun	Adj
belediyelerdeki	belediye	Noun	Adj
eşanlamlı	eşanlam	Noun	Adj
mahkemelerdeki	mahkeme	Noun	Adj
süretli	süret	Noun	Adj
problemli	problem	Noun	Adj
arenadaki	arena	Noun	Adj
başkanlığındaki	başkanlık	Noun	Adj
tansiyonlu	tansiyon	Noun	Adj
albümdeki	albüm	Noun	Adj
maaşlı	maaş	Noun	Adj
enzimlerindeki	enzim	Noun	Adj
moralsiz	moral	Noun	Adj
hükümetteki	hükümet	Noun	Adj
gümrüklerdeki	gümrük	Noun	Adj
televizyonlardaki	televizyon	Noun	Adj
ömenli	ömen	Noun	Adj
mitleştirildiği	mit	Noun	Adj
farlı	far	Noun	Adj
kesimli	kesim	Noun	Adj
pileli	pile	Noun	Adj
tesettürlü	tesettür	Noun	Adj
dökümlü	döküm	Noun	Adj
dekolteli	dekolte	Noun	Adj
yünlü	yün	Noun	Adj
abartılı	abartı	Noun	Adj
fonksiyonlu	fonksiyon	Noun	Adj
desenli	desen	Noun	Adj
özündeki	öz	Noun	Adj
gardıroplarımızdaki	gardırop	Noun	Adj
yırtmaçlı	yırtmaç	Noun	Adj
temalı	tema	Noun	Adj
puantiyeli	puantiye	Noun	Adj
korsajlı	korsaj	Noun	Adj
motifli	motif	Noun	Adj
mineli	mine	Noun	Adj
temkinli	temkin	Noun	Adj
mesleğindeki	meslek	Noun	Adj
fotograftaki	fotoğraf	Noun	Adj
panjurlu	panjur	Noun	Adj
giyimli	giyim	Noun	Adj
cephedeki	cephe	Noun	Adj
fosforlu	fosfor	Noun	Adj
rakımlı	rakım	Noun	Adj
ampülü	ampü	Noun	Adj
mevzideki	mevzi	Noun	Adj
mangasındaki	manga	Noun	Adj
mayınlı	mayın	Noun	Adj
ağdalı	ağda	Noun	Adj
makamındaki	makam	Noun	Adj
beyazperdedeki	beyazperde	Noun	Adj
flatolu	flato	Noun	Adj
disiplinli	disiplin	Noun	Adj
stüdyodaki	stüdyo	Noun	Adj
korumasız	koruma	Noun	Adj
özverili	özveri	Noun	Adj
kumlu	kum	Noun	Adj
killi	kil	Noun	Adj
internetteki	internet	Noun	Adj
fermuarlı	fermuar	Noun	Adj
fileli	file	Noun	Adj
kumaşlı	kumaş	Noun	Adj
termoslu	termos	Noun	Adj
pilili	pili	Noun	Adj
müzedeki	müze	Noun	Adj
raylı	ray	Noun	Adj
buharlı	buhar	Noun	Adj
tesilli	tesil	Noun	Adj
geleli	gele	Noun	Adj
bakanlığındaki	bakanlık	Noun	Adj
endeksli	endeks	Noun	Adj
kefenli	kefen	Noun	Adj
rahatladığınız	rahatla	Verb	Adj
gözlemeye	gözle	Verb	Noun
düzeltmeliyiz	düzel	Verb	Verb
çıkmadıkları	çık	Verb	Adj
görebildiğimiz	gör	Verb	Adj
indiğim	in	Verb	Adj
gerileyeceği	gerile	Verb	Adj
düştüğümüz	düş	Verb	Adj
imiş	i	Verb	Verb
ödediğim	öde	Verb	Adj
bulunduran	bulun	Verb	Adj
olamadıkları	ol	Verb	Adj
etmediğiniz	et	Verb	Adj
verdiğimiz	ver	Verb	Adj
belirtildiği	belir	Verb	Adj
bildigi	bil	Verb	Adj
yaptıramadığı	yap	Verb	Adj
söyleyemediği	söyle	Verb	Adj
seçtiği	seç	Verb	Adj
koyabildiğiniz	koy	Verb	Adj
çektirdiğim	çek	Verb	Adj
istenildiği	iste	Verb	Adj
gelindiği	gel	Verb	Adj
yumuşamıştım	yumuşa	Verb	Verb
biliyoruz	bile	Verb	Verb
gittiğimiz	git	Verb	Adj
attıkları	at	Verb	Adj
imzalandığı	imzala	Verb	Adj
benzeyecek	benze	Verb	Adj
tartışıldığı	tartış	Verb	Adj
sanılan	san	Verb	Adj
sevdikleri	sev	Verb	Adj
bağıran	bağır	Verb	Adj
çekinen	çekin	Verb	Adj
binen	bin	Verb	Adj
geçebilecek	geç	Verb	Adj
gerektirecek	gerek	Verb	Adj
yarattığım	yara	Verb	Adj
tiksiniyordu	tiksin	Verb	Verb
ayırmadığım	ayır	Verb	Adj
varan	var	Verb	Adj
dolanan	dola	Verb	Adj
okşanan	okşa	Verb	Adj
beklediğimiz	bekle	Verb	Adj
oturulacak	otur	Verb	Adj
dolaştırdığım	dolaş	Verb	Adj
işittiği	işit	Verb	Adj
ittiği	it	Verb	Adj
aldıran	al	Verb	Adj
düşünmediği	düşün	Verb	Adj
izleyeceği	izle	Verb	Adj
dökülürkenki	dök	Verb	Adj
durduran	dur	Verb	Adj
baktıkları	bak	Verb	Adj
ıslanan	ısla	Verb	Adj
döndürülen	dön	Verb	Adj
dediğiniz	de	Verb	Adj
dolandırılmış	dolan	Verb	Verb
soluya	solu	Verb	Verb
çatıyordu	çat	Verb	Verb
duymayan	duy	Verb	Adj
hatırlattığımız	hatırla	Verb	Adj
acıyan	acı	Verb	Adj
adayan	ada	Verb	Adj
sallamakla	salla	Verb	Noun
yaşadığımız	yaşa	Verb	Adj
haykırmak	haykır	Verb	Noun
dolduran	dol	Verb	Adj
silinen	sil	Verb	Adj
fısıldanan	fısılda	Verb	Adj
öpüşür	öp	Verb	Adj
kalıveren	kal	Verb	Adj
bulunabilen	bul	Verb	Adj
öldürüldüğü	öl	Verb	Adj
göstereceğimiz	göster	Verb	Adj
kestiremeyen	kes	Verb	Adj
koşuldukları	koş	Verb	Adj
kaybolan	kaybol	Verb	Adj
yıprandı	yıpran	Verb	Verb
açıkladığı	açıkla	Verb	Adj
hissettiren	hisset	Verb	Adj
hazırladığımız	hazırla	Verb	Adj
eğmeleri	eğ	Verb	Noun
değiliz	değil	Verb	Verb
ilgilenen	ilgilen	Verb	Adj
nişanlandığından	nişanla	Verb	Noun
silkindi	silkin	Verb	Verb
inanmadığım	inan	Verb	Adj
kaybeden	kaybet	Verb	Adj
sakladığı	sakla	Verb	Adj
evlendiği	evlen	Verb	Adj
geliştiren	geliş	Verb	Adj
unutturan	unut	Verb	Adj
üzen	üz	Verb	Adj
onaylatmadığı	onayla	Verb	Adj
sorduğumuz	sor	Verb	Adj
karışan	karış	Verb	Adj
büyüleyen	büyüle	Verb	Adj
vurduğum	vur	Verb	Adj
kılan	kıl	Verb	Adj
yitirdiği	yit	Verb	Adj
getirdikleri	getir	Verb	Adj
ekledikleri	ekle	Verb	Adj
kastettiği	kastet	Verb	Adj
gülen	gül	Verb	Adj
korkan	kork	Verb	Adj
zanneden	zannet	Verb	Adj
sağlanamadığı	sağla	Verb	Adj
övmenize	öv	Verb	Noun
buluyor	bula	Verb	Verb
çürümeye	çürü	Verb	Noun
taşıdığı	taşı	Verb	Adj
kutluyordu	kutla	Verb	Verb
görünüşlü	görün	Verb	Adj
affettireceğini	affet	Verb	Noun
anlamayan	anla	Verb	Adj
giyindiğim	giy	Verb	Adj
yemekli	ye	Verb	Adj
oynamayan	oyna	Verb	Adj
süslemek	süsle	Verb	Noun
taşan	taş	Verb	Adj
topladığı	topla	Verb	Adj
doğuran	doğ	Verb	Adj
ilerleyen	ilerle	Verb	Adj
konuşabilen	konuş	Verb	Adj
peydahlandı	peydahla	Verb	Verb
yaklaştığı	yaklaş	Verb	Adj
titreyen	titre	Verb	Adj
ürperten	ürper	Verb	Adj
kurtaran	kurtar	Verb	Adj
sarılan	sar	Verb	Adj
bıraktığınız	bırak	Verb	Adj
yudumladığını	yudumla	Verb	Noun
mırıldanıyordum	mırıldan	Verb	Verb
feshedilemez	feshet	Verb	Verb
değiştikleri	değiş	Verb	Adj
zorlanan	zorla	Verb	Adj
yükledikleri	yükle	Verb	Adj
yetmeyen	yet	Verb	Adj
silkti	silk	Verb	Verb
kullanmadığımız	kullan	Verb	Adj
davrandığı	davran	Verb	Adj
ederler	ederle	Verb	Verb
hoşlanacağım	hoşlan	Verb	Adj
boşver	boşver	Verb	Verb
bayılan	bayıl	Verb	Adj
dayanmak	daya	Verb	Noun
kapladığı	kapla	Verb	Adj
giremediği	gir	Verb	Adj
götürüldüğü	götür	Verb	Adj
karşılaştıkları	karşılaş	Verb	Adj
oyalayan	oyala	Verb	Adj
asmalı	as	Verb	Adj
paylaştırıldığı	paylaş	Verb	Adj
dilediği	dile	Verb	Adj
öğretmeyen	öğret	Verb	Adj
yaratabilmiş	yarat	Verb	Adj
mahvediyordu	mahvet	Verb	Verb
sürdürülen	sür	Verb	Adj
kalktığı	kalk	Verb	Adj
başlanan	başla	Verb	Adj
saldıran	sal	Verb	Adj
uğradığım	uğra	Verb	Adj
vurgulayan	vurgula	Verb	Adj
yaraşır	yaraş	Verb	Verb
okutamayan	oku	Verb	Adj
saçtığı	saç	Verb	Adj
yazdıkları	yaz	Verb	Adj
dağılacağıydı	dağıl	Verb	Verb
kapılan	kap	Verb	Adj
saydığımız	say	Verb	Adj
çizen	çiz	Verb	Adj
kemiriyordu	kemir	Verb	Verb
denediğim	dene	Verb	Adj
yanıltıcı	yanıl	Verb	Adj
karardığı	karar	Verb	Adj
tanıdığımız	tanı	Verb	Adj
öğrenen	öğren	Verb	Adj
yaydığı	yay	Verb	Adj
çakışmasıydı	çakış	Verb	Verb
dayanan	dayan	Verb	Adj
içtiğim	iç	Verb	Adj
bastığı	bas	Verb	Adj
beğendikleri	beğen	Verb	Adj
biçici	biç	Verb	Noun
uyanan	uyan	Verb	Adj
tuttukları	tut	Verb	Adj
güvenen	güven	Verb	Adj
dalan	dal	Verb	Adj
batıran	bat	Verb	Adj
uyaran	uyar	Verb	Adj
yuvarlanan	yuvarla	Verb	Adj
cıvıttı	cıvı	Verb	Verb
çalışmayan	çalış	Verb	Adj
somurtuyorlardı	somur	Verb	Verb
bürünen	bürü	Verb	Adj
umursanmayan	umursa	Verb	Adj
bitirdiğim	bit	Verb	Adj
anlattığın	anlat	Verb	Adj
içerecek	içer	Verb	Adj
gizleyeceği	gizle	Verb	Adj
bakındım	bakın	Verb	Verb
bahsettiğimiz	bahset	Verb	Adj
giderdiği	gider	Verb	Adj
tıkandığı	tıka	Verb	Adj
dikişsiz	dik	Verb	Adj
dinlediğimiz	dinle	Verb	Adj
yürüten	yürü	Verb	Adj
uğraştığım	uğraş	Verb	Adj
püslenecektim	püsle	Verb	Verb
yapıştıkları	yapış	Verb	Adj
çarptırılan	çarp	Verb	Adj
atadığı	ata	Verb	Adj
eğlenen	eğlen	Verb	Adj
kopan	kop	Verb	Adj
gevşemiş	gevşe	Verb	Verb
sustu	sus	Verb	Verb
seziş	sez	Verb	Noun
kaldıracak	kaldır	Verb	Adj
yormaya	yor	Verb	Noun
süzülen	süz	Verb	Adj
yıkanabilen	yıka	Verb	Adj
eriyen	eri	Verb	Adj
çaldığın	çal	Verb	Adj
geçinen	geçin	Verb	Adj
tanıştığı	tanış	Verb	Adj
işlenen	işle	Verb	Adj
coşmuştu	coş	Verb	Verb
diriltin	diril	Verb	Verb
seslenen	seslen	Verb	Adj
geveliyordu	gevele	Verb	Verb
reddeden	reddet	Verb	Adj
kazanmadığı	kazan	Verb	Adj
ihtiyarlar	ihtiyarla	Verb	Verb
gezdikleri	gez	Verb	Adj
tekrarladığı	tekrarla	Verb	Adj
yalvaran	yalvar	Verb	Adj
çöktüğü	çök	Verb	Adj
anlaşılmayan	anlaş	Verb	Adj
körükleyin	körükle	Verb	Verb
kucaklamasından	kucakla	Verb	Noun
seyreden	seyret	Verb	Adj
çevirdiği	çevir	Verb	Adj
uzayan	uza	Verb	Adj
kekeledi	kekele	Verb	Verb
korumayan	koru	Verb	Adj
parlayan	parla	Verb	Adj
serdiğim	ser	Verb	Adj
kalkışan	kalkış	Verb	Adj
sokamadıkları	sok	Verb	Adj
kapanan	kapa	Verb	Adj
tüketecek	tüket	Verb	Verb
yatırırlar	yatır	Verb	Verb
kapaklanıyordu	kapaklan	Verb	Verb
sıkan	sık	Verb	Adj
kenetlenmiş	kenetle	Verb	Verb
yaşarmıştı	yaşar	Verb	Verb
açıldığı	aç	Verb	Adj
ezilen	ez	Verb	Adj
suçladığı	suçla	Verb	Adj
buruşturmuştu	buruş	Verb	Verb
köpürdü	köpür	Verb	Verb
sarsılan	sars	Verb	Adj
kavrar	kavra	Verb	Adj
vuruldunuz	vurul	Verb	Verb
şaşılacak	şaş	Verb	Adj
iliştirilen	iliş	Verb	Adj
fırlatan	fırla	Verb	Adj
kınayın	kına	Verb	Verb
inceleyen	incele	Verb	Adj
çatırdatacak	çatırda	Verb	Verb
küçümseyen	küçümse	Verb	Adj
büksün	bük	Verb	Verb
kötülemek	kötüle	Verb	Noun
başvurduğu	başvur	Verb	Adj
ağladığı	ağla	Verb	Adj
kazıyorsunuz	kaz	Verb	Verb
konduğu	kon	Verb	Adj
homurdanır	homurda	Verb	Verb
hesaplayan	hesapla	Verb	Adj
girişilen	giriş	Verb	Adj
şakıyorsunuz	şakı	Verb	Verb
şaşırtır	şaşır	Verb	Adj
gücenebileceğim	gücen	Verb	Verb
karşılayamadığınız	karşıla	Verb	Adj
bağışlandığı	bağışla	Verb	Adj
yaslayan	yasla	Verb	Adj
kıpırdamadan	kıpırda	Verb	Noun
kollayan	kolla	Verb	Adj
ulaşabildiğim	ulaş	Verb	Adj
inleten	inle	Verb	Adj
kavuşan	kavuş	Verb	Adj
savmıştı	sav	Verb	Verb
kaçtığım	kaç	Verb	Adj
bulandıran	bulan	Verb	Adj
tartmaya	tart	Verb	Noun
mahvolan	mahvol	Verb	Adj
vazgeçemeyen	vazgeç	Verb	Adj
ısmarlamıştı	ısmarla	Verb	Verb
yığılıverdi	yığ	Verb	Verb
hıçkıra	hıçkır	Verb	Verb
bozulan	boz	Verb	Adj
kıyılan	kıy	Verb	Adj
sıkıştırılmamış	sıkış	Verb	Adj
kurulandı	kurula	Verb	Verb
emredersiniz	emret	Verb	Verb
kıvırtması	kıvır	Verb	Noun
yakışan	yakış	Verb	Adj
kokan	kok	Verb	Adj
estiği	es	Verb	Adj
yükselten	yüksel	Verb	Adj
sersemlemiş	sersemle	Verb	Verb
bağlayan	bağla	Verb	Adj
dokunmadığı	dokun	Verb	Adj
yakalayan	yakala	Verb	Adj
alıştığımız	alış	Verb	Adj
yatan	yat	Verb	Adj
takmalı	tak	Verb	Adj
oluştukları	oluş	Verb	Adj
doyurucu	doy	Verb	Adj
harcattığı	harca	Verb	Adj
abandığı	aban	Verb	Adj
kudurmuş	kudur	Verb	Adj
kovalayan	kovala	Verb	Adj
gerdiği	ger	Verb	Adj
takırdadı	takırda	Verb	Verb
yetişen	yetiş	Verb	Adj
dürülmüş	dür	Verb	Verb
incinen	incin	Verb	Adj
dokumalı	doku	Verb	Adj
yatıştırana	yatış	Verb	Noun
yöneltilen	yönel	Verb	Adj
kabartıyordu	kabar	Verb	Verb
parçaladığı	parçala	Verb	Adj
kaynaklanacak	kaynakla	Verb	Adj
yetinen	yetin	Verb	Adj
yumacak	yum	Verb	Adj
yerleştikleri	yerleş	Verb	Adj
dürttü	dürt	Verb	Verb
kışkırtıyordu	kışkırt	Verb	Verb
savuşuyordu	savuş	Verb	Verb
edinmeyen	edin	Verb	Adj
engellendiği	engelle	Verb	Adj
beslenen	besle	Verb	Adj
sırnaşmıyordu	sırnaş	Verb	Verb
katlandığınız	katla	Verb	Adj
esirgeyen	esirge	Verb	Adj
sataşmamayı	sataş	Verb	Noun
ören	ör	Verb	Adj
çiğnenen	çiğne	Verb	Adj
perçinleniyordu	perçinle	Verb	Verb
yaralandığı	yarala	Verb	Adj
düzenleyen	düzenle	Verb	Adj
gezinen	gezin	Verb	Adj
atlayan	atla	Verb	Adj
tamamlayan	tamamla	Verb	Adj
yağladım	yağla	Verb	Verb
gözetlemiş	gözetle	Verb	Verb
tırmandığı	tırman	Verb	Adj
beceremiyordu	becer	Verb	Verb
ısırmaktaydı	ısır	Verb	Verb
azarlayan	azarla	Verb	Adj
pataklıyordu	patakla	Verb	Verb
dilenciler	dil	Verb	Noun
ürktüğünüz	ürk	Verb	Adj
rastladığınız	rastla	Verb	Adj
kazımışımdır	kazı	Verb	Verb
onaracağım	onar	Verb	Verb
böbürlenir	böbürlen	Verb	Verb
boyamalı	boya	Verb	Adj
oynatan	oynat	Verb	Adj
taşınan	taşın	Verb	Adj
bur	bur	Verb	Verb
kahroluyorum	kahrol	Verb	Verb
hafiflemiştim	hafifle	Verb	Verb
selamlayacaklarmış	selamla	Verb	Verb
tütmekte	tüt	Verb	Noun
boğucu	boğ	Verb	Noun
alçaltmıştı	alçal	Verb	Verb
dönüştüğü	dönüş	Verb	Adj
burkuldu	burk	Verb	Verb
gömüldükleri	göm	Verb	Adj
çekiştirilirdi	çekiş	Verb	Verb
doğrulmak	doğrul	Verb	Noun
sürünen	sürü	Verb	Adj
gözüken	gözük	Verb	Adj
şükretsin	şükret	Verb	Verb
yeltenmemesi	yelten	Verb	Noun
yeğledi	yeğle	Verb	Verb
boşanan	boşa	Verb	Adj
artıracak	art	Verb	Adj
kovulmuş	kov	Verb	Adj
darılmadığımı	darıl	Verb	Noun
başaran	başar	Verb	Adj
yakan	yak	Verb	Adj
sağol	sağol	Verb	Verb
kırdığı	kır	Verb	Adj
sevinen	sevin	Verb	Adj
görüşen	görüş	Verb	Adj
yüzdüğü	yüz	Verb	Adj
düşlemekle	düşle	Verb	Noun
paralıyordu	parala	Verb	Verb
çağıran	çağır	Verb	Adj
uydukları	uy	Verb	Adj
benimsediğiniz	benimse	Verb	Adj
yadırganıyordu	yadırga	Verb	Verb
gülümseyen	gülümse	Verb	Adj
yıktığı	yık	Verb	Adj
satabileceği	sat	Verb	Adj
boşalan	boşal	Verb	Adj
serperdi	serp	Verb	Verb
iliklemeyen	ilikle	Verb	Adj
yırtan	yırt	Verb	Adj
sendeleye	sendele	Verb	Verb
uyutan	uyu	Verb	Adj
utandığı	utan	Verb	Noun
büzülmüştü	büz	Verb	Verb
boylayan	boyla	Verb	Adj
tıka	tık	Verb	Verb
kaydıkları	kay	Verb	Adj
kırpıştırıyordu	kırpış	Verb	Verb
bunaltacak	bunal	Verb	Adj
bıkmış	bık	Verb	Verb
usanmış	usan	Verb	Verb
soğutulan	soğu	Verb	Adj
yutuyordum	yut	Verb	Verb
yarılan	yar	Verb	Adj
akıtılan	ak	Verb	Adj
şişirilen	şiş	Verb	Adj
çapalamaya	çapala	Verb	Noun
bölmedeki	böl	Verb	Adj
zımparalayacaktı	zımparala	Verb	Verb
terkedilmiş	terket	Verb	Verb
çömeldi	çömel	Verb	Verb
kısmış	kıs	Verb	Verb
değdiğinden	değ	Verb	Noun
farketmişti	farket	Verb	Verb
sarkıtılan	sarkıt	Verb	Adj
sırıttı	sırıt	Verb	Verb
toparlandığı	toparla	Verb	Adj
saçmalıyorsun	saçmala	Verb	Verb
büyüdüğüm	büyü	Verb	Adj
baltalanacaksın	baltala	Verb	Verb
pişen	piş	Verb	Adj
tekmeledi	tekmele	Verb	Verb
böğürdü	böğür	Verb	Verb
damlayan	damla	Verb	Adj
azdığı	az	Verb	Adj
kötümsersin	kötümse	Verb	Verb
katlanılabilir	katlan	Verb	Adj
sarfedilir	sarfet	Verb	Verb
donatıyormuş	dona	Verb	Verb
kaşıdı	kaşı	Verb	Verb
huylanıyor	huylan	Verb	Verb
sarkan	sark	Verb	Adj
yumurtlayan	yumurtla	Verb	Adj
cevapladım	cevapla	Verb	Verb
sabitlediğinde	sabitle	Verb	Noun
takınırlardı	takın	Verb	Verb
kilitlediğinden	kilitle	Verb	Noun
çevreleyen	çevrele	Verb	Adj
yağışlı	yağ	Verb	Adj
çakan	çak	Verb	Adj
aydınlatır	aydınlat	Verb	Adj
anımsatan	anımsa	Verb	Adj
daraltır	daral	Verb	Adj
desteklemeyen	destekle	Verb	Adj
sürünüyorduk	sürün	Verb	Verb
süpürüyor	süpür	Verb	Verb
kaynaşma	kaynaş	Verb	Noun
yavaşlatabilecek	yavaşla	Verb	Adj
sararmıştı	sarar	Verb	Verb
bulaştırıyordu	bulaş	Verb	Verb
çırptı	çırp	Verb	Verb
sıçrayan	sıçra	Verb	Adj
döven	döv	Verb	Adj
susuyor	susa	Verb	Verb
küçültmeden	küçül	Verb	Noun
morarmış	morar	Verb	Verb
lekelemişti	lekele	Verb	Verb
kanayan	kana	Verb	Adj
örtecek	ört	Verb	Adj
özetleyen	özetle	Verb	Adj
aşağılayan	aşağıla	Verb	Adj
elleyen	elle	Verb	Adj
dağıttığı	dağıt	Verb	Adj
yolladığı	yolla	Verb	Adj
sığmayan	sığ	Verb	Adj
tasarlanan	tasarla	Verb	Adj
sökerim	sök	Verb	Verb
şapırdattı	şapırda	Verb	Verb
direniyordu	dire	Verb	Verb
gönderdikleri	gönder	Verb	Adj
aşamadığınız	aş	Verb	Adj
aydınlanmıştı	aydınlan	Verb	Verb
bezenmişti	beze	Verb	Verb
saptıkları	sap	Verb	Adj
etkilemeyen	etkile	Verb	Adj
tutuklandı	tutukla	Verb	Verb
birleştiği	birleş	Verb	Adj
yayımlanan	yayımla	Verb	Adj
müjdeliyordu	müjdele	Verb	Verb
aktarmalı	aktar	Verb	Adj
karşılaştırılacak	karşılaştır	Verb	Adj
sergilendiği	sergile	Verb	Adj
tanımlayacağı	tanımla	Verb	Adj
yaladı	yala	Verb	Verb
biriktirivereyim	birik	Verb	Verb
sızmış	sız	Verb	Adj
sürüklediğiniz	sürükle	Verb	Adj
berelenmiş	berele	Verb	Verb
övünülecek	övün	Verb	Adj
döğüşmüşlerdi	döğ	Verb	Verb
savurduğu	savur	Verb	Adj
çırpınan	çırpın	Verb	Adj
defol	defol	Verb	Verb
çatladı	çatla	Verb	Verb
kokladı	kokla	Verb	Verb
süzülüyordu	süzül	Verb	Verb
tıngırdıyordu	tıngırda	Verb	Verb
azaldığı	azal	Verb	Adj
seslendiğinde	sesle	Verb	Noun
sevişiyor	seviş	Verb	Verb
yasaklanan	yasakla	Verb	Adj
hapsediyorsunuz	hapset	Verb	Verb
kabullenmişlerdi	kabullen	Verb	Verb
yinelenen	yinele	Verb	Adj
küllenmiş	külle	Verb	Verb
sözediyordu	sözet	Verb	Verb
zayıflamıştı	zayıfla	Verb	Verb
alıkoyacak	alıkoy	Verb	Adj
sahnelenen	sahnele	Verb	Adj
tutunmuş	tutun	Verb	Verb
belirledikleri	belirle	Verb	Adj
sarmalayabilir	sarmala	Verb	Verb
uyuşturmak	uyuş	Verb	Noun
algılayan	algıla	Verb	Adj
büyütmedim	büyüt	Verb	Verb
derdim	der	Verb	Verb
keşfetmediği	keşfet	Verb	Adj
temizler	temizle	Verb	Verb
kurtulan	kurtul	Verb	Adj
çıldırtan	çıldır	Verb	Adj
öksürtmeye	öksür	Verb	Noun
çınlatan	çınla	Verb	Adj
sürttü	sürt	Verb	Verb
ısıtamıyordum	ısıt	Verb	Verb
kaykılmış	kaykıl	Verb	Verb
üşüme	üşü	Verb	Noun
oyulan	oy	Verb	Adj
küfretmeye	küfret	Verb	Noun
ıskalayan	ıskala	Verb	Adj
tökezledi	tökezle	Verb	Verb
tembihledim	tembihle	Verb	Verb
erdiği	er	Verb	Adj
değiller	değille	Verb	Verb
danışır	danış	Verb	Verb
tutuşturulan	tutuş	Verb	Adj
avutacak	avut	Verb	Adj
ezberledim	ezberle	Verb	Verb
afallamıştım	afalla	Verb	Verb
sunuculu	sun	Verb	Adj
eleştiren	eleştir	Verb	Adj
kirletmeyecek	kirlet	Verb	Verb
iletebilen	ilet	Verb	Adj
üşüşmüştü	üşüş	Verb	Verb
irkiliyor	irkil	Verb	Verb
sönen	sön	Verb	Adj
abartacaklardı	abart	Verb	Verb
önemsediğim	önemse	Verb	Adj
dalıyordum	dala	Verb	Verb
yargılayan	yargıla	Verb	Adj
bürüneceğini	bürün	Verb	Noun
kakacağım	kak	Verb	Verb
kiraladığım	kirala	Verb	Adj
kuruyan	kuru	Verb	Adj
savunan	savun	Verb	Adj
tarandıkları	tara	Verb	Adj
serpiştirilmiş	serpiş	Verb	Verb
uçuştuğu	uçuş	Verb	Adj
arzuladığı	arzula	Verb	Adj
kırışmış	kırış	Verb	Verb
önerdiğim	öner	Verb	Adj
aldatıcı	aldat	Verb	Noun
ovuşturmaya	ovuştur	Verb	Noun
direnen	diren	Verb	Adj
buyurur	buyur	Verb	Verb
sayıklıyordu	sayıkla	Verb	Verb
sızlayan	sızla	Verb	Adj
hastalanmamıştı	hastalan	Verb	Verb
ummadıkları	um	Verb	Adj
kaçınmayan	kaçın	Verb	Adj
kızardığını	kızar	Verb	Noun
şakalaşıyor	şakalaş	Verb	Verb
zamanlandığı	zamanla	Verb	Adj
dışlandı	dışla	Verb	Verb
yayınladığı	yayınla	Verb	Adj
pazarlamacıydı	pazarla	Verb	Verb
çözümlenemeyen	çözümle	Verb	Adj
paketlememişti	paketle	Verb	Verb
önlediği	önle	Verb	Adj
acıkmıştı	acık	Verb	Verb
varsayılan	varsay	Verb	Adj
gıcırdayan	gıcırda	Verb	Adj
kımıldamadı	kımılda	Verb	Verb
savsaklıyorsunuz	savsakla	Verb	Verb
aralandı	arala	Verb	Verb
yankılanıyordu	yankıla	Verb	Verb
havalandığı	havalan	Verb	Adj
hışırdayan	hışırda	Verb	Adj
sıyrılmıştı	sıyrıl	Verb	Verb
topallayan	topalla	Verb	Adj
uygulanabilen	uygula	Verb	Adj
noktalanırsa	noktala	Verb	Verb
donan	don	Verb	Adj
yendiği	yen	Verb	Adj
geğirdi	geğir	Verb	Verb
nitelendirilebilecek	nitelen	Verb	Verb
üstlenen	üstlen	Verb	Adj
incelir	incel	Verb	Verb
oflar	ofla	Verb	Verb
çabalasa	çabala	Verb	Verb
çözebilen	çöz	Verb	Adj
ışıldayan	ışılda	Verb	Adj
zaptedemiyordum	zaptet	Verb	Verb
kahrediyorsunuz	kahret	Verb	Verb
araştırdığınız	araştır	Verb	Adj
ferahlaması	ferahla	Verb	Noun
uğurlama	uğurla	Verb	Noun
dizdiği	diz	Verb	Adj
kıyaslanabilecek	kıyasla	Verb	Adj
zehirleyen	zehirle	Verb	Adj
taparlar	tap	Verb	Noun
alkışlamaya	alkışla	Verb	Noun
ayarlayacak	ayarla	Verb	Adj
savaşan	savaş	Verb	Adj
geciken	gecik	Verb	Adj
çalkalandığını	çalkala	Verb	Noun
ayıplamaya	ayıpla	Verb	Noun
gözettiğimi	göze	Verb	Noun
öğütlememe	öğütle	Verb	Noun
halletmek	hallet	Verb	Noun
toslamamak	tosla	Verb	Noun
dizginlemeye	dizginle	Verb	Noun
hırlayan	hırla	Verb	Adj
hırpalanmış	hırpala	Verb	Adj
dalaşmadan	dalaş	Verb	Noun
kanıtlayabilmeli	kanıtla	Verb	Adj
saplanan	sapla	Verb	Adj
paylamadan	payla	Verb	Noun
ısınan	ısın	Verb	Adj
eğitmek	eğit	Verb	Noun
tünemeye	tüne	Verb	Noun
tıklattığınız	tıkla	Verb	Adj
tükenmek	tüken	Verb	Noun
şaklamasıyla	şakla	Verb	Noun
ötesinden	öt	Verb	Noun
mırıldanmak	mırılda	Verb	Noun
buluşan	buluş	Verb	Adj
genişletilen	genişle	Verb	Adj
yakarış	yakar	Verb	Noun
tepesinden	tep	Verb	Noun
alınan	alın	Verb	Adj
yumruklamaya	yumrukla	Verb	Noun
üfledikten	üfle	Verb	Noun
yansıyacak	yansı	Verb	Adj
eklemlerimi	eklemle	Verb	Noun
esnemesini	esne	Verb	Noun
seğirmeler	seğir	Verb	Noun
patlamak	patla	Verb	Noun
kağıtlarımı	kağıtla	Verb	Noun
filizlenmeye	filizle	Verb	Noun
soyunmuş	soyun	Verb	Adj
diklendiği	dikle	Verb	Adj
kısıtlanmış	kısıtla	Verb	Adj
yonttuğu	yont	Verb	Adj
sümküren	sümkür	Verb	Adj
kamaştıran	kamaş	Verb	Adj
kaynayan	kayna	Verb	Adj
tırmalayan	tırmala	Verb	Adj
koşuşturan	koşuş	Verb	Adj
yönetir	yönet	Verb	Adj
denetleyicisindeki	denetle	Verb	Adj
avlanan	avla	Verb	Adj
hortladığı	hortla	Verb	Adj
yağmaladığı	yağmala	Verb	Adj
kanlar	kanla	Verb	Adj
azıttığı	azıt	Verb	Adj
incitici	incit	Verb	Adj
varolan	varol	Verb	Adj
üretmeyen	üre	Verb	Adj
uluyan	ulu	Verb	Adj
bahşettiği	bahşet	Verb	Adj
ağrıyan	ağrı	Verb	Adj
döşenmiş	döşe	Verb	Adj
budanmış	buda	Verb	Adj
kesişen	kesiş	Verb	Adj
ayaklanan	ayaklan	Verb	Adj
fışkıran	fışkır	Verb	Adj
şenlendirdiği	şenlen	Verb	Adj
uğuldayan	uğulda	Verb	Adj
pekiştiren	pekiş	Verb	Adj
iğrenilecek	iğren	Verb	Adj
sorgulayan	sorgula	Verb	Adj
delen	del	Verb	Adj
dikilen	dikil	Verb	Adj
rastgeldiği	rastgel	Verb	Adj
ağarmış	ağar	Verb	Adj
hedeflendiği	hedefle	Verb	Adj
defnedildiği	defnet	Verb	Adj
otladığı	otla	Verb	Adj
değinen	değin	Verb	Adj
püskürten	püskür	Verb	Adj
doğrulayan	doğrula	Verb	Adj
yanaşamadığı	yanaş	Verb	Adj
güttüğüm	güt	Verb	Adj
uyuklayan	uyukla	Verb	Adj
dinlenen	dinlen	Verb	Adj
kuşanan	kuşan	Verb	Adj
şıngırdayacak	şıngırda	Verb	Adj
kurcalayan	kurcala	Verb	Adj
devrilen	devir	Verb	Adj
takılan	takıl	Verb	Adj
özlediği	özle	Verb	Adj
yadsıyan	yadsı	Verb	Adj
bütünleyen	bütünle	Verb	Adj
aşılayan	aşıla	Verb	Adj
kıvranan	kıvran	Verb	Adj
aldırdığı	aldır	Verb	Adj
görüntülendiği	görüntüle	Verb	Adj
işaretlenen	işaretle	Verb	Adj
devraldığı	devral	Verb	Adj
kısalan	kısal	Verb	Adj
planladığınız	planla	Verb	Adj
kaydettiği	kaydet	Verb	Adj
ölçüldüğü	ölç	Verb	Adj
tetikleyen	tetikle	Verb	Adj
şifreleyen	şifrele	Verb	Adj
odaklanılan	odakla	Verb	Adj
önyüklemesiz	önyükle	Verb	Adj
depolayan	depola	Verb	Adj
eriştiği	eriş	Verb	Adj
listelenecek	listele	Verb	Adj
yorumlayan	yorumla	Verb	Adj
kopyalanan	kopyala	Verb	Adj
barındırdığı	barın	Verb	Adj
önizlediğim	önizle	Verb	Adj
yedeklediğiniz	yedekle	Verb	Adj
sekmeli	sek	Verb	Adj
sınamadığınız	sın	Verb	Adj
kapsayacak	kapsa	Verb	Adj
bileşenlerindeki	bileş	Verb	Adj
sınırlayan	sınırla	Verb	Adj
eşitlendiği	eşitle	Verb	Adj
yönlendirildiği	yönlen	Verb	Adj
simgeleyecek	simgele	Verb	Adj
sıralandığı	sırala	Verb	Adj
dengeleyen	dengele	Verb	Adj
grupladığınız	grupla	Verb	Adj
rendelenmiş	rendele	Verb	Adj
başgösteren	başgöster	Verb	Adj
yeralan	yeral	Verb	Adj
devredilen	devret	Verb	Adj
fakslanan	faksla	Verb	Adj
addetmeyen	addet	Verb	Adj
göğüsleyen	göğüsle	Verb	Adj
sollayan	solla	Verb	Adj
konakladığınız	konakla	Verb	Adj
sahiplenen	sahiplen	Verb	Adj
amaçlayan	amaçla	Verb	Adj
yenilediği	yenile	Verb	Adj
nitelediği	nitele	Verb	Adj
öngördüğü	öngör	Verb	Adj
duyuran	duyur	Verb	Adj
çimdikleyen	çimdikle	Verb	Adj
eğiren	eğir	Verb	Adj
yazıştığım	yazış	Verb	Adj
tokatlayan	tokatla	Verb	Adj
çağrıştırdığı	çağrış	Verb	Adj
güreşen	güreş	Verb	Adj
gözlemleyen	gözlemle	Verb	Adj
yanıtlayan	yanıtla	Verb	Adj
sevkettiği	sevket	Verb	Adj
haczedilen	haczet	Verb	Adj
kıskandıracak	kıskan	Verb	Adj
harmanladığımız	harmanla	Verb	Adj
sıkılan	sıkıl	Verb	Adj
yıprattıkları	yıprat	Verb	Adj
yeşerdiği	yeşer	Verb	Adj
çoğalan	çoğal	Verb	Adj
cezbeden	cezbet	Verb	Adj
ertelenen	ertele	Verb	Adj
sığınmayan	sığın	Verb	Adj
frenler	frenle	Verb	Adj
