almayacaklarını	al+Verb+Neg^DB+Noun+FutPart+A3pl+P3pl+Acc
aşmamak	aş+Verb+Neg^DB+Noun+Inf1+A3sg+Pnon+Nom
bulunmadığını	bulun+Verb+Neg^DB+Noun+PastPart+A3sg+P3sg+Acc
verilmediğini	ver+Verb^DB+Verb+Pass+Neg^DB+Noun+PastPart+A3sg+P3sg+Acc
olmadığını	ol+Verb+Neg^DB+Noun+PastPart+A3sg+P3sg+Acc
edemez	et+Verb^DB+Verb+Able+Neg+Aor+A3sg
bilmiyor	bil+Verb+Neg+Prog1+A3sg
gitmeyecek	git+Verb+Neg+Fut+A3sg
imzalanmamış	imzala+Verb^DB+Verb+Pass+Neg+Narr+A3sg
tartışmayacağım	tartış+Verb+Neg+Fut+A1sg
vermeyeceğini	ver+Verb+Neg^DB+Noun+FutPart+A3sg+P3sg+Acc
vermezsin	ver+Verb+Neg+Aor+A2sg
olmadığından	ol+Verb+Neg^DB+Noun+PastPart+A3sg+P3sg+Abl
olmayan	ol+Verb+Neg^DB+Adj+PresPart
vermedi	ver+Verb+Neg+Past+A3sg
duymuyordu	duy+Verb+Neg+Prog1+Past+A3sg
çıkmamıştı	çık+Verb+Neg+Narr+Past+A3sg
düşünmüyorum	düşün+Verb+Neg+Prog1+A1sg
etmedi	et+Verb+Neg+Past+A3sg
değildir	değil+Verb+Neg+Pres+A3sg+Cop
ilgilendirmiyor	ilgilen+Verb^DB+Verb+Caus+Neg+Prog1+A3sg
inanamıyorum	inan+Verb^DB+Verb+Able+Neg+Prog1+A1sg
söylemedim	söyle+Verb+Neg+Past+A1sg
nişanlanmadığımı	nişanla+Verb^DB+Verb+Pass+Neg^DB+Noun+PastPart+A3sg+P1sg+Acc
istemem	iste+Verb+Neg+Aor+A1sg
yanılmaz	yan+Verb^DB+Verb+Pass+Neg+Aor+A3sg
unutmazsa	unut+Verb+Neg+Aor+Cond+A3sg
onaylamam	onayla+Verb+Neg+Aor+A1sg
onaylamamam	onayla+Verb+Neg^DB+Noun+Inf2+A3sg+P1sg+Nom
gelmedik	gel+Verb+Neg+Past+A1pl
etmiyorum	et+Verb+Neg+Prog1+A1sg
karışmıyorum	karış+Verb+Neg+Prog1+A1sg
olmasın	ol+Verb+Neg+Imp+A3sg
olmazdı	ol+Verb+Neg+Aor+Past+A3sg
olmadığımı	ol+Verb+Neg^DB+Noun+PastPart+A3sg+P1sg+Acc
değiştirmedikleri	değiş+Verb^DB+Verb+Caus+Neg^DB+Noun+PastPart+A3pl+P3pl+Nom
kastetmiyorsun	kastet+Verb+Neg+Prog1+A2sg
olmaz	ol+Verb+Neg^DB+Adj+AorPart
dokunmayacakları	doku+Verb^DB+Verb+Pass+Neg^DB+Noun+FutPart+A3sg+P3pl+Nom
olmamıştım	ol+Verb+Neg+Narr+Past+A1sg
etmemeni	et+Verb+Neg^DB+Noun+Inf2+A3sg+P2sg+Acc
affetmeyeceğim	affet+Verb+Neg+Fut+A1sg
görünmemişti	görün+Verb+Neg+Narr+Past+A3sg
görmediği	gör+Verb+Neg^DB+Noun+PastPart+A3sg+P3sg+Nom
rastlamadığım	rastla+Verb+Neg^DB+Adj+PastPart+P1sg
edemem	et+Verb^DB+Verb+Able+Neg+Aor+A1sg
anlatmamam	anla+Verb^DB+Verb+Caus+Neg^DB+Noun+Inf2+A3sg+P1sg+Nom
söylemedi	söyle+Verb+Neg+Past+A3sg
bilmiyorum	bil+Verb+Neg+Prog1+A1sg
konuşmadım	konuş+Verb+Neg+Past+A1sg
olmamak	ol+Verb+Neg^DB+Noun+Inf1+A3sg+Pnon+Nom
benzemez	benze+Verb+Neg+Aor+A3sg
etmez	et+Verb+Neg+Aor+A3sg
sinirlenmez	sinir+Noun+A3sg+Pnon+Nom^DB+Verb+Acquire+Neg+Aor+A3sg
anlamıyorum	anla+Verb+Neg+Prog1+A1sg
dönülmez	dön+Verb^DB+Verb+Pass+Neg+Aor+A3sg
etme	et+Verb+Neg+Imp+A2sg
feshedilemez	feshet+Verb^DB+Verb+Pass^DB+Verb+Able+Neg+Aor+A3sg
edemeyeceğim	et+Verb^DB+Verb+Able+Neg+Fut+A1sg
ödemez	öde+Verb+Neg+Aor+A3sg
yetmemesidir	yet+Verb+Neg^DB+Noun+Inf2+A3sg+P3sg+Nom^DB+Verb+Zero+Pres+A3sg+Cop
olmasa	ol+Verb+Neg+Desr+A3sg
kullanmadıklarıdır	kullan+Verb+Neg^DB+Noun+PastPart+A3pl+P3pl+Nom^DB+Verb+Zero+Pres+A3sg+Cop
duymaz	duy+Verb+Neg+Aor+A3sg
bilmez	bil+Verb+Neg+Aor+A3sg
olamaz	ol+Verb^DB+Verb+Able+Neg+Aor+A3sg
bilmem	bil+Verb+Neg+Aor+A1sg
edemeyeceğin	et+Verb^DB+Verb+Able+Neg^DB+Noun+FutPart+A3sg+P2sg+Nom
bilmediğiniz	bil+Verb+Neg^DB+Noun+PastPart+A3sg+P2pl+Nom
olmayacak	ol+Verb+Neg+Fut+A3sg
dayanamazdı	daya+Verb^DB+Verb+Pass^DB+Verb+Able+Neg+Aor+Past+A3sg
olmayacağını	ol+Verb+Neg^DB+Noun+FutPart+A3sg+P3sg+Acc
dilemem	dile+Verb+Neg+Aor+A1sg
düşünmüyordum	düşün+Verb+Neg+Prog1+Past+A1sg
tamamlanmamış	tamamla+Verb^DB+Verb+Pass+Neg^DB+Adj+NarrPart
alamıyordu	al+Verb^DB+Verb+Able+Neg+Prog1+Past+A3sg
kullanamıyordu	kullan+Verb^DB+Verb+Able+Neg+Prog1+Past+A3sg
edemediler	et+Verb^DB+Verb+Able+Neg+Past+A3pl
edilemezdi	et+Verb^DB+Verb+Pass^DB+Verb+Able+Neg+Aor+Past+A3sg
değildi	değil+Verb+Neg+Past+A3sg
etmiyormuş	et+Verb+Neg+Prog1+Narr+A3sg
yapamıyor	yap+Verb^DB+Verb+Able+Neg+Prog1+A3sg
kalmamalısın	kal+Verb+Neg+Neces+A2sg
görülmemiş	gör+Verb^DB+Verb+Pass+Neg+Narr+A3sg
kaybetmiyordu	kaybet+Verb+Neg+Prog1+Past+A3sg
söylemiyordu	söyle+Verb+Neg+Prog1+Past+A3sg
kalmazdı	kal+Verb+Neg+Aor+Past+A3sg
durmuyordu	dur+Verb+Neg+Prog1+Past+A3sg
bahsetmediği	bahset+Verb+Neg^DB+Adj+PastPart+P3sg
yanıltmazdı	yanıl+Verb^DB+Verb+Caus+Neg+Aor+Past+A3sg
bilmediği	bil+Verb+Neg^DB+Noun+PastPart+A3sg+P3sg+Nom
bilinmemekle	bil+Verb^DB+Verb+Pass+Neg^DB+Noun+Inf1+A3sg+Pnon+Ins
yapılamaz	yap+Verb^DB+Verb+Pass^DB+Verb+Able+Neg+Aor+A3sg
öğrenilemedi	öğren+Verb^DB+Verb+Pass^DB+Verb+Able+Neg+Past+A3sg
dönmediler	dön+Verb+Neg+Past+A3pl
alamazdım	al+Verb^DB+Verb+Able+Neg+Aor+Past+A1sg
hoşlanmıyorlardı	hoşlan+Verb+Neg+Prog1+A3pl+Past
sayılmazdı	say+Verb^DB+Verb+Pass+Neg+Aor+Past+A3sg
görünmüyor	görün+Verb+Neg+Prog1+A3sg
evlenmeyeceğini	evlen+Verb+Neg^DB+Noun+FutPart+A3sg+P3sg+Acc
edemiyordu	et+Verb^DB+Verb+Able+Neg+Prog1+Past+A3sg
uyandıramazdı	uyan+Verb^DB+Verb+Caus^DB+Verb+Able+Neg+Aor+Past+A3sg
duymamış	duy+Verb+Neg+Narr+A3sg
gelmeyeni	gel+Verb+Neg^DB+Adj+PresPart^DB+Noun+Zero+A3sg+P3sg+Nom
koymayacaklarını	koy+Verb+Neg^DB+Noun+FutPart+A3pl+P3pl+Acc
tutamazdı	tut+Verb^DB+Verb+Able+Neg+Aor+Past+A3sg
damlamayacaklarına	damla+Verb+Neg^DB+Noun+FutPart+A3sg+P3pl+Dat
başlamamıştı	başla+Verb+Neg+Narr+Past+A3sg
etmeyeceğiz	et+Verb+Neg+Fut+A1pl
bilmiyordu	bil+Verb+Neg+Prog1+Past+A3sg
dönmeyeceğine	dön+Verb+Neg^DB+Noun+FutPart+A3sg+P3sg+Dat
koymadı	koy+Verb+Neg+Past+A3sg
alışmayan	alış+Verb+Neg^DB+Adj+PresPart
çekemiyordu	çek+Verb^DB+Verb+Able+Neg+Prog1+Past+A3sg
umursamaz	umursa+Verb+Neg+Aor+A3sg
başlayamazdı	başla+Verb^DB+Verb+Able+Neg+Aor+Past+A3sg
bitmez	bit+Verb+Neg+Aor+A3sg
beklenmedik	bekle+Verb^DB+Verb+Pass+Neg^DB+Adj+PastPart+Pnon
varılmıyormuş	var+Verb^DB+Verb+Pass+Neg+Prog1+Narr+A3sg
basmadım	bas+Verb+Neg+Past+A1sg
gelmez	gel+Verb+Neg+Aor+A3sg
çıkıvermez	çık+Verb+Pos^DB+Verb+Hastily+Neg+Aor+A3sg
hatırlamıyorum	hatırla+Verb+Neg+Prog1+A1sg
istememiştiniz	iste+Verb+Neg+Narr+Past+A2pl
düşünmem	düşün+Verb+Neg+Aor+A1sg
sanmam	san+Verb+Neg+Aor+A1sg
hatırlatmam	hatırla+Verb^DB+Verb+Caus+Neg+Aor+A1sg
çıkmayacağım	çık+Verb+Neg+Fut+A1sg
unutmayın	unut+Verb+Neg+Imp+A2pl
konuşmayın	konuş+Verb+Neg+Imp+A2pl
dinleyemem	dinle+Verb^DB+Verb+Able+Neg+Aor+A1sg
yapamazsanız	yap+Verb^DB+Verb+Able+Neg+Aor+Cond+A2pl
yapmıyorum	yap+Verb+Neg+Prog1+A1sg
değilmiş	değil+Verb+Neg+Narr+A3sg
duramıyordu	dur+Verb^DB+Verb+Able+Neg+Prog1+Past+A3sg
susmaz	sus+Verb+Neg+Aor+A3sg
kaçırmamak	kaç+Verb^DB+Verb+Caus+Neg^DB+Noun+Inf1+A3sg+Pnon+Nom
dayanamadı	dayan+Verb^DB+Verb+Able+Neg+Past+A3sg
tanımıyorsunuz	tanı+Verb+Neg+Prog1+A2pl
bırakmazlar	bırak+Verb+Neg+Aor+A3pl
bulunmaz	bulun+Verb+Neg+Aor+A3sg
değilim	değil+Verb+Neg+Pres+A1sg
çıkmazdı	çık+Verb+Neg+Aor+Past+A3sg
ayıramıyor	ayır+Verb^DB+Verb+Able+Neg+Prog1+A3sg
bitiremedi	bit+Verb^DB+Verb+Caus^DB+Verb+Able+Neg+Past+A3sg
unutmadım	unut+Verb+Neg+Past+A1sg
ayrılmamak	ayır+Verb^DB+Verb+Pass+Neg^DB+Noun+Inf1+A3sg+Pnon+Nom
görmüyor	gör+Verb+Neg+Prog1+A3sg
sevmemiş	sev+Verb+Neg+Narr+A3sg
kastetmiyorum	kastet+Verb+Neg+Prog1+A1sg
anlamıyor	anla+Verb+Neg+Prog1+A3sg
yorulmadınızsa	yor+Verb^DB+Verb+Pass+Neg+Past+A2pl+Cond
istemiyorum	iste+Verb+Neg+Prog1+A1sg
tutamadı	tut+Verb^DB+Verb+Able+Neg+Past+A3sg
anlaşılmıyordu	anlaş+Verb^DB+Verb+Pass+Neg+Prog1+Past+A3sg
bırakmam	bırak+Verb+Neg+Aor+A1sg
çıkarmıyordu	çık+Verb^DB+Verb+Caus+Neg+Prog1+Past+A3sg
bırakmayacağım	bırak+Verb+Neg+Fut+A1sg
bahsedemem	bahset+Verb^DB+Verb+Able+Neg+Aor+A1sg
edilmez	et+Verb^DB+Verb+Pass+Neg+Aor+A3sg
bulamıyorum	bul+Verb^DB+Verb+Able+Neg+Prog1+A1sg
söyleyemeyeceğimi	söyle+Verb^DB+Verb+Able+Neg^DB+Noun+FutPart+A3sg+P1sg+Acc
bildirmemiş	bil+Verb^DB+Verb+Caus+Neg+Narr+A3sg
çevirmediniz	çevir+Verb+Neg+Past+A2pl
reddetmediniz	reddet+Verb+Neg+Past+A2pl
çevirmedimse	çevir+Verb+Neg+Past+A1sg+Cond
dememem	de+Verb+Neg^DB+Noun+Inf2+A3sg+P1sg+Nom
reddetmezsiniz	reddet+Verb+Neg+Aor+A2pl
edemezsiniz	et+Verb^DB+Verb+Able+Neg+Aor+A2pl
görmedim	gör+Verb+Neg+Past+A1sg
darılmadığımı	darıl+Verb+Neg^DB+Noun+PastPart+A3sg+P1sg+Acc
saklayamadık	sakla+Verb^DB+Verb+Able+Neg+Past+A1pl
istemedik	iste+Verb+Neg+Past+A1pl
istemiyoruz	iste+Verb+Neg+Prog1+A1pl
değilse	değil+Verb+Neg+Cond+A3sg
gitmemişti	git+Verb+Neg+Narr+Past+A3sg
değilsiniz	değil+Verb+Neg+Pres+A2pl
olmadığı	ol+Verb+Neg^DB+Noun+PastPart+A3sg+P3sg+Nom
etmeme	et+Verb+Neg^DB+Noun+Inf2+A3sg+Pnon+Nom
şaşmamalıyım	şaş+Verb+Neg+Neces+A1sg
olmazsa	ol+Verb+Neg+Aor+Cond+A3sg
söyleyemem	söyle+Verb^DB+Verb+Able+Neg+Aor+A1sg
kandıramazsınız	kan+Verb^DB+Verb+Caus^DB+Verb+Able+Neg+Aor+A2pl
konuşmamam	konuş+Verb+Neg^DB+Noun+Inf2+A3sg+P1sg+Nom
olmayabilirdi	ol+Verb+Neg^DB+Verb+Able+Aor+Past+A3sg
bulmayın	bul+Verb+Neg+Imp+A2pl
söylemediğinizi	söyle+Verb+Neg^DB+Noun+PastPart+A3sg+P2pl+Acc
bırakmamışsınız	bırak+Verb+Neg+Narr+A2pl
sayılmaz	say+Verb^DB+Verb+Pass+Neg+Aor+A3sg
sevmese	sev+Verb+Neg+Desr+A3sg
bilmiyorsunuz	bil+Verb+Neg+Prog1+A2pl
çıkmadı	çık+Verb+Neg+Past+A3sg
karıştırmayın	karış+Verb^DB+Verb+Caus+Neg+Imp+A2pl
bilemeyecektir	bil+Verb^DB+Verb+Able+Neg+Fut+A3sg+Cop
durmuyorum	dur+Verb+Neg+Prog1+A1sg
anlayamazsınız	anla+Verb^DB+Verb+Able+Neg+Aor+A2pl
kalmamış	kal+Verb+Neg+Narr+A3sg
alamadığım	al+Verb^DB+Verb+Able+Neg^DB+Noun+PastPart+A3sg+P1sg+Nom
konuşmama	konuş+Verb+Neg^DB+Noun+Inf2+A3sg+Pnon+Nom
düşünmez	düşün+Verb+Neg+Aor+A3sg
ayrılmadığımızı	ayır+Verb^DB+Verb+Pass+Neg^DB+Noun+PastPart+A3sg+P1pl+Acc
düşünmediğimi	düşün+Verb+Neg^DB+Noun+PastPart+A3sg+P1sg+Acc
yanılmamışım	yanıl+Verb+Neg+Narr+A1sg
olmadığına	ol+Verb+Neg^DB+Noun+PastPart+A3sg+P3sg+Dat
gücendirmediniz	gücen+Verb^DB+Verb+Caus+Neg+Past+A2pl
etmediniz	et+Verb+Neg+Past+A2pl
kuvvetlendirmediniz	kuvvet+Noun+A3sg+Pnon+Nom^DB+Verb+Acquire^DB+Verb+Caus+Neg+Past+A2pl
kesmeyin	kes+Verb+Neg+Imp+A2pl
koyamam	koy+Verb^DB+Verb+Able+Neg+Aor+A1sg
inanmamıştım	inan+Verb+Neg+Narr+Past+A1sg
dayanılmaz	daya+Verb^DB+Verb+Pass+Neg+Aor+A3sg
geçilmez	geç+Verb^DB+Verb+Pass+Neg+Aor+A3sg
gitmediğinizi	git+Verb+Neg^DB+Noun+PastPart+A3sg+P2pl+Acc
öğütlememe	öğütle+Verb+Neg^DB+Noun+Inf2+A3sg+Pnon+Nom
kollayamaz	kolla+Verb^DB+Verb+Able+Neg+Aor+A3sg
varmamak	var+Verb+Neg^DB+Noun+Inf1+A3sg+Pnon+Nom
hesaplayamamak	hesapla+Verb^DB+Verb+Able+Neg^DB+Noun+Inf1+A3sg+Pnon+Nom
görmemek	gör+Verb+Neg^DB+Noun+Inf1+A3sg+Pnon+Nom
bilmiyordunuz	bil+Verb+Neg+Prog1+Past+A2pl
gelmeseniz	gel+Verb+Neg+Desr+A2pl
ölmezse	öl+Verb+Neg+Aor+Cond+A3sg
ekmesin	ek+Verb+Neg+Imp+A3sg
dayanamayacağım	daya+Verb^DB+Verb+Pass^DB+Verb+Able+Neg+Fut+A1sg
üzmeyin	üz+Verb+Neg+Imp+A2pl
basmayın	bas+Verb+Neg+Imp+A2pl
tartamamışım	tart+Verb^DB+Verb+Able+Neg+Narr+A1sg
bırakmayıp	bırak+Verb+Neg^DB+Adverb+AfterDoingSo
dayanamaz	daya+Verb^DB+Verb+Pass^DB+Verb+Able+Neg+Aor+A3sg
kaldırmadı	kal+Verb^DB+Verb+Caus+Neg+Past+A3sg
oturamıyordu	otur+Verb^DB+Verb+Able+Neg+Prog1+Past+A3sg
saklamayalım	sakla+Verb+Neg+Opt+A1pl
açıklayamadığı	açıkla+Verb^DB+Verb+Able+Neg^DB+Adj+PastPart+P3sg
uzatmamalı	uza+Verb^DB+Verb+Caus+Neg+Neces+A3sg
inanmadığımız	inan+Verb+Neg^DB+Adj+PastPart+P1pl
olmayacağına	ol+Verb+Neg^DB+Noun+FutPart+A3sg+P3sg+Dat
atmaz	at+Verb+Neg+Aor+A3sg
dayanamayacak	daya+Verb^DB+Verb+Pass^DB+Verb+Able+Neg+Fut+A3sg
istemeyecek	iste+Verb+Neg^DB+Adj+FutPart+Pnon
demeyecekti	de+Verb+Neg+Fut+Past+A3sg
kesilmemiş	kes+Verb^DB+Verb+Pass+Neg+Narr+A3sg
emretmemiş	emret+Verb+Neg+Narr+A3sg
yapmadın	yap+Verb+Neg+Past+A2sg
yaramayan	yara+Verb+Neg^DB+Adj+PresPart
vermiyorlar	ver+Verb+Neg+Prog1+A3pl
ayrılmıyordu	ayır+Verb^DB+Verb+Pass+Neg+Prog1+Past+A3sg
çıkaramıyordu	çık+Verb^DB+Verb+Caus^DB+Verb+Able+Neg+Prog1+Past+A3sg
bırakmadı	bırak+Verb+Neg+Past+A3sg
dokundurtmuyor	dokun+Verb^DB+Verb+Caus^DB+Verb+Caus+Neg+Prog1+A3sg
şaşırmadı	şaşır+Verb+Neg+Past+A3sg
erdiremeyeceğini	er+Verb^DB+Verb+Caus^DB+Verb+Able+Neg^DB+Noun+FutPart+A3sg+P3sg+Acc
etmeyin	et+Verb+Neg+Imp+A2pl
gelmediğini	gel+Verb+Neg^DB+Noun+PastPart+A3sg+P3sg+Acc
toslamamak	tosla+Verb+Neg^DB+Noun+Inf1+A3sg+Pnon+Nom
alamayarak	al+Verb^DB+Verb+Able+Neg^DB+Adverb+ByDoingSo
saldıramazdı	sal+Verb^DB+Verb+Caus^DB+Verb+Able+Neg+Aor+Past+A3sg
gerekmiyordu	gerek+Verb+Neg+Prog1+Past+A3sg
yetemezmiş	yet+Verb^DB+Verb+Able+Neg+Aor+Narr+A3sg
bulunmadı	bulun+Verb+Neg+Past+A3sg
istemiyordu	iste+Verb+Neg+Prog1+Past+A3sg
aldırmayın	al+Verb^DB+Verb+Caus+Neg+Imp+A2pl
bırakmıyordu	bırak+Verb+Neg+Prog1+Past+A3sg
kalmadı	kal+Verb+Neg+Past+A3sg
kaybetmedi	kaybet+Verb+Neg+Past+A3sg
uzaklaşmamıştı	uzak+Adj^DB+Verb+Become+Neg+Narr+Past+A3sg
yetişmemiş	yetiş+Verb+Neg+Narr+A3sg
benzemiyordu	benze+Verb+Neg+Prog1+Past+A3sg
görünmüyordu	görün+Verb+Neg+Prog1+Past+A3sg
yeltenmemesi	yelten+Verb+Neg^DB+Noun+Inf2+A3sg+P3sg+Nom
bilmediklerinden	bil+Verb+Neg^DB+Noun+PastPart+A3sg+P3pl+Abl
inanamayan	inan+Verb^DB+Verb+Able+Neg^DB+Adj+PresPart
bulamadı	bul+Verb^DB+Verb+Able+Neg+Past+A3sg
kaynaklanmıyordu	kaynakla+Verb^DB+Verb+Pass+Neg+Prog1+Past+A3sg
girmemişti	gir+Verb+Neg+Narr+Past+A3sg
sataşmamayı	sataş+Verb+Neg^DB+Noun+Inf2+A3sg+Pnon+Acc
unutmamıştı	unut+Verb+Neg+Narr+Past+A3sg
umursamıyordu	umursa+Verb+Neg+Prog1+Past+A3sg
gelmeyeceğini	gel+Verb+Neg^DB+Noun+FutPart+A3sg+P3sg+Acc
göstermiyordu	göster+Verb+Neg+Prog1+Past+A3sg
gelmezdi	gel+Verb+Neg+Aor+Past+A3sg
geçiremiyordu	geç+Verb^DB+Verb+Caus^DB+Verb+Able+Neg+Prog1+Past+A3sg
saplamamak	sapla+Verb+Neg^DB+Noun+Inf1+A3sg+Pnon+Nom
etmemeyi	et+Verb+Neg^DB+Noun+Inf2+A3sg+Pnon+Acc
çıkmamayı	çık+Verb+Neg^DB+Noun+Inf2+A3sg+Pnon+Acc
unutmamak	unut+Verb+Neg^DB+Noun+Inf1+A3sg+Pnon+Nom
yetmiyormuş	yet+Verb+Neg+Prog1+Narr+A3sg
yanılmayan	yan+Verb^DB+Verb+Pass+Neg^DB+Adj+PresPart
sevememişti	sev+Verb^DB+Verb+Able+Neg+Narr+Past+A3sg
çektirmemişlerdi	çek+Verb^DB+Verb+Caus+Neg+Narr+A3pl+Past
bilemezdi	bil+Verb^DB+Verb+Able+Neg+Aor+Past+A3sg
engelleyemiyordu	engelle+Verb^DB+Verb+Able+Neg+Prog1+Past+A3sg
olmuyordu	ol+Verb+Neg+Prog1+Past+A3sg
kalmıyordu	kal+Verb+Neg+Prog1+Past+A3sg
beslemiyordu	besle+Verb+Neg+Prog1+Past+A3sg
sırnaşmıyordu	sırnaş+Verb+Neg+Prog1+Past+A3sg
katlanamaz	katla+Verb^DB+Verb+Pass^DB+Verb+Able+Neg+Aor+A3sg
etmiyordu	et+Verb+Neg+Prog1+Past+A3sg
koşmazdı	koş+Verb+Neg+Aor+Past+A3sg
çıkmaz	çık+Verb+Neg+Aor+A3sg
görmez	gör+Verb+Neg+Aor+A3sg
çıkmıyordu	çık+Verb+Neg+Prog1+Past+A3sg
edemiyorlardı	et+Verb^DB+Verb+Able+Neg+Prog1+A3pl+Past
sataşmıyor	sataş+Verb+Neg+Prog1+A3sg
yaklaşmıyorlardı	yaklaş+Verb+Neg+Prog1+A3pl+Past
bitmiyordu	bit+Verb+Neg+Prog1+Past+A3sg
eğmez	eğ+Verb+Neg+Aor+A3sg
acıtmasa	acı+Verb^DB+Verb+Caus+Neg+Desr+A3sg
görmediğini	gör+Verb+Neg^DB+Noun+PastPart+A3sg+P3sg+Acc
düşünmemişti	düşün+Verb+Neg+Narr+Past+A3sg
almadı	al+Verb+Neg+Past+A3sg
durmamış	dur+Verb+Neg+Narr+A3sg
geçemediği	geç+Verb^DB+Verb+Able+Neg^DB+Adj+PastPart+P3sg
bilmediğinden	bil+Verb+Neg^DB+Noun+PastPart+A3sg+P3sg+Abl
yemez	ye+Verb+Neg+Aor+A3sg
demedi	de+Verb+Neg+Past+A3sg
etmemiş	et+Verb+Neg+Narr+A3sg
yanılmamıştı	yan+Verb^DB+Verb+Pass+Neg+Narr+Past+A3sg
almamıştı	al+Verb+Neg+Narr+Past+A3sg
gizleyememiş	gizle+Verb^DB+Verb+Able+Neg+Narr+A3sg
dokunmamayı	dokun+Verb+Neg^DB+Noun+Inf2+A3sg+Pnon+Acc
vermeyeceğim	ver+Verb+Neg+Fut+A1sg
hoşlanmasa	hoşlan+Verb+Neg+Desr+A3sg
kalkışmadı	kalkış+Verb+Neg+Past+A3sg
alamıyordum	al+Verb^DB+Verb+Able+Neg+Prog1+Past+A1sg
anlayamıyordum	anla+Verb^DB+Verb+Able+Neg+Prog1+Past+A1sg
rastlamıyordum	rastla+Verb+Neg+Prog1+Past+A1sg
tanımaz	tanı+Verb+Neg+Aor+A3sg
görmezsek	gör+Verb+Neg+Aor+Cond+A1pl
görememiştik	gör+Verb^DB+Verb+Able+Neg+Narr+Past+A1pl
tanıştırılmamıştık	tanış+Verb^DB+Verb+Caus^DB+Verb+Pass+Neg+Narr+Past+A1pl
etmesinler	et+Verb+Neg+Imp+A3pl
unutamam	unut+Verb^DB+Verb+Able+Neg+Aor+A1sg
acımamışlar	acı+Verb+Neg+Narr+A3pl
edemedim	et+Verb^DB+Verb+Able+Neg+Past+A1sg
hissedemiyordum	hisset+Verb^DB+Verb+Able+Neg+Prog1+Past+A1sg
tanıyamayacak	tanı+Verb^DB+Verb+Able+Neg^DB+Adj+FutPart+Pnon
olmamış	ol+Verb+Neg^DB+Adj+NarrPart
düşünememiştim	düşün+Verb^DB+Verb+Able+Neg+Narr+Past+A1sg
değişmeyen	değiş+Verb+Neg^DB+Adj+PresPart
almadım	al+Verb+Neg+Past+A1sg
bilmeyen	bil+Verb+Neg^DB+Adj+PresPart
anlaşılamayan	anlaş+Verb^DB+Verb+Pass^DB+Verb+Able+Neg^DB+Adj+PresPart
dönmeyeceğinden	dön+Verb+Neg^DB+Noun+FutPart+A3sg+P3sg+Abl
bilememelerinden	bil+Verb^DB+Verb+Able+Neg^DB+Noun+Inf2+A3sg+P3pl+Abl
kurmadığım	kur+Verb+Neg^DB+Adj+PastPart+P1sg
istemez	iste+Verb+Neg+Aor+A3sg
bozmadı	boz+Verb+Neg+Past+A3sg
yanılmıyordum	yanıl+Verb+Neg+Prog1+Past+A1sg
kalamazdım	kal+Verb^DB+Verb+Able+Neg+Aor+Past+A1sg
edilmemiş	et+Verb^DB+Verb+Pass+Neg+Narr+A3sg
duramayacak	dur+Verb^DB+Verb+Able+Neg^DB+Adj+FutPart+Pnon
gözükmüyordu	gözük+Verb+Neg+Prog1+Past+A3sg
beklenmeyen	bekle+Verb^DB+Verb+Pass+Neg^DB+Adj+PresPart
tanımadığım	tanı+Verb+Neg^DB+Adj+PastPart+P1sg
yeltenmez	yelten+Verb+Neg+Aor+A3sg
bilinmeyen	bil+Verb^DB+Verb+Pass+Neg^DB+Adj+PresPart
bilmeyecek	bil+Verb+Neg+Fut+A3sg
yapmasaydınız	yap+Verb+Neg+Desr+Past+A2pl
gelmeyecekti	gel+Verb+Neg+Fut+Past+A3sg
tanımıyordum	tanı+Verb+Neg+Prog1+Past+A1sg
bilmediğimi	bil+Verb+Neg^DB+Noun+PastPart+A3sg+P1sg+Acc
gelmedi	gel+Verb+Neg+Past+A3sg
dokunmamış	doku+Verb^DB+Verb+Pass+Neg+Narr+A3sg
sayılmam	say+Verb^DB+Verb+Pass+Neg+Aor+A1sg
beceremem	becer+Verb^DB+Verb+Able+Neg+Aor+A1sg
söylemediniz	söyle+Verb+Neg+Past+A2pl
bilemez	bil+Verb^DB+Verb+Able+Neg+Aor+A3sg
hoşlanmadım	hoşlan+Verb+Neg+Past+A1sg
sevmemiştir	sev+Verb+Neg+Narr+A3sg+Cop
tanışmadım	tanış+Verb+Neg+Past+A1sg
tanımadığınız	tanı+Verb+Neg^DB+Noun+PastPart+A3sg+P2pl+Nom
kovmamalıydı	kov+Verb+Neg+Neces+Past+A3sg
sevmiyor	sev+Verb+Neg+Prog1+A3sg
etmemek	et+Verb+Neg^DB+Noun+Inf1+A3sg+Pnon+Nom
yakışmazdı	yakış+Verb+Neg+Aor+Past+A3sg
görmemeye	gör+Verb+Neg^DB+Noun+Inf2+A3sg+Pnon+Dat
darılmayın	darıl+Verb+Neg+Imp+A2pl
esirgemezdi	esirge+Verb+Neg+Aor+Past+A3sg
bilemezsiniz	bil+Verb^DB+Verb+Able+Neg+Aor+A2pl
söylemiyorsunuz	söyle+Verb+Neg+Prog1+A2pl
bilemiyorum	bil+Verb^DB+Verb+Able+Neg+Prog1+A1sg
hissetmemiştim	hisset+Verb+Neg+Narr+Past+A1sg
dayanamadım	dayan+Verb^DB+Verb+Able+Neg+Past+A1sg
duymam	duy+Verb+Neg+Aor+A1sg
etmedim	et+Verb+Neg+Past+A1sg
etmeyelim	et+Verb+Neg+Opt+A1pl
göremeyecek	gör+Verb^DB+Verb+Able+Neg+Fut+A3sg
yapamam	yap+Verb^DB+Verb+Able+Neg+Aor+A1sg
yapamayacağımı	yap+Verb^DB+Verb+Able+Neg^DB+Noun+FutPart+A3sg+P1sg+Acc
yaşamama	yaşa+Verb+Neg^DB+Noun+Inf2+A3sg+Pnon+Nom
bilmezsiniz	bil+Verb+Neg+Aor+A2pl
vazgeçiremeyeceğimi	vazgeç+Verb^DB+Verb+Caus^DB+Verb+Able+Neg^DB+Noun+FutPart+A3sg+P1sg+Acc
gelmemem	gel+Verb+Neg^DB+Noun+Inf2+A3sg+P1sg+Nom
düşünmeyin	düşün+Verb+Neg+Imp+A2pl
gelmem	gel+Verb+Neg+Aor+A1sg
darılmam	darıl+Verb+Neg+Aor+A1sg
geçmez	geç+Verb+Neg+Aor+A3sg
varmayın	var+Verb+Neg+Imp+A2pl
sanmayın	san+Verb+Neg+Imp+A2pl
vermezdim	ver+Verb+Neg+Aor+Past+A1sg
bulunmayacağım	bulun+Verb+Neg+Fut+A1sg
kalkmayın	kalk+Verb+Neg+Imp+A2pl
yadırgamayın	yadırga+Verb+Neg+Imp+A2pl
edemezsin	et+Verb^DB+Verb+Able+Neg+Aor+A2sg
atamazlardı	at+Verb^DB+Verb+Able+Neg+Aor+A3pl+Past
değildin	değil+Verb+Neg+Past+A2sg
yıkılmamıştı	yık+Verb^DB+Verb+Pass+Neg+Narr+Past+A3sg
atılmamıştı	at+Verb^DB+Verb+Pass+Neg+Narr+Past+A3sg
satmamıştım	sat+Verb+Neg+Narr+Past+A1sg
yaramaz	yara+Verb+Neg+Aor+A3sg
ayrılmaz	ayır+Verb^DB+Verb+Pass+Neg+Aor+A3sg
vuramamıştı	vur+Verb^DB+Verb+Able+Neg+Narr+Past+A3sg
sinirlenmemişti	sinir+Noun+A3sg+Pnon+Nom^DB+Verb+Acquire+Neg+Narr+Past+A3sg
veremezdi	ver+Verb^DB+Verb+Able+Neg+Aor+Past+A3sg
göstermezdi	göster+Verb+Neg+Aor+Past+A3sg
bilmemekle	bil+Verb+Neg^DB+Noun+Inf1+A3sg+Pnon+Ins
söyleyemiyordu	söyle+Verb^DB+Verb+Able+Neg+Prog1+Past+A3sg
yapmazdı	yap+Verb+Neg+Aor+Past+A3sg
hissetmiyordu	hisset+Verb+Neg+Prog1+Past+A3sg
boylamamıştı	boyla+Verb+Neg+Narr+Past+A3sg
dinlemiyor	dinle+Verb+Neg+Prog1+A3sg
ayırmamak	ayır+Verb+Neg^DB+Noun+Inf1+A3sg+Pnon+Nom
çıkamıyordu	çık+Verb^DB+Verb+Able+Neg+Prog1+Past+A3sg
bilmiyordum	bil+Verb+Neg+Prog1+Past+A1sg
konuşmadı	konuş+Verb+Neg+Past+A3sg
anlamaz	anla+Verb+Neg+Aor+A3sg
göremedim	gör+Verb^DB+Verb+Able+Neg+Past+A1sg
uğramıyor	uğra+Verb+Neg+Prog1+A3sg
ayırmayan	ayır+Verb+Neg^DB+Adj+PresPart
çalışmıyordu	çalış+Verb+Neg+Prog1+Past+A3sg
yaramazdım	yar+Verb^DB+Verb+Able+Neg+Aor+Past+A1sg
yiyemediğim	ye+Verb^DB+Verb+Able+Neg^DB+Noun+PastPart+A3sg+P1sg+Nom
bahsetmediniz	bahset+Verb+Neg+Past+A2pl
olmadı	ol+Verb+Neg+Past+A3sg
bilmiyorsun	bil+Verb+Neg+Prog1+A2sg
tanımazsın	tanı+Verb+Neg+Aor+A2sg
bilemedin	bil+Verb^DB+Verb+Able+Neg+Past+A2sg
götüremeyecek	götür+Verb^DB+Verb+Able+Neg+Fut+A3sg
götürmememiz	götür+Verb+Neg^DB+Noun+Inf2+A3sg+P1pl+Nom
yakışmıyor	yakış+Verb+Neg+Prog1+A3sg
unutmayacaktı	unut+Verb+Neg+Fut+Past+A3sg
tanımazdım	tanı+Verb+Neg+Aor+Past+A1sg
hoşlanmayacağını	hoşlan+Verb+Neg^DB+Noun+FutPart+A3sg+P3sg+Acc
gelemem	gel+Verb^DB+Verb+Able+Neg+Aor+A1sg
satamam	sat+Verb^DB+Verb+Able+Neg+Aor+A1sg
almıyorsun	al+Verb+Neg+Prog1+A2sg
inmem	in+Verb+Neg+Aor+A1sg
götüremem	götür+Verb^DB+Verb+Able+Neg+Aor+A1sg
anlamıyorsun	anla+Verb+Neg+Prog1+A2sg
anlayamazsın	anla+Verb^DB+Verb+Able+Neg+Aor+A2sg
anlatmayacak	anla+Verb^DB+Verb+Caus+Neg+Fut+A3sg
gülmediler	gül+Verb+Neg+Past+A3pl
gülemediler	gül+Verb^DB+Verb+Able+Neg+Past+A3pl
başlayamayız	başla+Verb^DB+Verb+Able+Neg+Aor+A1pl
kalmasa	kal+Verb+Neg+Desr+A3sg
zannetmem	zannet+Verb+Neg+Aor+A1sg
bilmezsek	bil+Verb+Neg+Aor+Cond+A1pl
yaşayamazsın	yaşa+Verb^DB+Verb+Able+Neg+Aor+A2sg
tutmayan	tut+Verb+Neg^DB+Adj+PresPart
yakışmaz	yakış+Verb+Neg+Aor+A3sg
düşünmemelisin	düşün+Verb+Neg+Neces+A2sg
olmazmış	ol+Verb+Neg+Aor+Narr+A3sg
durmazlar	dur+Verb+Neg+Aor+A3pl
anlatmıyor	anla+Verb^DB+Verb+Caus+Neg+Prog1+A3sg
uyutmazlar	uyu+Verb^DB+Verb+Caus+Neg+Aor+A3pl
istemedi	iste+Verb+Neg+Past+A3sg
iliklemeyen	ilikle+Verb+Neg^DB+Adj+PresPart
karışamaz	karış+Verb^DB+Verb+Able+Neg+Aor+A3sg
alamadım	al+Verb^DB+Verb+Able+Neg+Past+A1sg
hoşlanmazdı	hoşlan+Verb+Neg+Aor+Past+A3sg
görmemiştim	gör+Verb+Neg+Narr+Past+A1sg
görünmeyen	görün+Verb+Neg^DB+Adj+PresPart
oturmam	otur+Verb+Neg+Aor+A1sg
bulamıyoruz	bul+Verb^DB+Verb+Able+Neg+Prog1+A1pl
görünmez	görün+Verb+Neg+Aor+A3sg
evlenemeyeceğini	evlen+Verb^DB+Verb+Able+Neg^DB+Noun+FutPart+A3sg+P3sg+Acc
görmedi	gör+Verb+Neg+Past+A3sg
ilgilenmiyordu	ilgilen+Verb+Neg+Prog1+Past+A3sg
denemezdi	de+Verb^DB+Verb+Pass^DB+Verb+Able+Neg+Aor+Past+A3sg
düşünemiyordum	düşün+Verb^DB+Verb+Able+Neg+Prog1+Past+A1sg
bulamayacaktı	bul+Verb^DB+Verb+Able+Neg+Fut+Past+A3sg
bulamadığını	bul+Verb^DB+Verb+Able+Neg^DB+Noun+PastPart+A3sg+P3sg+Acc
ilgilenmedi	ilgilen+Verb+Neg+Past+A3sg
kullanılmayan	kullan+Verb^DB+Verb+Pass+Neg^DB+Adj+PresPart
erimemişti	eri+Verb+Neg+Narr+Past+A3sg
göremiyordum	gör+Verb^DB+Verb+Able+Neg+Prog1+Past+A1sg
bilmiyormuş	bil+Verb+Neg+Prog1+Narr+A3sg
çaktırmasınlar	çak+Verb^DB+Verb+Caus+Neg+Imp+A3pl
yapmaması	yap+Verb+Neg^DB+Noun+Inf2+A3sg+P3sg+Nom
edemeyeceğine	et+Verb^DB+Verb+Able+Neg^DB+Noun+FutPart+A3sg+P3sg+Dat
edemeyiz	et+Verb^DB+Verb+Able+Neg+Aor+A1pl
bilmedi	bil+Verb+Neg+Past+A3sg
öğrenemeyecek	öğren+Verb^DB+Verb+Able+Neg+Fut+A3sg
gelmemesi	gel+Verb+Neg^DB+Noun+Inf2+A3sg+P3sg+Nom
ağlamıyorsun	ağla+Verb+Neg+Prog1+A2sg
ağlamayacağım	ağla+Verb+Neg+Fut+A1sg
görünmeyecek	görün+Verb+Neg+Fut+A3sg
olamayacağını	ol+Verb^DB+Verb+Able+Neg^DB+Noun+FutPart+A3sg+P3sg+Acc
değişmemişti	değiş+Verb+Neg+Narr+Past+A3sg
sanmıyorum	san+Verb+Neg+Prog1+A1sg
oynayamaz	oyna+Verb^DB+Verb+Able+Neg+Aor+A3sg
istemiyorsun	iste+Verb+Neg+Prog1+A2sg
aydınlatmıyordu	aydınlat+Verb+Neg+Prog1+Past+A3sg
edememişti	et+Verb^DB+Verb+Able+Neg+Narr+Past+A3sg
bilemedim	bil+Verb^DB+Verb+Able+Neg+Past+A1sg
görünmüyorum	görün+Verb+Neg+Prog1+A1sg
beklenemez	bekle+Verb^DB+Verb+Pass^DB+Verb+Able+Neg+Aor+A3sg
kıyamam	kıy+Verb^DB+Verb+Able+Neg+Aor+A1sg
durmadı	dur+Verb+Neg+Past+A3sg
düşünmemek	düşün+Verb+Neg^DB+Noun+Inf1+A3sg+Pnon+Nom
bağlamaz	bağla+Verb+Neg+Aor+A3sg
olmasaydım	ol+Verb+Neg+Desr+Past+A1sg
çekmeme	çek+Verb+Neg^DB+Noun+Inf2+A3sg+Pnon+Nom
durmamıştık	dur+Verb+Neg+Narr+Past+A1pl
kaynaşmaz	kaynaş+Verb+Neg+Aor+A3sg
gelmiyor	gel+Verb+Neg+Prog1+A3sg
anlaşılmaz	anlaş+Verb^DB+Verb+Pass+Neg+Aor+A3sg
şaşırmadım	şaşır+Verb+Neg+Past+A1sg
gösteremedikleri	göster+Verb^DB+Verb+Able+Neg^DB+Noun+PastPart+A3pl+P3pl+Nom
edemezler	et+Verb^DB+Verb+Able+Neg+Aor+A3pl
dokunmuyordu	doku+Verb^DB+Verb+Pass+Neg+Prog1+Past+A3sg
çıkarmıyordum	çık+Verb^DB+Verb+Caus+Neg+Prog1+Past+A1sg
görmem	gör+Verb+Neg+Aor+A1sg
tırmanmam	tırman+Verb+Neg+Aor+A1sg
olamayıp	ol+Verb^DB+Verb+Able+Neg^DB+Adverb+AfterDoingSo
bulunmayan	bulun+Verb+Neg^DB+Adj+PresPart
etmemiştim	et+Verb+Neg+Narr+Past+A1sg
görünmese	görün+Verb+Neg+Desr+A3sg
şaşırmamıştım	şaşır+Verb+Neg+Narr+Past+A1sg
vuramadı	vur+Verb^DB+Verb+Able+Neg+Past+A3sg
olmasam	ol+Verb+Neg+Desr+A1sg
kapanmayacağına	kapa+Verb^DB+Verb+Pass+Neg^DB+Noun+FutPart+A3sg+P3sg+Dat
veremeyeceğini	ver+Verb^DB+Verb+Able+Neg^DB+Noun+FutPart+A3sg+P3sg+Acc
atmadım	at+Verb+Neg+Past+A1sg
inanılmaz	inan+Verb^DB+Verb+Pass+Neg+Aor+A3sg
istemeyeceğinden	iste+Verb+Neg^DB+Noun+FutPart+A3sg+P2sg+Abl
bahsedilmedi	bahset+Verb^DB+Verb+Pass+Neg+Past+A3sg
anlaşılmamıştı	anlaş+Verb^DB+Verb+Pass+Neg+Narr+Past+A3sg
görmesin	gör+Verb+Neg+Imp+A3sg
gitmeme	git+Verb+Neg^DB+Noun+Inf2+A3sg+Pnon+Nom
güzelleşmiyor	güzel+Adj^DB+Verb+Become+Neg+Prog1+A3sg
anlaşılamıyordu	anlaş+Verb^DB+Verb+Pass^DB+Verb+Able+Neg+Prog1+Past+A3sg
olmasaydı	ol+Verb+Neg+Desr+Past+A3sg
güvenmiyordum	güven+Verb+Neg+Prog1+Past+A1sg
kesilmiyor	kes+Verb^DB+Verb+Pass+Neg+Prog1+A3sg
konuşamazmış	konuş+Verb^DB+Verb+Able+Neg+Aor+Narr+A3sg
alamazsınız	al+Verb^DB+Verb+Able+Neg+Aor+A2pl
işlemediğini	işle+Verb+Neg^DB+Noun+PastPart+A3sg+P3sg+Acc
girmedi	gir+Verb+Neg+Past+A3sg
sığmaz	sığ+Verb+Neg+Aor+A3sg
edilmezler	et+Verb^DB+Verb+Pass+Neg+Aor+A3pl
getirilmezlerse	getir+Verb^DB+Verb+Pass+Neg+Aor+A3pl+Cond
bulunmadığı	bulun+Verb+Neg^DB+Noun+PastPart+A3sg+P3sg+Nom
olmadıklarını	ol+Verb+Neg^DB+Noun+PastPart+A3sg+P3pl+Acc
görmediklerini	gör+Verb+Neg^DB+Noun+PastPart+A3pl+P3pl+Acc
bitirmez	bit+Verb^DB+Verb+Caus+Neg+Aor+A3sg
dinlememeye	dinle+Verb+Neg^DB+Noun+Inf2+A3sg+Pnon+Dat
çıkarmamamı	çık+Verb^DB+Verb+Caus+Neg^DB+Noun+Inf2+A3sg+P1sg+Acc
değildim	değil+Verb+Neg+Past+A1sg
kalmayarak	kal+Verb+Neg^DB+Adverb+ByDoingSo
inmedim	in+Verb+Neg+Past+A1sg
olmaması	ol+Verb+Neg^DB+Noun+Inf2+A3sg+P3sg+Nom
sayılmazsa	say+Verb^DB+Verb+Pass+Neg+Aor+Cond+A3sg
edilemiyor	et+Verb^DB+Verb+Pass^DB+Verb+Able+Neg+Prog1+A3sg
kullanmamaya	kullan+Verb+Neg^DB+Noun+Inf2+A3sg+Pnon+Dat
söylememeye	söyle+Verb+Neg^DB+Noun+Inf2+A3sg+Pnon+Dat
bulamadığı	bula+Verb+Neg^DB+Noun+PastPart+A3sg+P3sg+Nom
dayanamadığı	daya+Verb^DB+Verb+Pass^DB+Verb+Able+Neg^DB+Noun+PastPart+A3sg+P3sg+Nom
yitirmeyen	yit+Verb^DB+Verb+Caus+Neg^DB+Adj+PresPart
kopartmamış	kop+Verb^DB+Verb+Caus^DB+Verb+Caus+Neg+Narr+A3sg
vazgeçilmez	vazgeç+Verb^DB+Verb+Pass+Neg+Aor+A3sg
saklamadı	sakla+Verb+Neg+Past+A3sg
sergilemese	sergile+Verb+Neg+Desr+A3sg
giremeyişinden	gir+Verb^DB+Verb+Able+Neg^DB+Noun+Inf3+A3sg+P3sg+Abl
istenmez	iste+Verb^DB+Verb+Pass+Neg+Aor+A3sg
benimsemedi	benimse+Verb+Neg+Past+A3sg
bakılmamış	bak+Verb^DB+Verb+Pass+Neg+Narr+A3sg
tanımlama	tanımla+Verb+Neg+Imp+A2sg
bırakmayan	bırak+Verb+Neg^DB+Adj+PresPart
edinmeyen	edin+Verb+Neg^DB+Adj+PresPart
alışmadıkça	alış+Verb+Neg^DB+Adverb+AsLongAs
atamayacağız	at+Verb^DB+Verb+Able+Neg+Fut+A1pl
bulamamış	bul+Verb^DB+Verb+Able+Neg+Narr+A3sg
yaşanmamış	yaşa+Verb^DB+Verb+Pass+Neg+Narr+A3sg
edemedikleri	et+Verb^DB+Verb+Able+Neg^DB+Noun+PastPart+A3pl+P3pl+Nom
ayrılmayarak	ayır+Verb^DB+Verb+Pass+Neg^DB+Adverb+ByDoingSo
çarpmaz	çarp+Verb+Neg+Aor+A3sg
tartışamazdı	tartış+Verb^DB+Verb+Able+Neg+Aor+Past+A3sg
olmamalarına	ol+Verb+Neg^DB+Noun+Inf2+A3sg+P3pl+Dat
anlamadıkları	anla+Verb+Neg^DB+Adj+PastPart+P3pl
karışamayarak	karış+Verb^DB+Verb+Able+Neg^DB+Adverb+ByDoingSo
sevmezdi	sev+Verb+Neg+Aor+Past+A3sg
sezmez	sez+Verb+Neg+Aor+A3sg
istemezdi	iste+Verb+Neg+Aor+Past+A3sg
istemeyeceksin	iste+Verb+Neg+Fut+A2sg
tutmadı	tut+Verb+Neg+Past+A3sg
ayrılmazdı	ayır+Verb^DB+Verb+Pass+Neg+Aor+Past+A3sg
dövmez	döv+Verb+Neg+Aor+A3sg
azarlamazdı	azarla+Verb+Neg+Aor+Past+A3sg
okşamazdı	okşa+Verb+Neg+Aor+Past+A3sg
kaldırmasa	kaldır+Verb+Neg+Desr+A3sg
ölmedi	öl+Verb+Neg+Past+A3sg
dönmedi	dön+Verb+Neg+Past+A3sg
etmemişti	et+Verb+Neg+Narr+Past+A3sg
yapmamalıydın	yap+Verb+Neg+Neces+Past+A2sg
olmuyor	ol+Verb+Neg+Prog1+A3sg
çıkamayan	çık+Verb^DB+Verb+Able+Neg^DB+Adj+PresPart
almamış	al+Verb+Neg+Narr+A3sg
bulamadıkları	bula+Verb+Neg^DB+Noun+PastPart+A3pl+P3pl+Nom
davranmadığını	davran+Verb+Neg^DB+Noun+PastPart+A3sg+P3sg+Acc
bulmuyorum	bul+Verb+Neg+Prog1+A1sg
gelmiyordu	gel+Verb+Neg+Prog1+Past+A3sg
anlamadığı	anla+Verb+Neg^DB+Adj+PastPart+P3sg
gitmiyorsun	git+Verb+Neg+Prog1+A2sg
yapmadığı	yap+Verb+Neg^DB+Adj+PastPart+P3sg
bakmayarak	bak+Verb+Neg^DB+Adverb+ByDoingSo
yansıtmadıkları	yansı+Verb^DB+Verb+Caus+Neg^DB+Noun+PastPart+A3pl+P3pl+Nom
gelmemişti	gel+Verb+Neg+Narr+Past+A3sg
bulamayarak	bul+Verb^DB+Verb+Able+Neg^DB+Adverb+ByDoingSo
değmez	değ+Verb+Neg+Aor+A3sg
yaşamadı	yaşa+Verb+Neg+Past+A3sg
bilmezdi	bil+Verb+Neg+Aor+Past+A3sg
bulamayınca	bula+Verb+Neg^DB+Adverb+When
söylemediği	söyle+Verb+Neg^DB+Noun+PastPart+A3sg+P3sg+Nom
olmamıştı	ol+Verb+Neg+Narr+Past+A3sg
alışmadığı	alış+Verb+Neg^DB+Adj+PastPart+P3sg
azalmayan	azal+Verb+Neg^DB+Adj+PresPart
söyleyemedi	söyle+Verb^DB+Verb+Able+Neg+Past+A3sg
tanımadığı	tanı+Verb+Neg^DB+Adj+PastPart+P3sg
söylemeseydin	söyle+Verb+Neg+Desr+Past+A2sg
alıkoyamam	alıkoy+Verb^DB+Verb+Able+Neg+Aor+A1sg
bilemeyen	bil+Verb^DB+Verb+Able+Neg^DB+Adj+PresPart
bitirilmedi	bit+Verb^DB+Verb+Caus^DB+Verb+Pass+Neg+Past+A3sg
birleştiremezdim	birleş+Verb^DB+Verb+Caus^DB+Verb+Able+Neg+Aor+Past+A1sg
görmediğimden	gör+Verb+Neg^DB+Noun+PastPart+A3sg+P1sg+Abl
yapmayın	yap+Verb+Neg+Imp+A2pl
olmama	ol+Verb+Neg^DB+Noun+Inf2+A3sg+Pnon+Nom
ağlamamak	ağla+Verb+Neg^DB+Noun+Inf1+A3sg+Pnon+Nom
vermedim	ver+Verb+Neg+Past+A1sg
yaşamayacağını	yaşa+Verb+Neg^DB+Noun+FutPart+A3sg+P3sg+Acc
hissetmem	hisset+Verb+Neg+Aor+A1sg
bulanmaz	bula+Verb^DB+Verb+Pass+Neg+Aor+A3sg
kalkışmazsan	kalkış+Verb+Neg+Aor+Cond+A2sg
yapamazsan	yap+Verb^DB+Verb+Able+Neg+Aor+Cond+A2sg
vermesin	ver+Verb+Neg+Imp+A3sg
rastlayamadım	rastla+Verb^DB+Verb+Able+Neg+Past+A1sg
çekmediğini	çek+Verb+Neg^DB+Noun+PastPart+A3sg+P3sg+Acc
çıkarmadığını	çık+Verb^DB+Verb+Caus+Neg^DB+Noun+PastPart+A3sg+P3sg+Acc
anlamıyordum	anla+Verb+Neg+Prog1+Past+A1sg
dönmemiş	dön+Verb+Neg^DB+Adj+NarrPart
çıkarmadığımı	çık+Verb^DB+Verb+Caus+Neg^DB+Noun+PastPart+A3sg+P1sg+Acc
söylememişti	söyle+Verb+Neg+Narr+Past+A3sg
edemiyordum	et+Verb^DB+Verb+Able+Neg+Prog1+Past+A1sg
ayırmam	ayır+Verb+Neg+Aor+A1sg
bulamayabilirdim	bul+Verb^DB+Verb+Able+Neg^DB+Verb+Able+Aor+Past+A1sg
dokunulmamış	doku+Verb^DB+Verb+Pass+Neg+Narr+A3sg
almıyordu	al+Verb+Neg+Prog1+Past+A3sg
kaçmadı	kaç+Verb+Neg+Past+A3sg
olamazsın	ol+Verb^DB+Verb+Able+Neg+Aor+A2sg
ölmedin	öl+Verb+Neg+Past+A2sg
gelmemişse	gel+Verb+Neg+Narr+Cond+A3sg
düşünmedim	düşün+Verb+Neg+Past+A1sg
görmüyordum	gör+Verb+Neg+Prog1+Past+A1sg
getirmem	getir+Verb+Neg+Aor+A1sg
ölmeyeceğini	öl+Verb+Neg^DB+Noun+FutPart+A3sg+P3sg+Acc
öldürmemesi	öl+Verb^DB+Verb+Caus+Neg^DB+Noun+Inf2+A3sg+P3sg+Nom
olmamıştır	ol+Verb+Neg+Narr+A3sg+Cop
karıştırmam	karış+Verb^DB+Verb+Caus+Neg+Aor+A1sg
yapılamayacak	yap+Verb^DB+Verb+Pass^DB+Verb+Able+Neg+Fut+A3sg
anlamadım	anla+Verb+Neg+Past+A1sg
söyletmezsin	söyle+Verb^DB+Verb+Caus+Neg+Aor+A2sg
anlamadı	anla+Verb+Neg+Past+A3sg
olmayacaksanız	ol+Verb+Neg+Fut+Cond+A2pl
büyütmedim	büyüt+Verb+Neg+Past+A1sg
soymam	soy+Verb+Neg+Aor+A1sg
yapmama	yap+Verb+Neg^DB+Noun+Inf2+A3sg+Pnon+Nom
sürtmem	sürt+Verb+Neg+Aor+A1sg
kaybedemezdim	kaybet+Verb^DB+Verb+Able+Neg+Aor+Past+A1sg
etmemesini	et+Verb+Neg^DB+Noun+Inf2+A3sg+P3sg+Acc
gelmedikleri	gel+Verb+Neg^DB+Noun+PastPart+A3pl+P3pl+Nom
bilmezlerdi	bil+Verb+Neg+Aor+A3pl+Past
ısıtamıyordum	ısıt+Verb^DB+Verb+Able+Neg+Prog1+Past+A1sg
görmeseydi	gör+Verb+Neg+Desr+Past+A3sg
söylemiyorsun	söyle+Verb+Neg+Prog1+A2sg
getirmedin	getir+Verb+Neg+Past+A2sg
takmadın	tak+Verb+Neg+Past+A2sg
etmemesinden	et+Verb+Neg^DB+Noun+Inf2+A3sg+P3sg+Abl
kaçınamayınca	kaçın+Verb^DB+Verb+Able+Neg^DB+Adverb+When
katılmam	kat+Verb^DB+Verb+Pass+Neg+Aor+A1sg
yapmazsa	yap+Verb+Neg+Aor+Cond+A3sg
beklememesi	bekle+Verb+Neg^DB+Noun+Inf2+A3sg+P3sg+Nom
ulaşamayacaklarını	ulaş+Verb^DB+Verb+Able+Neg^DB+Noun+FutPart+A3pl+P3pl+Acc
çalamayacağını	çal+Verb^DB+Verb+Able+Neg^DB+Noun+FutPart+A3sg+P3sg+Acc
çalmamasına	çal+Verb+Neg^DB+Noun+Inf2+A3sg+P3sg+Dat
telaşlanmayacağım	telaş+Noun+A3sg+Pnon+Nom^DB+Verb+Acquire+Neg+Fut+A1sg
korkmayacak	kork+Verb+Neg^DB+Adj+FutPart+Pnon
söylemeyeceğim	söyle+Verb+Neg+Fut+A1sg
inandıramam	inan+Verb^DB+Verb+Caus^DB+Verb+Able+Neg+Aor+A1sg
inanmamanızı	inan+Verb+Neg^DB+Noun+Inf2+A3sg+P2pl+Acc
söylememe	söyle+Verb+Neg^DB+Noun+Inf2+A3sg+Pnon+Nom
korkmuyorum	kork+Verb+Neg+Prog1+A1sg
ermemiştim	er+Verb+Neg+Narr+Past+A1sg
tanıştırılmadı	tanış+Verb^DB+Verb+Caus^DB+Verb+Pass+Neg+Past+A3sg
değilimdir	değil+Verb+Neg+Pres+A1sg+Cop
istemediği	iste+Verb+Neg^DB+Noun+PastPart+A3sg+P3sg+Nom
olmadığım	ol+Verb+Neg^DB+Adj+PastPart+P1sg
yakalayamıyorum	yakala+Verb^DB+Verb+Able+Neg+Prog1+A1sg
görünemiyorum	görün+Verb^DB+Verb+Able+Neg+Prog1+A1sg
etmiyorlar	et+Verb+Neg+Prog1+A3pl
girmiyorum	gir+Verb+Neg+Prog1+A1sg
endişelenmeyin	endişe+Noun+A3sg+Pnon+Nom^DB+Verb+Acquire+Neg+Imp+A2pl
kestiremiyordu	kes+Verb^DB+Verb+Caus^DB+Verb+Able+Neg+Prog1+Past+A3sg
bekleyemezsek	bekle+Verb^DB+Verb+Able+Neg+Aor+Cond+A1pl
tanımadı	tanı+Verb+Neg+Past+A3sg
konuşmayan	konuş+Verb+Neg^DB+Adj+PresPart
bilemezler	bil+Verb^DB+Verb+Able+Neg+Aor+A3pl
keşfedemedi	keşfet+Verb^DB+Verb+Able+Neg+Past+A3sg
dönmemesini	dön+Verb+Neg^DB+Noun+Inf2+A3sg+P3sg+Acc
etmedik	et+Verb+Neg+Past+A1pl
olamıyorum	ol+Verb^DB+Verb+Able+Neg+Prog1+A1sg
örmediniz	ör+Verb+Neg+Past+A2pl
çağırtmadım	çağır+Verb^DB+Verb+Caus+Neg+Past+A1sg
bitmeyeceğini	bit+Verb+Neg^DB+Noun+FutPart+A3sg+P3sg+Acc
alamadı	al+Verb^DB+Verb+Able+Neg+Past+A3sg
istememesi	iste+Verb+Neg^DB+Noun+Inf2+A3sg+P3sg+Nom
anlaşılmayacak	anlaş+Verb^DB+Verb+Pass+Neg+Fut+A3sg
tasalanmayın	tasa+Noun+A3sg+Pnon+Nom^DB+Verb+Acquire+Neg+Imp+A2pl
koymadığımı	koy+Verb+Neg^DB+Noun+PastPart+A3sg+P1sg+Acc
çıkarmayın	çık+Verb^DB+Verb+Caus+Neg+Imp+A2pl
kabartmaz	kabar+Verb^DB+Verb+Caus+Neg+Aor+A3sg
zannetmeyin	zannet+Verb+Neg+Imp+A2pl
demezler	de+Verb+Neg+Aor+A3pl
bitirmedim	bit+Verb^DB+Verb+Caus+Neg+Past+A1sg
çaktırmamak	çak+Verb^DB+Verb+Caus+Neg^DB+Noun+Inf1+A3sg+Pnon+Nom
etmemesi	et+Verb+Neg^DB+Noun+Inf2+A3sg+P3sg+Nom
şüphelenmemeli	şüphe+Noun+A3sg+Pnon+Nom^DB+Verb+Acquire+Neg+Neces+A3sg
demez	de+Verb+Neg+Aor+A3sg
yemem	ye+Verb+Neg+Aor+A1sg
lekelememek	lekele+Verb+Neg^DB+Noun+Inf1+A3sg+Pnon+Nom
unutamaz	unut+Verb^DB+Verb+Able+Neg+Aor+A3sg
unutmazlar	unut+Verb+Neg+Aor+A3pl
yapmadı	yap+Verb+Neg+Past+A3sg
bayılmadı	bayıl+Verb+Neg+Past+A3sg
doymasın	doy+Verb+Neg+Imp+A3sg
bakma	bak+Verb+Neg+Imp+A2sg
duymuyor	duy+Verb+Neg+Prog1+A3sg
olamamak	ol+Verb^DB+Verb+Able+Neg^DB+Noun+Inf1+A3sg+Pnon+Nom
alamadılar	al+Verb^DB+Verb+Able+Neg+Past+A3pl
kalmasınlar	kal+Verb+Neg+Imp+A3pl
hoşlanmam	hoşlan+Verb+Neg+Aor+A1sg
göndermedi	gönder+Verb+Neg+Past+A3sg
yanaşamadığı	yanaş+Verb^DB+Verb+Able+Neg^DB+Adj+PastPart+P3sg
erdiremez	er+Verb^DB+Verb+Caus^DB+Verb+Able+Neg+Aor+A3sg
yaramazdı	yara+Verb+Neg+Aor+Past+A3sg
göstermedi	göster+Verb+Neg+Past+A3sg
kirletmeyecek	kirlet+Verb+Neg+Fut+A3sg
anlamamıştım	anla+Verb+Neg+Narr+Past+A1sg
anımsamıyordum	anımsa+Verb+Neg+Prog1+Past+A1sg
olmazdım	ol+Verb+Neg+Aor+Past+A1sg
istemeyerek	iste+Verb+Neg^DB+Adverb+ByDoingSo
kovmayacağım	kov+Verb+Neg+Fut+A1sg
getiremedim	getir+Verb^DB+Verb+Able+Neg+Past+A1sg
anlamam	anla+Verb+Neg+Aor+A1sg
beklemeyin	bekle+Verb+Neg+Imp+A2pl
değiliz	değil+Verb+Neg+Pres+A1pl
titrememesine	titre+Verb+Neg^DB+Noun+Inf2+A3sg+P3sg+Dat
konuşmamışımdır	konuş+Verb+Neg+Narr+A1sg+Cop
istemedim	iste+Verb+Neg+Past+A1sg
gitmedi	git+Verb+Neg+Past+A3sg
edemesem	et+Verb^DB+Verb+Able+Neg+Desr+A1sg
konuşamazdım	konuş+Verb^DB+Verb+Able+Neg+Aor+Past+A1sg
düşmemek	düş+Verb+Neg^DB+Noun+Inf1+A3sg+Pnon+Nom
kalmasın	kal+Verb+Neg+Imp+A3sg
duymazdım	duy+Verb+Neg+Aor+Past+A1sg
görmediğim	gör+Verb+Neg^DB+Noun+PastPart+A3sg+P1sg+Nom
beklemiyordun	bekle+Verb+Neg+Prog1+Past+A2sg
kullanmayacaksa	kullan+Verb+Neg+Fut+Cond+A3sg
bulmasaydı	bul+Verb+Neg+Desr+Past+A3sg
ayıramıyorum	ayır+Verb^DB+Verb+Able+Neg+Prog1+A1sg
çekmem	çek+Verb+Neg+Aor+A1sg
gelmeyecek	gel+Verb+Neg+Fut+A3sg
konuşmamak	konuş+Verb+Neg^DB+Noun+Inf1+A3sg+Pnon+Nom
bırakmamam	bırak+Verb+Neg^DB+Noun+Inf2+A3sg+P1sg+Nom
yaşamam	yaşa+Verb+Neg+Aor+A1sg
görünmeyecekti	görün+Verb+Neg+Fut+Past+A3sg
istemediğini	iste+Verb+Neg^DB+Noun+PastPart+A3sg+P3sg+Acc
düşünülmüyordu	düşün+Verb^DB+Verb+Pass+Neg+Prog1+Past+A3sg
gidemezdim	git+Verb^DB+Verb+Able+Neg+Aor+Past+A1sg
bilememiştim	bil+Verb^DB+Verb+Able+Neg+Narr+Past+A1sg
yapılamazdı	yap+Verb^DB+Verb+Pass^DB+Verb+Able+Neg+Aor+Past+A3sg
sokmamak	sok+Verb+Neg^DB+Noun+Inf1+A3sg+Pnon+Nom
uyandırmamak	uyan+Verb^DB+Verb+Caus+Neg^DB+Noun+Inf1+A3sg+Pnon+Nom
çıkarmadı	çık+Verb^DB+Verb+Caus+Neg+Past+A3sg
görmedik	gör+Verb+Neg+Past+A1pl
bulamadık	bul+Verb^DB+Verb+Able+Neg+Past+A1pl
almadığını	al+Verb+Neg^DB+Noun+PastPart+A3sg+P3sg+Acc
dönmediğinden	dön+Verb+Neg^DB+Noun+PastPart+A3sg+P3sg+Abl
önemsememişti	önemse+Verb+Neg+Narr+Past+A3sg
bilmediğim	bil+Verb+Neg^DB+Adj+PastPart+P1sg
istemezsen	iste+Verb+Neg+Aor+Cond+A2sg
bitiremedim	bit+Verb^DB+Verb+Caus^DB+Verb+Able+Neg+Past+A1sg
girmezdi	gir+Verb+Neg+Aor+Past+A3sg
içemeseydim	iç+Verb^DB+Verb+Able+Neg+Desr+Past+A1sg
binmeyecek	bin+Verb+Neg+Fut+A3sg
konuşmayacağım	konuş+Verb+Neg+Fut+A1sg
tanınmayıp	tanı+Verb^DB+Verb+Pass+Neg^DB+Adverb+AfterDoingSo
yakalanmamanız	yakala+Verb^DB+Verb+Pass+Neg^DB+Noun+Inf2+A3sg+P2pl+Nom
bakmadım	bak+Verb+Neg+Past+A1sg
bahsetmeyin	bahset+Verb+Neg+Imp+A2pl
söylemezse	söyle+Verb+Neg+Aor+Cond+A3sg
dönmeyeceğim	dön+Verb+Neg+Fut+A1sg
korkmam	kork+Verb+Neg+Aor+A1sg
tutmazsa	tut+Verb+Neg+Aor+Cond+A3sg
söylemeyecekti	söyle+Verb+Neg+Fut+Past+A3sg
görmediklerinden	gör+Verb+Neg^DB+Noun+PastPart+A3sg+P3pl+Abl
çıkamadım	çık+Verb^DB+Verb+Able+Neg+Past+A1sg
açmaması	aç+Verb+Neg^DB+Noun+Inf2+A3sg+P3sg+Nom
söyleme	söyle+Verb+Neg+Imp+A2sg
edemiyorum	et+Verb^DB+Verb+Able+Neg+Prog1+A1sg
bakmıyordu	bak+Verb+Neg+Prog1+Past+A3sg
girmeyeceğim	gir+Verb+Neg+Fut+A1sg
bırakmamamı	bırak+Verb+Neg^DB+Noun+Inf2+A3sg+P1sg+Acc
kakmayacaksın	kak+Verb+Neg+Fut+A2sg
doğmamayı	doğ+Verb+Neg^DB+Noun+Inf2+A3sg+Pnon+Acc
kalmazsam	kal+Verb+Neg+Aor+Cond+A1sg
etmeyeceği	et+Verb+Neg^DB+Noun+FutPart+A3sg+P3sg+Nom
biçilmez	biç+Verb^DB+Verb+Pass+Neg+Aor+A3sg
çıkmıyorsun	çık+Verb+Neg+Prog1+A2sg
dağıtılmıyor	dağıt+Verb^DB+Verb+Pass+Neg+Prog1+A3sg
gidemem	git+Verb^DB+Verb+Able+Neg+Aor+A1sg
vermeyecek	ver+Verb+Neg+Fut+A3sg
gitmemeyi	git+Verb+Neg^DB+Noun+Inf2+A3sg+Pnon+Acc
düşünmemiştim	düşün+Verb+Neg+Narr+Past+A1sg
edilmemek	et+Verb^DB+Verb+Pass+Neg^DB+Noun+Inf1+A3sg+Pnon+Nom
bulamadılar	bul+Verb^DB+Verb+Able+Neg+Past+A3pl
bulamıyorlardı	bul+Verb^DB+Verb+Able+Neg+Prog1+A3pl+Past
bakmadın	bak+Verb+Neg+Past+A2sg
bulamamıştı	bul+Verb^DB+Verb+Able+Neg+Narr+Past+A3sg
bulmamıştı	bul+Verb+Neg+Narr+Past+A3sg
satmamasını	sat+Verb+Neg^DB+Noun+Inf2+A3sg+P3sg+Acc
açmadı	aç+Verb+Neg+Past+A3sg
koymaz	koy+Verb+Neg+Aor+A3sg
taranmamış	tara+Verb^DB+Verb+Pass+Neg+Narr+A3sg
kaybetmeseydi	kaybet+Verb+Neg+Desr+Past+A3sg
tanımamış	tanı+Verb+Neg+Narr+A3sg
görüşmeyeli	görüş+Verb+Neg^DB+Adverb+SinceDoingSo
etmemiştin	et+Verb+Neg+Narr+Past+A2sg
yanmamıştı	yan+Verb+Neg+Narr+Past+A3sg
görmedikleri	gör+Verb+Neg^DB+Adj+PastPart+P3pl
keşfedilmemiş	keşfet+Verb^DB+Verb+Pass+Neg+Narr+A3sg
girmemiş	gir+Verb+Neg+Narr+A3sg
değmemiş	değ+Verb+Neg+Narr+A3sg
işlenmemiş	işle+Verb^DB+Verb+Pass+Neg^DB+Adj+NarrPart
karışmayan	karış+Verb+Neg^DB+Adj+PresPart
öğrenemedi	öğren+Verb^DB+Verb+Able+Neg+Past+A3sg
anlamamış	anla+Verb+Neg+Narr+A3sg
hissetmemişti	hisset+Verb+Neg+Narr+Past+A3sg
olmadım	ol+Verb+Neg+Past+A1sg
arzulamıyordu	arzula+Verb+Neg+Prog1+Past+A3sg
olamazdı	ol+Verb^DB+Verb+Able+Neg+Aor+Past+A3sg
çıkartamadığı	çık+Verb^DB+Verb+Caus^DB+Verb+Caus^DB+Verb+Able+Neg^DB+Noun+PastPart+A3sg+P3sg+Nom
satmamaya	sat+Verb+Neg^DB+Noun+Inf2+A3sg+Pnon+Dat
getirmeyin	getir+Verb+Neg+Imp+A2pl
açmayın	aç+Verb+Neg+Imp+A2pl
değişmiyor	değiş+Verb+Neg+Prog1+A3sg
uğraşmıyorsunuz	uğraş+Verb+Neg+Prog1+A2pl
olmuyorsunuz	ol+Verb+Neg+Prog1+A2pl
gitmez	git+Verb+Neg+Aor+A3sg
diyemem	de+Verb^DB+Verb+Able+Neg+Aor+A1sg
uyumadı	uyu+Verb+Neg+Past+A3sg
söylenemez	söyle+Verb^DB+Verb+Pass^DB+Verb+Able+Neg+Aor+A3sg
vazgeçmediği	vazgeç+Verb+Neg^DB+Noun+PastPart+A3sg+P3sg+Nom
yaşlanmamıştı	yaş+Noun+A3sg+Pnon+Nom^DB+Verb+Acquire+Neg+Narr+Past+A3sg
olgunlaşmadığına	olgun+Adj^DB+Verb+Become+Neg^DB+Noun+PastPart+A3sg+P3sg+Dat
yemiyorsunuz	ye+Verb+Neg+Prog1+A2pl
olmadığımızı	ol+Verb+Neg^DB+Noun+PastPart+A3sg+P1pl+Acc
istemeyeceğim	iste+Verb+Neg+Fut+A1sg
tekrarlatmadı	tekrarla+Verb^DB+Verb+Caus+Neg+Past+A3sg
yemiyordu	ye+Verb+Neg+Prog1+Past+A3sg
içmiyordu	iç+Verb+Neg+Prog1+Past+A3sg
demem	de+Verb+Neg+Aor+A1sg
bitirmemişti	bit+Verb^DB+Verb+Caus+Neg+Narr+Past+A3sg
çekinmeyin	çekin+Verb+Neg+Imp+A2pl
bakmaz	bak+Verb+Neg+Aor+A3sg
bulamazdım	bul+Verb^DB+Verb+Able+Neg+Aor+Past+A1sg
yollamadım	yolla+Verb+Neg+Past+A1sg
yanaşmayacağımı	yanaş+Verb+Neg^DB+Noun+FutPart+A3sg+P1sg+Acc
gelmesin	gel+Verb+Neg+Imp+A3sg
etmesin	et+Verb+Neg+Imp+A3sg
görmezler	gör+Verb+Neg+Aor+A3pl
anlayamıyor	anla+Verb^DB+Verb+Able+Neg+Prog1+A3sg
yapmadım	yap+Verb+Neg+Past+A1sg
evlenmediği	evlen+Verb+Neg^DB+Noun+PastPart+A3sg+P3sg+Nom
veremezdim	ver+Verb^DB+Verb+Able+Neg+Aor+Past+A1sg
karşılaşmaması	karşılaş+Verb+Neg^DB+Noun+Inf2+A3sg+P3sg+Nom
korkmadığınız	kork+Verb+Neg^DB+Noun+PastPart+A3sg+P2pl+Nom
utanmadınız	utan+Verb+Neg+Past+A2pl
koymadınız	koy+Verb+Neg+Past+A2pl
içmeyecek	iç+Verb+Neg+Fut+A3sg
ödememe	öde+Verb+Neg^DB+Noun+Inf2+A3sg+Pnon+Nom
vermezsiniz	ver+Verb+Neg+Aor+A2pl
anlatmayacağım	anlat+Verb+Neg+Fut+A1sg
yıkmaması	yık+Verb+Neg^DB+Noun+Inf2+A3sg+P3sg+Nom
yatmamış	yat+Verb+Neg+Narr+A3sg
tanımamıştı	tanı+Verb+Neg+Narr+Past+A3sg
düşünemez	düşün+Verb^DB+Verb+Able+Neg+Aor+A3sg
konuşamazdı	konuş+Verb^DB+Verb+Able+Neg+Aor+Past+A3sg
anlatamayınca	anla+Verb^DB+Verb+Caus^DB+Verb+Able+Neg^DB+Adverb+When
gelememişti	gel+Verb^DB+Verb+Able+Neg+Narr+Past+A3sg
söndürmemiştim	sön+Verb^DB+Verb+Caus+Neg+Narr+Past+A1sg
atamıyordu	at+Verb^DB+Verb+Able+Neg+Prog1+Past+A3sg
kaybolmuyordu	kaybol+Verb+Neg+Prog1+Past+A3sg
anlamadığımı	anla+Verb+Neg^DB+Noun+PastPart+A3sg+P1sg+Acc
geçmediğini	geç+Verb+Neg^DB+Noun+PastPart+A3sg+P3sg+Acc
çekmemiş	çek+Verb+Neg+Narr+A3sg
durmadığım	dur+Verb+Neg^DB+Adj+PastPart+P1sg
anlayamadığım	anla+Verb^DB+Verb+Able+Neg^DB+Adj+PastPart+P1sg
umulmadık	um+Verb^DB+Verb+Pass+Neg+Past+A1pl
almaz	al+Verb+Neg^DB+Adj+AorPart
istemeyebilir	iste+Verb+Neg^DB+Verb+Able+Aor+A3sg
istemediğinden	iste+Verb+Neg^DB+Noun+PastPart+A3sg+P3sg+Abl
düşmüyordu	düş+Verb+Neg+Prog1+Past+A3sg
gülmemek	gül+Verb+Neg^DB+Noun+Inf1+A3sg+Pnon+Nom
yapmazsanız	yap+Verb+Neg+Aor+Cond+A2pl
anlayamadım	anla+Verb^DB+Verb+Able+Neg+Past+A1sg
görülmez	gör+Verb^DB+Verb+Pass+Neg+Aor+A3sg
açamadığı	aç+Verb^DB+Verb+Able+Neg^DB+Adj+PastPart+P3sg
söylemeyip	söyle+Verb+Neg^DB+Adverb+AfterDoingSo
getiremedi	getir+Verb^DB+Verb+Able+Neg+Past+A3sg
ağlamayın	ağla+Verb+Neg+Imp+A2pl
doyamıyormuş	doy+Verb^DB+Verb+Able+Neg+Prog1+Narr+A3sg
ayırmıyordu	ayır+Verb+Neg+Prog1+Past+A3sg
neşelenmem	neşe+Noun+A3sg+Pnon+Nom^DB+Verb+Acquire+Neg+Aor+A1sg
istemiyor	iste+Verb+Neg+Prog1+A3sg
dinlemediğimi	dinle+Verb+Neg^DB+Noun+PastPart+A3sg+P1sg+Acc
sevmediği	sev+Verb+Neg^DB+Adj+PastPart+P3sg
etmiyordum	et+Verb+Neg+Prog1+Past+A1sg
gelemez	gel+Verb^DB+Verb+Able+Neg+Aor+A3sg
kırılmadı	kır+Verb^DB+Verb+Pass+Neg+Past+A3sg
dokunmadı	doku+Verb^DB+Verb+Pass+Neg+Past+A3sg
beklemezler	bekle+Verb+Neg+Aor+A3pl
karşılaşmaman	karşılaş+Verb+Neg^DB+Noun+Inf2+A3sg+P2sg+Nom
gelmediğimi	gel+Verb+Neg^DB+Noun+PastPart+A3sg+P1sg+Acc
tanımıyorum	tanı+Verb+Neg+Prog1+A1sg
veremedim	ver+Verb^DB+Verb+Able+Neg+Past+A1sg
ulaşmayan	ulaş+Verb+Neg^DB+Adj+PresPart
olmayışı	ol+Verb+Neg^DB+Noun+Inf3+A3sg+P3sg+Nom
ulaşamayacağı	ulaş+Verb^DB+Verb+Able+Neg^DB+Noun+FutPart+A3sg+P3sg+Nom
vermiyordu	ver+Verb+Neg+Prog1+Past+A3sg
kazanamayan	kazan+Verb^DB+Verb+Able+Neg^DB+Adj+PresPart
anlayamadığı	anla+Verb^DB+Verb+Able+Neg^DB+Adj+PastPart+P3sg
çalmamış	çal+Verb+Neg+Narr+A3sg
söylenemezdi	söyle+Verb^DB+Verb+Pass^DB+Verb+Able+Neg+Aor+Past+A3sg
paketlememişti	paketle+Verb+Neg+Narr+Past+A3sg
önleyemezdi	önle+Verb^DB+Verb+Able+Neg+Aor+Past+A3sg
gitmese	git+Verb+Neg+Desr+A3sg
kaçmazdı	kaç+Verb+Neg+Aor+Past+A3sg
hastalanmamıştı	hastalan+Verb+Neg+Narr+Past+A3sg
çıkmama	çık+Verb+Neg^DB+Noun+Inf2+A3sg+Pnon+Nom
yetişmeyecek	yetiş+Verb+Neg+Fut+A3sg
inanamayacağı	inan+Verb^DB+Verb+Able+Neg^DB+Noun+FutPart+A3sg+P3sg+Nom
geçirmiyordu	geç+Verb^DB+Verb+Caus+Neg+Prog1+Past+A3sg
olamadığı	ol+Verb^DB+Verb+Able+Neg^DB+Adj+PastPart+P3sg
kestiremediği	kes+Verb^DB+Verb+Caus^DB+Verb+Able+Neg^DB+Adj+PastPart+P3sg
oynamıyordu	oyna+Verb+Neg+Prog1+Past+A3sg
yitirmemesi	yit+Verb^DB+Verb+Caus+Neg^DB+Noun+Inf2+A3sg+P3sg+Nom
kalkamayacağını	kalk+Verb^DB+Verb+Able+Neg^DB+Noun+FutPart+A3sg+P3sg+Acc
kalkmadı	kalk+Verb+Neg+Past+A3sg
yaralanmayacaktı	yarala+Verb^DB+Verb+Pass+Neg+Fut+Past+A3sg
görmezdi	gör+Verb+Neg+Aor+Past+A3sg
koruyamayacak	koru+Verb^DB+Verb+Able+Neg+Fut+A3sg
açmazlar	aç+Verb+Neg+Aor+A3pl
çıkamayacak	çık+Verb^DB+Verb+Able+Neg+Fut+A3sg
çekmeyen	çek+Verb+Neg^DB+Adj+PresPart
tutamadığı	tut+Verb^DB+Verb+Able+Neg^DB+Noun+PastPart+A3sg+P3sg+Nom
gelemeyeceğini	gel+Verb^DB+Verb+Able+Neg^DB+Noun+FutPart+A3sg+P3sg+Acc
gitmediğini	git+Verb+Neg^DB+Noun+PastPart+A3sg+P3sg+Acc
bilmiyoruz	bil+Verb+Neg+Prog1+A1pl
çıkmıyor	çık+Verb+Neg+Prog1+A3sg
edemezdik	et+Verb^DB+Verb+Able+Neg+Aor+Past+A1pl
kımıldamadı	kımılda+Verb+Neg+Past+A3sg
açıklayamıyorum	açıkla+Verb^DB+Verb+Able+Neg+Prog1+A1sg
gitmiyordu	git+Verb+Neg+Prog1+Past+A3sg
geçirmemişti	geç+Verb^DB+Verb+Caus+Neg+Narr+Past+A3sg
kalkamadığı	kalk+Verb^DB+Verb+Able+Neg^DB+Noun+PastPart+A3sg+P3sg+Nom
sokmadığı	sok+Verb+Neg^DB+Noun+PastPart+A3sg+P3sg+Nom
isteyemezdi	iste+Verb^DB+Verb+Able+Neg+Aor+Past+A3sg
düşünülemezdi	düşün+Verb^DB+Verb+Pass^DB+Verb+Able+Neg+Aor+Past+A3sg
geçemeyeceğim	geç+Verb^DB+Verb+Able+Neg+Fut+A1sg
gelmeyişinizin	gel+Verb+Neg^DB+Noun+Inf3+A3sg+P2pl+Gen
olamayacağı	ol+Verb^DB+Verb+Able+Neg^DB+Noun+FutPart+A3sg+P3sg+Nom
duymuyorum	duy+Verb+Neg+Prog1+A1sg
harcamama	harca+Verb+Neg^DB+Noun+Inf2+A3sg+Pnon+Nom
öğrenmemesi	öğren+Verb+Neg^DB+Noun+Inf2+A3sg+P3sg+Nom
olmamalıdır	ol+Verb+Neg+Neces+A3sg+Cop
kalkamadım	kalk+Verb^DB+Verb+Able+Neg+Past+A1sg
toparlayamadım	toparla+Verb^DB+Verb+Able+Neg+Past+A1sg
okumamış	oku+Verb+Neg+Narr+A3sg
aldırmıyordu	al+Verb^DB+Verb+Caus+Neg+Prog1+Past+A3sg
duyulmadı	duy+Verb^DB+Verb+Pass+Neg+Past+A3sg
anlamıyorlardı	anla+Verb+Neg+Prog1+A3pl+Past
benzememesinden	benze+Verb+Neg^DB+Noun+Inf2+A3sg+P3sg+Abl
güvenemiyordu	güven+Verb^DB+Verb+Able+Neg+Prog1+Past+A3sg
aldırmıyor	al+Verb^DB+Verb+Caus+Neg+Prog1+A3sg
yuvarlanmamak	yuvarla+Verb^DB+Verb+Pass+Neg^DB+Noun+Inf1+A3sg+Pnon+Nom
gözükmeyecek	gözük+Verb+Neg^DB+Adj+FutPart+Pnon
verememişçesine	ver+Verb^DB+Verb+Able+Neg+Narr+A3sg^DB+Adverb+AsIf
dinmemişti	de+Verb^DB+Verb+Pass+Neg+Narr+Past+A3sg
kaybetmeyen	kaybet+Verb+Neg^DB+Adj+PresPart
yaşayamazdım	yaşa+Verb^DB+Verb+Able+Neg+Aor+Past+A1sg
çalışamayacak	çalış+Verb^DB+Verb+Able+Neg^DB+Adj+FutPart+Pnon
zorlaştırmayın	zor+Adj^DB+Verb+Become^DB+Verb+Caus+Neg+Imp+A2pl
sevilmez	sev+Verb^DB+Verb+Pass+Neg+Aor+A3sg
duyulmaz	duy+Verb^DB+Verb+Pass+Neg+Aor+A3sg
gitmeyin	git+Verb+Neg+Imp+A2pl
başlamaz	başla+Verb+Neg+Aor+A3sg
anlayamıyorlardı	anla+Verb^DB+Verb+Able+Neg+Prog1+A3pl+Past
anlaşılmadığını	anlaş+Verb^DB+Verb+Pass+Neg^DB+Noun+PastPart+A3sg+P3sg+Acc
beceremiyordu	becer+Verb^DB+Verb+Able+Neg+Prog1+Past+A3sg
gidemediğinin	git+Verb^DB+Verb+Able+Neg^DB+Noun+PastPart+A3sg+P3sg+Gen
etmediği	et+Verb+Neg^DB+Adj+PastPart+P3sg
geçemeyecek	geç+Verb^DB+Verb+Able+Neg^DB+Adj+FutPart+Pnon
geçmedi	geç+Verb+Neg+Past+A3sg
vermeyecekti	ver+Verb+Neg+Fut+Past+A3sg
kalmamıştı	kal+Verb+Neg+Narr+Past+A3sg
hoşlanmamıştı	hoşlan+Verb+Neg+Narr+Past+A3sg
duyulmuyordu	duy+Verb^DB+Verb+Pass+Neg+Prog1+Past+A3sg
uygulanmaz	uygula+Verb^DB+Verb+Pass+Neg+Aor+A3sg
gitmemek	git+Verb+Neg^DB+Noun+Inf1+A3sg+Pnon+Nom
açılmadı	aç+Verb^DB+Verb+Pass+Neg+Past+A3sg
gelmeyeceği	gel+Verb+Neg^DB+Noun+FutPart+A3sg+P3sg+Nom
engelleyemeyerek	engelle+Verb^DB+Verb+Able+Neg^DB+Adverb+ByDoingSo
kaldıramamasına	kal+Verb^DB+Verb+Caus^DB+Verb+Able+Neg^DB+Noun+Inf2+A3sg+P3sg+Dat
sığamayacak	sığ+Verb^DB+Verb+Able+Neg^DB+Adj+FutPart+Pnon
aydınlanmamışken	aydınlan+Verb+Neg+Narr^DB+Adverb+While
göremedi	gör+Verb^DB+Verb+Able+Neg+Past+A3sg
tutamayıp	tut+Verb^DB+Verb+Able+Neg^DB+Adverb+AfterDoingSo
sürmediğini	sür+Verb+Neg^DB+Noun+PastPart+A3sg+P3sg+Acc
yenmez	yen+Verb+Neg+Aor+A3sg
dokunmayacağını	doku+Verb^DB+Verb+Pass+Neg^DB+Noun+FutPart+A3sg+P3sg+Acc
çekmiyordu	çek+Verb+Neg+Prog1+Past+A3sg
olamayan	ol+Verb^DB+Verb+Able+Neg^DB+Adj+PresPart
dokunmadığı	dokun+Verb+Neg^DB+Adj+PastPart+P3sg
dönmez	dön+Verb+Neg+Aor+A3sg
anlaşılmadığı	anlaş+Verb^DB+Verb+Pass+Neg^DB+Noun+PastPart+A3sg+P3sg+Nom
düşünmüyordu	düşün+Verb+Neg+Prog1+Past+A3sg
yemediğinde	ye+Verb+Neg^DB+Noun+PastPart+A3sg+P3sg+Loc
öğrenemiyorsa	öğren+Verb^DB+Verb+Able+Neg+Prog1+Cond+A3sg
almayan	al+Verb+Neg^DB+Adj+PresPart
bırakılamayacağından	bırak+Verb^DB+Verb+Pass^DB+Verb+Able+Neg^DB+Noun+FutPart+A3sg+P2sg+Abl
istememiş	iste+Verb+Neg+Narr+A3sg
anlatmayacağına	anla+Verb^DB+Verb+Caus+Neg^DB+Noun+FutPart+A3sg+P3sg+Dat
içmiyorlardı	iç+Verb+Neg+Prog1+A3pl+Past
vermeyince	ver+Verb+Neg^DB+Adverb+When
açılmıyordu	aç+Verb^DB+Verb+Pass+Neg+Prog1+Past+A3sg
kalmadığını	kal+Verb+Neg^DB+Noun+PastPart+A3sg+P3sg+Acc
sormamıştı	sor+Verb+Neg+Narr+Past+A3sg
yaşanamadılar	yaşa+Verb^DB+Verb+Pass^DB+Verb+Able+Neg+Past+A3pl
düşünülemeyecek	düşün+Verb^DB+Verb+Pass^DB+Verb+Able+Neg+Fut+A3sg
hoşlanmazlardı	hoşlan+Verb+Neg+Aor+A3pl+Past
veremiyor	ver+Verb^DB+Verb+Able+Neg+Prog1+A3sg
ilgilenmediği	ilgilen+Verb+Neg^DB+Noun+PastPart+A3sg+P3sg+Nom
dokunulmayan	doku+Verb^DB+Verb+Pass+Neg^DB+Adj+PresPart
harcanmamış	harca+Verb^DB+Verb+Pass+Neg+Narr+A3sg
dokunulmaması	doku+Verb^DB+Verb+Pass+Neg^DB+Noun+Inf2+A3sg+P3sg+Nom
edilemez	et+Verb^DB+Verb+Pass^DB+Verb+Able+Neg+Aor+A3sg
ezilmeyecekti	ez+Verb^DB+Verb+Pass+Neg+Fut+Past+A3sg
girmez	gir+Verb+Neg+Aor+A3sg
görmemesi	gör+Verb+Neg^DB+Noun+Inf2+A3sg+P3sg+Nom
girmeseydi	gir+Verb+Neg+Desr+Past+A3sg
olmayacaktı	ol+Verb+Neg+Fut+Past+A3sg
girmemekle	gir+Verb+Neg^DB+Noun+Inf1+A3sg+Pnon+Ins
dayanamayacağını	daya+Verb^DB+Verb+Pass^DB+Verb+Able+Neg^DB+Noun+FutPart+A3sg+P3sg+Acc
kaçmamak	kaç+Verb+Neg^DB+Noun+Inf1+A3sg+Pnon+Nom
göremeyecekti	gör+Verb^DB+Verb+Able+Neg+Fut+Past+A3sg
giremediler	gir+Verb^DB+Verb+Able+Neg+Past+A3pl
üzmemek	üz+Verb+Neg^DB+Noun+Inf1+A3sg+Pnon+Nom
yapamazdı	yap+Verb^DB+Verb+Able+Neg+Aor+Past+A3sg
edemezdi	et+Verb^DB+Verb+Able+Neg+Aor+Past+A3sg
bitiremezlerdi	bit+Verb^DB+Verb+Caus^DB+Verb+Able+Neg+Aor+A3pl+Past
bilmiyorlardı	bil+Verb+Neg+Prog1+A3pl+Past
anlamadığından	anla+Verb+Neg^DB+Noun+PastPart+A3sg+P3sg+Abl
sağlayamadığı	sağla+Verb^DB+Verb+Able+Neg^DB+Noun+PastPart+A3sg+P3sg+Nom
geçiremediği	geç+Verb^DB+Verb+Caus^DB+Verb+Able+Neg^DB+Adj+PastPart+P3sg
olmadıkça	ol+Verb+Neg^DB+Adverb+AsLongAs
anlayamazlar	anla+Verb^DB+Verb+Able+Neg+Aor+A3pl
olmadığınız	ol+Verb+Neg^DB+Adj+PastPart+P2pl
vermezdi	ver+Verb+Neg+Aor+Past+A3sg
olmasaydınız	ol+Verb+Neg+Desr+Past+A2pl
bilemediğim	bil+Verb^DB+Verb+Able+Neg^DB+Adj+PastPart+P1sg
çekilmez	çek+Verb^DB+Verb+Pass+Neg+Aor+A3sg
kızamıyorum	kız+Verb^DB+Verb+Able+Neg+Prog1+A1sg
dayanamayıp	dayan+Verb^DB+Verb+Able+Neg^DB+Adverb+AfterDoingSo
anlatmıyorsunuz	anla+Verb^DB+Verb+Caus+Neg+Prog1+A2pl
uyumamış	uyu+Verb+Neg+Narr+A3sg
anlayamamıştım	anla+Verb^DB+Verb+Able+Neg+Narr+Past+A1sg
uymuyor	uy+Verb+Neg+Prog1+A3sg
beğenmediğinizi	beğen+Verb+Neg^DB+Noun+PastPart+A3sg+P2pl+Acc
söyleyemezsiniz	söyle+Verb^DB+Verb+Able+Neg+Aor+A2pl
bulamıyordum	bul+Verb^DB+Verb+Able+Neg+Prog1+Past+A1sg
gelmeyişi	gel+Verb+Neg^DB+Noun+Inf3+A3sg+P3sg+Nom
kaçırmadım	kaç+Verb^DB+Verb+Caus+Neg+Past+A1sg
gelemezdi	gel+Verb^DB+Verb+Able+Neg+Aor+Past+A3sg
üzülmeyin	üz+Verb^DB+Verb+Pass+Neg+Imp+A2pl
olmayabilir	ol+Verb+Neg^DB+Verb+Able+Aor+A3sg
geçmemiştir	geç+Verb+Neg+Narr+A3sg+Cop
yapmaz	yap+Verb+Neg+Aor+A3sg
anlamamak	anla+Verb+Neg^DB+Noun+Inf1+A3sg+Pnon+Nom
olmuyorlar	ol+Verb+Neg+Prog1+A3pl
aktarmıyoruz	aktar+Verb+Neg+Prog1+A1pl
ulaşılmaz	ulaş+Verb^DB+Verb+Pass+Neg+Aor+A3sg
sarsılmaz	sars+Verb^DB+Verb+Pass+Neg+Aor+A3sg
söylenmemiş	söyle+Verb^DB+Verb+Pass+Neg+Narr+A3sg
kalmam	kal+Verb+Neg+Aor+A1sg
olmadığınızı	ol+Verb+Neg^DB+Noun+PastPart+A3sg+P2pl+Acc
dilemiyorum	dil+Verb^DB+Verb+Able+Neg+Prog1+A1sg
yanılmayız	yan+Verb^DB+Verb+Pass+Neg+Aor+A1pl
bilemezsin	bil+Verb^DB+Verb+Able+Neg+Aor+A2sg
duramaz	dur+Verb^DB+Verb+Able+Neg+Aor+A3sg
duymadığım	duy+Verb+Neg^DB+Adj+PastPart+P1sg
görüşmediniz	görüş+Verb+Neg+Past+A2pl
kaldıramayacak	kal+Verb^DB+Verb+Caus^DB+Verb+Able+Neg+Fut+A3sg
çalışmayın	çalış+Verb+Neg+Imp+A2pl
konuşamıyordu	konuş+Verb^DB+Verb+Able+Neg+Prog1+Past+A3sg
tanımamışım	tanı+Verb+Neg+Narr+A1sg
getiremezdim	getir+Verb^DB+Verb+Able+Neg+Aor+Past+A1sg
gelmeyeceksin	gel+Verb+Neg+Fut+A2sg
istemiyorsa	iste+Verb+Neg+Prog1+Cond+A3sg
yazmadı	yaz+Verb+Neg+Past+A3sg
almamıştır	al+Verb+Neg+Narr+A3sg+Cop
davranılmaz	davran+Verb^DB+Verb+Pass+Neg+Aor+A3sg
demeyin	de+Verb+Neg+Imp+A2pl
sevmiyorum	sev+Verb+Neg+Prog1+A1sg
davranmazdınız	davran+Verb+Neg+Aor+Past+A2pl
bırakmazdınız	bırak+Verb+Neg+Aor+Past+A2pl
oynamazdınız	oyna+Verb+Neg+Aor+Past+A2pl
geçiremediğini	geç+Verb^DB+Verb+Caus^DB+Verb+Able+Neg^DB+Noun+PastPart+A3sg+P3sg+Acc
zaptedemez	zaptet+Verb^DB+Verb+Able+Neg+Aor+A3sg
bastıramadım	bas+Verb^DB+Verb+Caus^DB+Verb+Able+Neg+Past+A1sg
yetmiyor	yet+Verb+Neg+Prog1+A3sg
duramayacağım	dur+Verb^DB+Verb+Able+Neg+Fut+A1sg
zaptedemiyordum	zaptet+Verb^DB+Verb+Able+Neg+Prog1+Past+A1sg
gerçekleşmeyeceğini	gerçek+Adj^DB+Verb+Become+Neg^DB+Noun+FutPart+A3sg+P3sg+Acc
yapamayacağım	yap+Verb^DB+Verb+Able+Neg+Fut+A1sg
beklemediğim	bekle+Verb+Neg^DB+Adj+PastPart+P1sg
incitemem	incit+Verb^DB+Verb+Able+Neg+Aor+A1sg
üzemem	üz+Verb^DB+Verb+Able+Neg+Aor+A1sg
oturmayacağım	otur+Verb+Neg+Fut+A1sg
duramam	dur+Verb^DB+Verb+Able+Neg+Aor+A1sg
göremeyeceksiniz	gör+Verb^DB+Verb+Able+Neg+Fut+A2pl
öğrenemeyecektiniz	öğren+Verb^DB+Verb+Able+Neg+Fut+Past+A2pl
tutamadım	tut+Verb^DB+Verb+Able+Neg+Past+A1sg
kovamazsınız	kov+Verb^DB+Verb+Able+Neg+Aor+A2pl
kovmuyorsunuz	kov+Verb+Neg+Prog1+A2pl
dayanamazdım	daya+Verb^DB+Verb+Pass^DB+Verb+Able+Neg+Aor+Past+A1sg
yaramıyordu	yara+Verb+Neg+Prog1+Past+A3sg
yapamadım	yap+Verb^DB+Verb+Able+Neg+Past+A1sg
uzlaşamadı	uzlaş+Verb^DB+Verb+Able+Neg+Past+A3sg
vermediler	ver+Verb+Neg+Past+A3pl
etkilemedi	etkile+Verb+Neg+Past+A3sg
direnmeme	diren+Verb+Neg^DB+Noun+Inf2+A3sg+Pnon+Nom
açmayacak	aç+Verb+Neg^DB+Adj+FutPart+Pnon
ölmez	öl+Verb+Neg+Aor+A3sg
duymamıştı	duy+Verb+Neg+Narr+Past+A3sg
yeşermemesi	yeşer+Verb+Neg^DB+Noun+Inf2+A3sg+P3sg+Nom
vazgeçmiyorlardı	vazgeç+Verb+Neg+Prog1+A3pl+Past
anlatmıyordu	anla+Verb^DB+Verb+Caus+Neg+Prog1+Past+A3sg
evlenmemiş	evlen+Verb+Neg^DB+Adj+NarrPart
olmamakla	ol+Verb+Neg^DB+Noun+Inf1+A3sg+Pnon+Ins
beslenmiyor	besle+Verb^DB+Verb+Pass+Neg+Prog1+A3sg
edemese	et+Verb^DB+Verb+Able+Neg+Desr+A3sg
çalışamadı	çalış+Verb^DB+Verb+Able+Neg+Past+A3sg
bulamıyordu	bula+Verb+Neg+Prog1+Past+A3sg
önemsemiyordu	önemse+Verb+Neg+Prog1+Past+A3sg
beklemesin	bekle+Verb+Neg+Imp+A3sg
alamadığınız	al+Verb^DB+Verb+Able+Neg^DB+Adj+PastPart+P2pl
bilemem	bil+Verb^DB+Verb+Able+Neg+Aor+A1sg
kabullenmemişti	kabullen+Verb+Neg+Narr+Past+A3sg
koyamamış	koy+Verb^DB+Verb+Able+Neg+Narr+A3sg
gelmemezlik	gel+Verb+Neg^DB+Noun+NotState+A3sg+Pnon+Nom
görmüyordu	gör+Verb+Neg+Prog1+Past+A3sg
vermedikçe	ver+Verb+Neg^DB+Adverb+AsLongAs
gelmeyişinden	gel+Verb+Neg^DB+Noun+Inf3+A3sg+P3sg+Abl
gönderemediğim	gönder+Verb^DB+Verb+Able+Neg^DB+Noun+PastPart+A3sg+P1sg+Nom
gitmeyen	git+Verb+Neg^DB+Adj+PresPart
taşımadığı	taşı+Verb+Neg^DB+Noun+PastPart+A3sg+P3sg+Nom
bitmemiş	bit+Verb+Neg+Narr+A3sg
ilerleyemiyor	ilerle+Verb^DB+Verb+Able+Neg+Prog1+A3sg
ilerlemem	ilerle+Verb+Neg+Aor+A1sg
önemsemez	önemse+Verb+Neg+Aor+A3sg
evlenmemeli	evlen+Verb+Neg+Neces+A3sg
veremediği	ver+Verb^DB+Verb+Able+Neg^DB+Noun+PastPart+A3sg+P3sg+Nom
görüştürülmemesi	görüş+Verb^DB+Verb+Caus^DB+Verb+Pass+Neg^DB+Noun+Inf2+A3sg+P3sg+Nom
çürütmeyin	çürü+Verb^DB+Verb+Caus+Neg+Imp+A2pl
çıkaramayacağınızdan	çık+Verb^DB+Verb+Caus^DB+Verb+Able+Neg^DB+Noun+FutPart+A3sg+P2pl+Abl
koyamıyorsanız	koy+Verb^DB+Verb+Able+Neg+Prog1+Cond+A2pl
göstermeyin	göster+Verb+Neg+Imp+A2pl
gerçekleştiremediği	gerçek+Adj^DB+Verb+Become^DB+Verb+Caus^DB+Verb+Able+Neg^DB+Adj+PastPart+P3sg
konmayacaktır	kon+Verb+Neg+Fut+A3sg+Cop
karıştırılmam	karış+Verb^DB+Verb+Caus^DB+Verb+Pass+Neg+Aor+A1sg
olmayacağım	ol+Verb+Neg+Fut+A1sg
bulunamayacaksınız	bul+Verb^DB+Verb+Pass^DB+Verb+Able+Neg+Fut+A2pl
çıkmamalı	çık+Verb+Neg+Neces+A3sg
görüştürülmeyenlerin	görüş+Verb^DB+Verb+Caus^DB+Verb+Pass+Neg^DB+Adj+PresPart^DB+Noun+Zero+A3pl+Pnon+Gen
gerçekleştiremeyeceği	gerçek+Adj^DB+Verb+Become^DB+Verb+Caus^DB+Verb+Able+Neg^DB+Noun+FutPart+A3sg+P3sg+Nom
bulamazsınız	bul+Verb^DB+Verb+Able+Neg+Aor+A2pl
kıpırdatamazsınız	kıpırda+Verb^DB+Verb+Caus^DB+Verb+Able+Neg+Aor+A2pl
yararlanamayacağı	yarar+Noun+A3sg+Pnon+Nom^DB+Verb+Acquire^DB+Verb+Able+Neg^DB+Noun+FutPart+A3sg+P3sg+Nom
erişilemiyor	eriş+Verb^DB+Verb+Pass^DB+Verb+Able+Neg+Prog1+A3sg
uyandırmayacağından	uyan+Verb^DB+Verb+Caus+Neg^DB+Noun+FutPart+A3sg+P2sg+Abl
göremiyorum	gör+Verb^DB+Verb+Able+Neg+Prog1+A1sg
katılamıyorum	kat+Verb^DB+Verb+Pass^DB+Verb+Able+Neg+Prog1+A1sg
olmamasını	ol+Verb+Neg^DB+Noun+Inf2+A3sg+P3sg+Acc
erişilemez	eriş+Verb^DB+Verb+Pass^DB+Verb+Able+Neg+Aor+A3sg
olmayabilirsiniz	ol+Verb+Neg^DB+Verb+Able+Aor+A2pl
bağlanamıyorum	bağla+Verb^DB+Verb+Pass^DB+Verb+Able+Neg+Prog1+A1sg
bağlanamıyor	bağla+Verb^DB+Verb+Pass^DB+Verb+Able+Neg+Prog1+A3sg
yapamazsınız	yap+Verb^DB+Verb+Able+Neg+Aor+A2pl
çalıştırılamayacağını	çalış+Verb^DB+Verb+Caus^DB+Verb+Pass^DB+Verb+Able+Neg^DB+Noun+FutPart+A3sg+P3sg+Acc
görüntülenmez	görüntüle+Verb^DB+Verb+Pass+Neg+Aor+A3sg
kullanılamamasına	kullan+Verb^DB+Verb+Pass^DB+Verb+Able+Neg^DB+Noun+Inf2+A3sg+P3sg+Dat
ayarlamaz	ayarla+Verb+Neg+Aor+A3sg
vermez	ver+Verb+Neg+Aor+A3sg
görüntüleyemeyebilirsiniz	görüntüle+Verb^DB+Verb+Able+Neg^DB+Verb+Able+Aor+A2pl
vermemesidir	ver+Verb+Neg^DB+Noun+Inf2+A3sg+P3sg+Nom^DB+Verb+Zero+Pres+A3sg+Cop
değiştiremezsiniz	değiş+Verb^DB+Verb+Caus^DB+Verb+Able+Neg+Aor+A2pl
ayarlanamaz	ayarla+Verb^DB+Verb+Pass^DB+Verb+Able+Neg+Aor+A3sg
planlamadığınız	planla+Verb+Neg^DB+Adj+PastPart+P2pl
içermediğinde	içer+Verb+Neg^DB+Noun+PastPart+A3sg+P3sg+Loc
istemiyorsanız	iste+Verb+Neg+Prog1+Cond+A2pl
gerekmez	gerek+Verb+Neg+Aor+A3sg
istemediğiniz	iste+Verb+Neg^DB+Adj+PastPart+P2pl
görüntülenmiyorsa	görüntüle+Verb^DB+Verb+Pass+Neg+Prog1+Cond+A3sg
kaldırılmaz	kal+Verb^DB+Verb+Caus^DB+Verb+Pass+Neg+Aor+A3sg
kullanılamaz	kullan+Verb^DB+Verb+Pass^DB+Verb+Able+Neg+Aor+A3sg
sağlamıyorsa	sağla+Verb+Neg+Prog1+Cond+A3sg
karşılamıyorsa	karşıla+Verb+Neg+Prog1+Cond+A3sg
görüntülemez	görüntüle+Verb+Neg+Aor+A3sg
görüntüleyemezsiniz	görüntüle+Verb^DB+Verb+Able+Neg+Aor+A2pl
bağlanmamış	bağla+Verb^DB+Verb+Pass+Neg+Narr+A3sg
kullanılamıyor	kullan+Verb^DB+Verb+Pass^DB+Verb+Able+Neg+Prog1+A3sg
göremezseniz	gör+Verb^DB+Verb+Able+Neg+Aor+Cond+A2pl
etkilemez	etkile+Verb+Neg^DB+Adj+AorPart
kullanılamıyorsa	kullan+Verb^DB+Verb+Pass^DB+Verb+Able+Neg+Prog1+Cond+A3sg
kullanamazsınız	kullan+Verb^DB+Verb+Able+Neg+Aor+A2pl
görüntülenmemesi	görüntüle+Verb^DB+Verb+Pass+Neg^DB+Noun+Inf2+A3sg+P3sg+Nom
gösterilmeyen	göster+Verb^DB+Verb+Pass+Neg^DB+Adj+PresPart
tamamlayamazsınız	tamamla+Verb^DB+Verb+Able+Neg+Aor+A2pl
işaretlemediyseniz	işaretle+Verb+Neg+Past+Cond+A2pl
eklenmez	ekle+Verb^DB+Verb+Pass+Neg+Aor+A3sg
koymamanız	koy+Verb+Neg^DB+Noun+Inf2+A3sg+P2pl+Nom
seçmeyin	seç+Verb+Neg+Imp+A2pl
seçilmediği	seç+Verb^DB+Verb+Pass+Neg^DB+Noun+PastPart+A3sg+P3sg+Nom
vermeyen	ver+Verb+Neg^DB+Adj+PresPart
sıfırlamayın	sıfırla+Verb+Neg+Imp+A2pl
verilmez	ver+Verb^DB+Verb+Pass+Neg+Aor+A3sg
bırakılmadığından	bırak+Verb^DB+Verb+Pass+Neg^DB+Noun+PastPart+A3sg+P3sg+Abl
silmez	sil+Verb+Neg+Aor+A3sg
devralmaz	devral+Verb+Neg+Aor+A3sg
kurtarılamaz	kurtar+Verb^DB+Verb+Pass^DB+Verb+Able+Neg+Aor+A3sg
silinemez	sil+Verb^DB+Verb+Pass^DB+Verb+Able+Neg+Aor+A3sg
atanmazsa	ata+Verb^DB+Verb+Pass+Neg+Aor+Cond+A3sg
erişemiyorum	eriş+Verb^DB+Verb+Able+Neg+Prog1+A1sg
açmamanız	aç+Verb+Neg^DB+Noun+Inf2+A3sg+P2pl+Nom
gerektirmediği	gerek+Verb^DB+Verb+Caus+Neg^DB+Noun+PastPart+A3sg+P3sg+Nom
gerçekleşmeyen	gerçek+Adj^DB+Verb+Become+Neg^DB+Adj+PresPart
denenmez	dene+Verb^DB+Verb+Pass+Neg+Aor+A3sg
ayrılmamış	ayır+Verb^DB+Verb+Pass+Neg^DB+Adj+NarrPart
genişletemezsiniz	genişle+Verb^DB+Verb+Caus^DB+Verb+Able+Neg+Aor+A2pl
yapılmayacaksa	yap+Verb^DB+Verb+Pass+Neg+Fut+Cond+A3sg
bağlanmayacaksa	bağla+Verb^DB+Verb+Pass+Neg+Fut+Cond+A3sg
onarılmayacaksa	onar+Verb^DB+Verb+Pass+Neg+Fut+Cond+A3sg
takılmayacaksa	tak+Verb^DB+Verb+Pass+Neg+Fut+Cond+A3sg
silmeyin	sil+Verb+Neg+Imp+A2pl
erişemezsiniz	eriş+Verb^DB+Verb+Able+Neg+Aor+A2pl
belirtilmezse	belir+Verb^DB+Verb+Caus^DB+Verb+Pass+Neg+Aor+Cond+A3sg
biçimlendirmedikçe	biçim+Noun+A3sg+Pnon+Nom^DB+Verb+Acquire^DB+Verb+Caus+Neg^DB+Adverb+AsLongAs
içermiyorsa	içer+Verb+Neg+Prog1+Cond+A3sg
bağlanmaz	bağla+Verb^DB+Verb+Pass+Neg+Aor+A3sg
atanmaz	ata+Verb^DB+Verb+Pass+Neg+Aor+A3sg
duymuyorsanız	duy+Verb+Neg+Prog1+Cond+A2pl
içermez	içer+Verb+Neg+Aor+A3sg
ayarlayamazsınız	ayarla+Verb^DB+Verb+Able+Neg+Aor+A2pl
verilmediği	ver+Verb^DB+Verb+Pass+Neg^DB+Noun+PastPart+A3sg+P3sg+Nom
engellenmediği	engelle+Verb^DB+Verb+Pass+Neg^DB+Noun+PastPart+A3sg+P3sg+Nom
kullanamıyorsa	kullan+Verb^DB+Verb+Able+Neg+Prog1+Cond+A3sg
kurulmaz	kur+Verb^DB+Verb+Pass+Neg+Aor+A3sg
kaydolamıyorum	kaydol+Verb^DB+Verb+Able+Neg+Prog1+A1sg
kullanamıyorum	kullan+Verb^DB+Verb+Able+Neg+Prog1+A1sg
kullanılamıyordur	kullan+Verb^DB+Verb+Pass^DB+Verb+Able+Neg+Prog1+A3sg+Cop
alınamamasından	al+Verb^DB+Verb+Pass^DB+Verb+Able+Neg^DB+Noun+Inf2+A3sg+P3sg+Abl
seçemezsiniz	seç+Verb^DB+Verb+Able+Neg+Aor+A2pl
bağlanamaz	bağla+Verb^DB+Verb+Pass^DB+Verb+Able+Neg+Aor+A3sg
kaldıramazsınız	kal+Verb^DB+Verb+Caus^DB+Verb+Able+Neg+Aor+A2pl
kullanmayın	kullan+Verb+Neg+Imp+A2pl
çıkamaz	çık+Verb^DB+Verb+Able+Neg+Aor+A3sg
yenileyemez	yenile+Verb^DB+Verb+Able+Neg+Aor+A3sg
deneyemezsiniz	dene+Verb^DB+Verb+Able+Neg+Aor+A2pl
olmadığında	ol+Verb+Neg^DB+Noun+PastPart+A3sg+P3sg+Loc
görüntülenmeyeceğini	görüntüle+Verb^DB+Verb+Pass+Neg^DB+Noun+FutPart+A3sg+P3sg+Acc
kullanılmadığından	kullan+Verb^DB+Verb+Pass+Neg^DB+Noun+PastPart+A3sg+P2sg+Abl
etkinleştirilmemiş	etkin+Adj^DB+Verb+Become^DB+Verb+Caus^DB+Verb+Pass+Neg+Narr+A3sg
görüntülenmiyor	görüntüle+Verb^DB+Verb+Pass+Neg+Prog1+A3sg
oluşamaz	oluş+Verb^DB+Verb+Able+Neg+Aor+A3sg
silinmemiş	sil+Verb^DB+Verb+Pass+Neg+Narr+A3sg
gerektirmez	gerek+Verb^DB+Verb+Caus+Neg+Aor+A3sg
bulunmasa	bulun+Verb+Neg+Desr+A3sg
içermediğine	içer+Verb+Neg^DB+Noun+PastPart+A3sg+P3sg+Dat
değiştiremeyeceğini	değiş+Verb^DB+Verb+Caus^DB+Verb+Able+Neg^DB+Noun+FutPart+A3sg+P3sg+Acc
bırakılmadığını	bırak+Verb^DB+Verb+Pass+Neg^DB+Noun+PastPart+A3sg+P3sg+Acc
bırakılamaz	bırak+Verb^DB+Verb+Pass^DB+Verb+Able+Neg+Aor+A3sg
açamayacağı	aç+Verb^DB+Verb+Able+Neg^DB+Noun+FutPart+A3sg+P3sg+Nom
kullanılmaz	kullan+Verb^DB+Verb+Pass+Neg+Aor+A3sg
silinmez	sil+Verb^DB+Verb+Pass+Neg+Aor+A3sg
duymayacağınızdan	duy+Verb+Neg^DB+Noun+FutPart+A3sg+P2pl+Abl
eklenemez	ekle+Verb^DB+Verb+Pass^DB+Verb+Able+Neg+Aor+A3sg
kapsamadığı	kapsa+Verb+Neg^DB+Noun+PastPart+A3sg+P3sg+Nom
önerilmez	öner+Verb^DB+Verb+Pass+Neg+Aor+A3sg
istenmeyen	iste+Verb^DB+Verb+Pass+Neg^DB+Adj+PresPart
vermediği	ver+Verb+Neg^DB+Adj+PastPart+P3sg
açmadıysanız	aç+Verb+Neg+Past+Cond+A2pl
etkinleştirmezseniz	etkin+Adj^DB+Verb+Become^DB+Verb+Caus+Neg+Aor+Cond+A2pl
denetlenmez	denetle+Verb^DB+Verb+Pass+Neg^DB+Adj+AorPart
engellemez	engelle+Verb+Neg+Aor+A3sg
görmüyorsanız	gör+Verb+Neg+Prog1+Cond+A2pl
açılmıyorsa	aç+Verb^DB+Verb+Pass+Neg+Prog1+Cond+A3sg
alınmaz	alın+Verb+Neg+Aor+A3sg
düzeltemezsiniz	düzel+Verb^DB+Verb+Caus^DB+Verb+Able+Neg+Aor+A2pl
görüntülenmezse	görüntüle+Verb^DB+Verb+Pass+Neg+Aor+Cond+A3sg
tanımayabilir	tanı+Verb+Neg^DB+Verb+Able+Aor+A3sg
ekleyemiyorum	ekle+Verb^DB+Verb+Able+Neg+Prog1+A1sg
yapmamanız	yap+Verb+Neg^DB+Noun+Inf2+A3sg+P2pl+Nom
gönderilmemiş	gönder+Verb^DB+Verb+Pass+Neg+Narr+A3sg
gideremezsiniz	gider+Verb^DB+Verb+Able+Neg+Aor+A2pl
çözülemeyen	çöz+Verb^DB+Verb+Pass^DB+Verb+Able+Neg^DB+Adj+PresPart
görüntüleyemez	görüntüle+Verb^DB+Verb+Able+Neg+Aor+A3sg
düzenleyemezsiniz	düzenle+Verb^DB+Verb+Able+Neg+Aor+A2pl
yükleyemeyebilir	yükle+Verb^DB+Verb+Able+Neg^DB+Verb+Able+Aor+A3sg
görüntüleyemeyebilir	görüntüle+Verb^DB+Verb+Able+Neg^DB+Verb+Able+Aor+A3sg
olmadığınızdan	ol+Verb+Neg^DB+Noun+PastPart+A3sg+P2pl+Abl
verilmeyen	ver+Verb^DB+Verb+Pass+Neg^DB+Adj+PresPart
içermeyecektir	içer+Verb+Neg+Fut+A3sg+Cop
okuyamaz	oku+Verb^DB+Verb+Able+Neg+Aor+A3sg
değiştirilemez	değiş+Verb^DB+Verb+Caus^DB+Verb+Pass^DB+Verb+Able+Neg+Aor+A3sg
tanıyamazsa	tanı+Verb^DB+Verb+Able+Neg+Aor+Cond+A3sg
taşıyamazsınız	taşı+Verb^DB+Verb+Able+Neg+Aor+A2pl
içermeyen	içer+Verb+Neg^DB+Adj+PresPart
yükseltmediğinize	yüksel+Verb^DB+Verb+Caus+Neg^DB+Noun+PastPart+A3sg+P2pl+Dat
ekleyemez	ekle+Verb^DB+Verb+Able+Neg+Aor+A3sg
kullanmayarak	kullan+Verb+Neg^DB+Adverb+ByDoingSo
zımbalayamayacağınızı	zımbala+Verb^DB+Verb+Able+Neg^DB+Noun+FutPart+A3sg+P2pl+Acc
edemiyorsanız	et+Verb^DB+Verb+Able+Neg+Prog1+Cond+A2pl
karşılaşmazsa	karşılaş+Verb+Neg+Aor+Cond+A3sg
yararlanamazsınız	yarar+Noun+A3sg+Pnon+Nom^DB+Verb+Acquire^DB+Verb+Able+Neg+Aor+A2pl
seçmediğim	seç+Verb+Neg^DB+Adj+PastPart+P1sg
bulunmuyorsa	bulun+Verb+Neg+Prog1+Cond+A3sg
taşınamaz	taşı+Verb^DB+Verb+Pass^DB+Verb+Able+Neg+Aor+A3sg
kullanılamadığını	kullan+Verb^DB+Verb+Pass^DB+Verb+Able+Neg^DB+Noun+PastPart+A3sg+P3sg+Acc
görüntülenmemesini	görüntüle+Verb^DB+Verb+Pass+Neg^DB+Noun+Inf2+A3sg+P3sg+Acc
kapatmam	kapa+Verb^DB+Verb+Caus+Neg+Aor+A1sg
sonlandırmam	son+Noun+A3sg+Pnon+Nom^DB+Verb+Acquire^DB+Verb+Caus+Neg+Aor+A1sg
sormaması	sor+Verb+Neg^DB+Noun+Inf2+A3sg+P3sg+Nom
biçimlendirilemez	biçim+Noun+A3sg+Pnon+Nom^DB+Verb+Acquire^DB+Verb+Caus^DB+Verb+Pass^DB+Verb+Able+Neg+Aor+A3sg
kaldırmam	kal+Verb^DB+Verb+Caus+Neg+Aor+A1sg
gerekmediğinden	gerek+Verb+Neg^DB+Noun+PastPart+A3sg+P3sg+Abl
olmayanları	ol+Verb+Neg^DB+Adj+PresPart^DB+Noun+Zero+A3pl+Pnon+Acc
etkilenmez	etkile+Verb^DB+Verb+Pass+Neg+Aor+A3sg
yaramazsa	yara+Verb+Neg+Aor+Cond+A3sg
bulunmamaktaydı	bulun+Verb+Neg+Prog2+Past+A3sg
geçmemesini	geç+Verb+Neg^DB+Noun+Inf2+A3sg+P3sg+Acc
kalmadığı	kal+Verb+Neg^DB+Noun+PastPart+A3sg+P3sg+Nom
kullanılamayacaktır	kullan+Verb^DB+Verb+Pass^DB+Verb+Able+Neg+Fut+A3sg+Cop
giremez	gir+Verb^DB+Verb+Able+Neg+Aor+A3sg
seçilmedikçe	seç+Verb^DB+Verb+Pass+Neg^DB+Adverb+AsLongAs
gerekmeyen	gerek+Verb+Neg^DB+Adj+PresPart
silemezsiniz	sil+Verb^DB+Verb+Able+Neg+Aor+A2pl
değilseniz	değil+Verb+Neg+Cond+A2pl
kalmaz	kal+Verb+Neg+Aor+A3sg
yüklenmedi	yükle+Verb^DB+Verb+Pass+Neg+Past+A3sg
bulunmuyor	bulun+Verb+Neg+Prog1+A3sg
değiştirilmez	değiş+Verb^DB+Verb+Caus^DB+Verb+Pass+Neg+Aor+A3sg
yapılmaz	yap+Verb^DB+Verb+Pass+Neg+Aor+A3sg
yazdırılamayan	yaz+Verb^DB+Verb+Caus^DB+Verb+Pass^DB+Verb+Able+Neg^DB+Adj+PresPart
sıkmayın	sık+Verb+Neg+Imp+A2pl
kavramayın	kavra+Verb+Neg+Imp+A2pl
kaybolmaması	kaybol+Verb+Neg^DB+Noun+Inf2+A3sg+P3sg+Nom
görmemesini	gör+Verb+Neg^DB+Noun+Inf2+A3sg+P3sg+Acc
kalmazsınız	kal+Verb+Neg+Aor+A2pl
kaydettirilmemiştir	kaydet+Verb^DB+Verb+Caus^DB+Verb+Pass+Neg+Narr+A3sg+Cop
belirlenemez	belirle+Verb^DB+Verb+Pass^DB+Verb+Able+Neg+Aor+A3sg
eklemeyin	ekle+Verb+Neg+Imp+A2pl
yapılandıramadı	yapı+Noun+A3sg+Pnon+Nom^DB+Verb+Acquire^DB+Verb+Caus^DB+Verb+Able+Neg+Past+A3sg
çalışmıyor	çalış+Verb+Neg+Prog1+A3sg
algılayamıyor	algıla+Verb^DB+Verb+Able+Neg+Prog1+A3sg
ayarlayamıyor	ayarla+Verb^DB+Verb+Able+Neg+Prog1+A3sg
değiştiremiyorsunuz	değiş+Verb^DB+Verb+Caus^DB+Verb+Able+Neg+Prog1+A2pl
erişemiyorsunuz	eriş+Verb^DB+Verb+Able+Neg+Prog1+A2pl
desteklenmediğini	destekle+Verb^DB+Verb+Pass+Neg^DB+Noun+PastPart+A3sg+P3sg+Acc
gerektirmediğine	gerek+Verb^DB+Verb+Caus+Neg^DB+Noun+PastPart+A3sg+P3sg+Dat
yayınlanmayacağını	yayınla+Verb^DB+Verb+Pass+Neg^DB+Noun+FutPart+A3sg+P3sg+Acc
bulunamazsa	bulun+Verb^DB+Verb+Able+Neg+Aor+Cond+A3sg
bulunmayıp	bul+Verb^DB+Verb+Pass+Neg^DB+Adverb+AfterDoingSo
sınamadığınız	sın+Verb^DB+Verb+Able+Neg^DB+Adj+PastPart+P2pl
değiştirmemelisiniz	değiş+Verb^DB+Verb+Caus+Neg+Neces+A2pl
otomatikleştiremediğiniz	otomatik+Adj^DB+Verb+Become^DB+Verb+Caus^DB+Verb+Able+Neg^DB+Adj+PastPart+P2pl
yönetemediğinizde	yönet+Verb^DB+Verb+Able+Neg^DB+Noun+PastPart+A3sg+P2pl+Loc
görmeme	gör+Verb+Neg^DB+Noun+Inf2+A3sg+Pnon+Nom
gönderilemiyor	gönder+Verb^DB+Verb+Pass^DB+Verb+Able+Neg+Prog1+A3sg
görünmemesi	görün+Verb+Neg^DB+Noun+Inf2+A3sg+P3sg+Nom
edilmeyeceği	et+Verb^DB+Verb+Pass+Neg^DB+Noun+FutPart+A3sg+P3sg+Nom
değiştirmeyin	değiş+Verb^DB+Verb+Caus+Neg+Imp+A2pl
değiştirmez	değiş+Verb^DB+Verb+Caus+Neg+Aor+A3sg
ayarlanmadığını	ayarla+Verb^DB+Verb+Pass+Neg^DB+Noun+PastPart+A3sg+P3sg+Acc
bulunamıyor	bulun+Verb^DB+Verb+Able+Neg+Prog1+A3sg
görülemiyor	gör+Verb^DB+Verb+Pass^DB+Verb+Able+Neg+Prog1+A3sg
göremiyorsanız	gör+Verb^DB+Verb+Able+Neg+Prog1+Cond+A2pl
göstermiyor	göster+Verb+Neg+Prog1+A3sg
olmamışsa	ol+Verb+Neg+Narr+Cond+A3sg
bulunamadı	bulun+Verb^DB+Verb+Able+Neg+Past+A3sg
kaydedemiyorsanız	kaydet+Verb^DB+Verb+Able+Neg+Prog1+Cond+A2pl
çalışmamasına	çalış+Verb+Neg^DB+Noun+Inf2+A3sg+P3sg+Dat
çakışmayacağından	çakış+Verb+Neg^DB+Noun+FutPart+A3sg+P2sg+Abl
kullanılmaması	kullan+Verb^DB+Verb+Pass+Neg^DB+Noun+Inf2+A3sg+P3sg+Nom
desteklemiyor	destekle+Verb+Neg+Prog1+A3sg
sökemez	sök+Verb^DB+Verb+Able+Neg+Aor+A3sg
çıkaramazsınız	çık+Verb^DB+Verb+Caus^DB+Verb+Able+Neg+Aor+A2pl
yapılmadığını	yap+Verb^DB+Verb+Pass+Neg^DB+Noun+PastPart+A3sg+P3sg+Acc
bağlanmazsa	bağla+Verb^DB+Verb+Pass+Neg+Aor+Cond+A3sg
çevirmemek	çevir+Verb+Neg^DB+Noun+Inf1+A3sg+Pnon+Nom
gerekmediği	gerek+Verb+Neg^DB+Noun+PastPart+A3sg+P3sg+Nom
olmayanlar	ol+Verb+Neg^DB+Adj+PresPart^DB+Noun+Zero+A3pl+Pnon+Nom
göremezsiniz	gör+Verb^DB+Verb+Able+Neg+Aor+A2pl
desteklenmez	destekle+Verb^DB+Verb+Pass+Neg+Aor+A3sg
atanamaz	ata+Verb^DB+Verb+Pass^DB+Verb+Able+Neg+Aor+A3sg
saptanamaz	sapta+Verb^DB+Verb+Pass^DB+Verb+Able+Neg+Aor+A3sg
açmadığından	aç+Verb+Neg^DB+Noun+PastPart+A3sg+P3sg+Abl
yansıtmaz	yansı+Verb^DB+Verb+Caus+Neg+Aor+A3sg
kaybolmamasını	kaybol+Verb+Neg^DB+Noun+Inf2+A3sg+P3sg+Acc
güncelleştirmem	güncel+Adj^DB+Verb+Become^DB+Verb+Caus+Neg+Aor+A1sg
kullanmadığınız	kullan+Verb+Neg^DB+Adj+PastPart+P2pl
seçmediğiniz	seç+Verb+Neg^DB+Adj+PastPart+P2pl
önermez	öner+Verb+Neg+Aor+A3sg
açamıyorsanız	aç+Verb^DB+Verb+Able+Neg+Prog1+Cond+A2pl
açamazsınız	aç+Verb^DB+Verb+Able+Neg+Aor+A2pl
göstermez	göster+Verb+Neg+Aor+A3sg
çalıştıramazsınız	çalış+Verb^DB+Verb+Caus^DB+Verb+Able+Neg+Aor+A2pl
sınırlanmamışsa	sınırla+Verb^DB+Verb+Pass+Neg+Narr+Cond+A3sg
yapılandırılmayacaktır	yapı+Noun+A3sg+Pnon+Nom^DB+Verb+Acquire^DB+Verb+Caus^DB+Verb+Pass+Neg+Fut+A3sg+Cop
kaldıramaz	kaldır+Verb^DB+Verb+Able+Neg+Aor+A3sg
değiştiremez	değiş+Verb^DB+Verb+Caus^DB+Verb+Able+Neg+Aor+A3sg
oluşturamaz	oluş+Verb^DB+Verb+Caus^DB+Verb+Able+Neg+Aor+A3sg
kapatamaz	kapa+Verb^DB+Verb+Caus^DB+Verb+Able+Neg+Aor+A3sg
çalıştırmamalısınız	çalış+Verb^DB+Verb+Caus+Neg+Neces+A2pl
şifrelenmediğini	şifrele+Verb^DB+Verb+Pass+Neg^DB+Noun+PastPart+A3sg+P3sg+Acc
kopyalamamasını	kopyala+Verb+Neg^DB+Noun+Inf2+A3sg+P3sg+Acc
listelenmediğini	listele+Verb^DB+Verb+Pass+Neg^DB+Noun+PastPart+A3sg+P3sg+Acc
gerekmiyorsa	gerek+Verb+Neg+Prog1+Cond+A3sg
silmezsiniz	sil+Verb+Neg+Aor+A2pl
bulamıyor	bul+Verb^DB+Verb+Able+Neg+Prog1+A3sg
görüntülenemeyebileceğini	görüntüle+Verb^DB+Verb+Pass^DB+Verb+Able+Neg^DB+Verb+Able^DB+Noun+FutPart+A3sg+P3sg+Acc
sağlanmadıysa	sağla+Verb^DB+Verb+Pass+Neg+Past+Cond+A3sg
kopyalanmaz	kopyala+Verb^DB+Verb+Pass+Neg+Aor+A3sg
kaldıramadım	kal+Verb^DB+Verb+Caus^DB+Verb+Able+Neg+Past+A1sg
kaldırmadığımı	kal+Verb^DB+Verb+Caus+Neg^DB+Noun+PastPart+A3sg+P1sg+Acc
yapmadıysanız	yap+Verb+Neg+Past+Cond+A2pl
ödemezsiniz	öde+Verb+Neg+Aor+A2pl
karışmaz	karış+Verb+Neg+Aor+A3sg
yüklenmezse	yükle+Verb^DB+Verb+Pass+Neg+Aor+Cond+A3sg
yüklenemezse	yükle+Verb^DB+Verb+Pass^DB+Verb+Able+Neg+Aor+Cond+A3sg
gerçekleştirilemez	gerçek+Adj^DB+Verb+Become^DB+Verb+Caus^DB+Verb+Pass^DB+Verb+Able+Neg+Aor+A3sg
çalışmadığını	çalış+Verb+Neg^DB+Noun+PastPart+A3sg+P3sg+Acc
görünmüyorsa	görün+Verb+Neg+Prog1+Cond+A3sg
sıralayamaz	sırala+Verb^DB+Verb+Able+Neg+Aor+A3sg
uygulayamazsınız	uygula+Verb^DB+Verb+Able+Neg+Aor+A2pl
doğrulanmadığını	doğrula+Verb^DB+Verb+Pass+Neg^DB+Noun+PastPart+A3sg+P3sg+Acc
sağlamaz	sağla+Verb+Neg+Aor+A3sg
desteklemez	destekle+Verb+Neg+Aor+A3sg
tanınmayan	tanı+Verb^DB+Verb+Pass+Neg^DB+Adj+PresPart
oluşturamazsınız	oluş+Verb^DB+Verb+Caus^DB+Verb+Able+Neg+Aor+A2pl
sıfırlayamaz	sıfırla+Verb^DB+Verb+Able+Neg+Aor+A3sg
açamaz	aç+Verb^DB+Verb+Able+Neg+Aor+A3sg
vermediğini	ver+Verb+Neg^DB+Noun+PastPart+A3sg+P3sg+Acc
yönetmiyorsanız	yönet+Verb+Neg+Prog1+Cond+A2pl
kurtaramazsınız	kurtar+Verb^DB+Verb+Able+Neg+Aor+A2pl
dönüştürülemeyen	dönüş+Verb^DB+Verb+Caus^DB+Verb+Pass^DB+Verb+Able+Neg^DB+Adj+PresPart
görüntülenmediyse	görüntüle+Verb^DB+Verb+Pass+Neg+Past+Cond+A3sg
bağlanamazsa	bağla+Verb^DB+Verb+Pass^DB+Verb+Able+Neg+Aor+Cond+A3sg
sağlanmamış	sağla+Verb^DB+Verb+Pass+Neg+Narr+A3sg
yerleştirilmez	yerleş+Verb^DB+Verb+Caus^DB+Verb+Pass+Neg+Aor+A3sg
desteklemeyen	destekle+Verb+Neg^DB+Adj+PresPart
seçilmediyse	seç+Verb^DB+Verb+Pass+Neg+Past+Cond+A3sg
kaldırmayın	kal+Verb^DB+Verb+Caus+Neg+Imp+A2pl
bulunmadığında	bul+Verb^DB+Verb+Pass+Neg^DB+Noun+PastPart+A3sg+P3sg+Loc
ekleyemezsiniz	ekle+Verb^DB+Verb+Able+Neg+Aor+A2pl
yapılmamalıdır	yap+Verb^DB+Verb+Pass+Neg+Neces+A3sg+Cop
paylaştıramaz	paylaş+Verb^DB+Verb+Caus^DB+Verb+Able+Neg+Aor+A3sg
olmayacağından	ol+Verb+Neg^DB+Noun+FutPart+A3sg+P2sg+Abl
artmadığını	art+Verb+Neg^DB+Noun+PastPart+A3sg+P3sg+Acc
eşleşmeyen	eş+Noun+A3sg+Pnon+Nom^DB+Verb+Become+Neg^DB+Adj+PresPart
yapılandırılmamış	yapı+Noun+A3sg+Pnon+Nom^DB+Verb+Acquire^DB+Verb+Caus^DB+Verb+Pass+Neg+Narr+A3sg
kopyalanmamışsa	kopyala+Verb^DB+Verb+Pass+Neg+Narr+Cond+A3sg
göremez	gör+Verb^DB+Verb+Able+Neg+Aor+A3sg
atayamazsınız	ata+Verb^DB+Verb+Able+Neg+Aor+A2pl
gizlenemez	gizle+Verb^DB+Verb+Pass^DB+Verb+Able+Neg+Aor+A3sg
yazılmaz	yaz+Verb^DB+Verb+Pass+Neg+Aor+A3sg
kaydedilmez	kaydet+Verb^DB+Verb+Pass+Neg+Aor+A3sg
edilmemesi	et+Verb^DB+Verb+Pass+Neg^DB+Noun+Inf2+A3sg+P3sg+Nom
çözülemeyecek	çöz+Verb^DB+Verb+Pass^DB+Verb+Able+Neg^DB+Adj+FutPart+Pnon
yönetilemiyor	yönet+Verb^DB+Verb+Pass^DB+Verb+Able+Neg+Prog1+A3sg
içermemelidir	içer+Verb+Neg+Neces+A3sg+Cop
yapamamasına	yap+Verb^DB+Verb+Able+Neg^DB+Noun+Inf2+A3sg+P3sg+Dat
doğrulanmamış	doğrula+Verb^DB+Verb+Pass+Neg^DB+Adj+NarrPart
uymayan	uy+Verb+Neg^DB+Adj+PresPart
kullanılamayabilir	kullan+Verb^DB+Verb+Pass^DB+Verb+Able+Neg^DB+Verb+Able+Aor+A3sg
şifrelenemez	şifrele+Verb^DB+Verb+Pass^DB+Verb+Able+Neg+Aor+A3sg
yapmıyorsa	yap+Verb+Neg+Prog1+Cond+A3sg
desteklemiyorsa	destekle+Verb+Neg+Prog1+Cond+A3sg
kaydedilmemiş	kaydet+Verb^DB+Verb+Pass+Neg^DB+Adj+NarrPart
gideremeyeceksiniz	gider+Verb^DB+Verb+Able+Neg+Fut+A2pl
dolduramazsınız	dol+Verb^DB+Verb+Caus^DB+Verb+Able+Neg+Aor+A2pl
belirtilmemişse	belir+Verb^DB+Verb+Caus^DB+Verb+Pass+Neg+Narr+Cond+A3sg
gerçekleşmedi	gerçek+Noun+A3sg+Pnon+Nom^DB+Verb+Become+Neg+Past+A3sg
sıralanmaz	sırala+Verb^DB+Verb+Pass+Neg+Aor+A3sg
yapamaz	yap+Verb^DB+Verb+Able+Neg+Aor+A3sg
dolmamışsa	dol+Verb+Neg+Narr+Cond+A3sg
karşılayamadığı	karşıla+Verb^DB+Verb+Able+Neg^DB+Adj+PastPart+P3sg
çözülemez	çöz+Verb^DB+Verb+Pass^DB+Verb+Able+Neg+Aor+A3sg
şifrelenmemiş	şifrele+Verb^DB+Verb+Pass+Neg^DB+Adj+NarrPart
gerektirmeyebilir	gerek+Verb^DB+Verb+Caus+Neg^DB+Verb+Able+Aor+A3sg
alınamaz	al+Verb^DB+Verb+Pass^DB+Verb+Able+Neg+Aor+A3sg
etkinleştirilmeyeceğini	etkin+Adj^DB+Verb+Become^DB+Verb+Caus^DB+Verb+Pass+Neg^DB+Noun+FutPart+A3sg+P3sg+Acc
düzenleyemiyorum	düzenle+Verb^DB+Verb+Able+Neg+Prog1+A1sg
bulunamadığını	bul+Verb^DB+Verb+Pass^DB+Verb+Able+Neg^DB+Noun+PastPart+A3sg+P3sg+Acc
seçemiyorum	seç+Verb^DB+Verb+Able+Neg+Prog1+A1sg
bulunmadığına	bulun+Verb+Neg^DB+Noun+PastPart+A3sg+P3sg+Dat
gösterilemeyecek	göster+Verb^DB+Verb+Pass^DB+Verb+Able+Neg^DB+Adj+FutPart+Pnon
yapıştıramıyorum	yapış+Verb^DB+Verb+Caus^DB+Verb+Able+Neg+Prog1+A1sg
yapıştırılamadı	yapış+Verb^DB+Verb+Caus^DB+Verb+Pass^DB+Verb+Able+Neg+Past+A3sg
bozmayacağından	boz+Verb+Neg^DB+Noun+FutPart+A3sg+P2sg+Abl
eklemiyor	ekle+Verb+Neg+Prog1+A3sg
görmüyorum	gör+Verb+Neg+Prog1+A1sg
edilmediğini	et+Verb^DB+Verb+Pass+Neg^DB+Noun+PastPart+A3sg+P3sg+Acc
yenilenemiyor	yenile+Verb^DB+Verb+Pass^DB+Verb+Able+Neg+Prog1+A3sg
kaydedemiyorum	kaydet+Verb^DB+Verb+Able+Neg+Prog1+A1sg
yenilemez	ye+Verb^DB+Verb+Pass^DB+Verb+Able+Neg+Aor+A3sg
edilmemektedir	et+Verb^DB+Verb+Pass+Neg+Prog2+A3sg+Cop
kullanamadığı	kullan+Verb^DB+Verb+Able+Neg^DB+Adj+PastPart+P3sg
erişemiyor	eriş+Verb^DB+Verb+Able+Neg+Prog1+A3sg
bozulmaz	boz+Verb^DB+Verb+Pass+Neg+Aor+A3sg
okuyamıyordur	oku+Verb^DB+Verb+Able+Neg+Prog1+A3sg+Cop
gerçekleştirmez	gerçek+Noun+A3sg+Pnon+Nom^DB+Verb+Become^DB+Verb+Caus+Neg+Aor+A3sg
döndürülmez	dön+Verb^DB+Verb+Caus^DB+Verb+Pass+Neg+Aor+A3sg
istemezseniz	iste+Verb+Neg+Aor+Cond+A2pl
içermemesi	içer+Verb+Neg^DB+Noun+Inf2+A3sg+P3sg+Nom
duymadığınızda	duy+Verb+Neg^DB+Noun+PastPart+A3sg+P2pl+Loc
ayarlanmamışsa	ayarla+Verb^DB+Verb+Pass+Neg+Narr+Cond+A3sg
bulmaz	bul+Verb+Neg+Aor+A3sg
seçmezseniz	seç+Verb+Neg+Aor+Cond+A2pl
eklemedikçe	ekle+Verb+Neg^DB+Adverb+AsLongAs
kaldırmadıkça	kal+Verb^DB+Verb+Caus+Neg^DB+Adverb+AsLongAs
yüklenmediği	yükle+Verb^DB+Verb+Pass+Neg^DB+Noun+PastPart+A3sg+P3sg+Nom
düşünmediğiniz	düşün+Verb+Neg^DB+Adj+PastPart+P2pl
çözümlenmemiş	çözüm+Noun+A3sg+Pnon+Nom^DB+Verb+Acquire+Neg+Narr+A3sg
temizleyemezsiniz	temizle+Verb^DB+Verb+Able+Neg+Aor+A2pl
taşıyamaz	taşı+Verb^DB+Verb+Able+Neg+Aor+A3sg
kesemezsiniz	kes+Verb^DB+Verb+Able+Neg+Aor+A2pl
doğrulanamazsa	doğrula+Verb^DB+Verb+Pass^DB+Verb+Able+Neg+Aor+Cond+A3sg
doğrulanamayan	doğrula+Verb^DB+Verb+Pass^DB+Verb+Able+Neg^DB+Adj+PresPart
kaydırılmaz	kay+Verb^DB+Verb+Caus^DB+Verb+Pass+Neg+Aor+A3sg
içerilmez	içer+Verb^DB+Verb+Pass+Neg+Aor+A3sg
sıralayamazsınız	sırala+Verb^DB+Verb+Able+Neg+Aor+A2pl
almıyor	al+Verb+Neg+Prog1+A3sg
değerlendiremiyorsa	değer+Noun+A3sg+Pnon+Nom^DB+Verb+Acquire^DB+Verb+Caus^DB+Verb+Able+Neg+Prog1+Cond+A3sg
gerçekleşmezse	gerçek+Adj^DB+Verb+Become+Neg+Aor+Cond+A3sg
biçimlendirilmediğini	biçim+Noun+A3sg+Pnon+Nom^DB+Verb+Acquire^DB+Verb+Caus^DB+Verb+Pass+Neg^DB+Noun+PastPart+A3sg+P3sg+Acc
eklenmediğinden	ekle+Verb^DB+Verb+Pass+Neg^DB+Noun+PastPart+A3sg+P3sg+Abl
takılmamış	tak+Verb^DB+Verb+Pass+Neg+Narr+A3sg
gitmediğiniz	git+Verb+Neg^DB+Adj+PastPart+P2pl
görüntülenmeyebilir	görüntüle+Verb^DB+Verb+Pass+Neg^DB+Verb+Able+Aor+A3sg
kapatmaz	kapa+Verb^DB+Verb+Caus+Neg+Aor+A3sg
sıkıştırılmamış	sıkış+Verb^DB+Verb+Caus^DB+Verb+Pass+Neg^DB+Adj+NarrPart
etkinleştirilmedikçe	etkin+Adj^DB+Verb+Become^DB+Verb+Caus^DB+Verb+Pass+Neg^DB+Adverb+AsLongAs
sağlanmayan	sağla+Verb^DB+Verb+Pass+Neg^DB+Adj+PresPart
eklenmemiştir	ekle+Verb^DB+Verb+Pass+Neg+Narr+A3sg+Cop
kullanmadıkça	kullan+Verb+Neg^DB+Adverb+AsLongAs
açmam	aç+Verb+Neg+Aor+A1sg
yüklemediyseniz	yükle+Verb+Neg+Past+Cond+A2pl
takmadıysanız	tak+Verb+Neg+Past+Cond+A2pl
çözmezse	çöz+Verb+Neg+Aor+Cond+A3sg
yaramadı	yara+Verb+Neg+Past+A3sg
gideremezse	gider+Verb^DB+Verb+Able+Neg+Aor+Cond+A3sg
çalışmadığından	çalış+Verb+Neg^DB+Noun+PastPart+A3sg+P3sg+Abl
kopyalayamıyorum	kopyala+Verb^DB+Verb+Able+Neg+Prog1+A1sg
değiştiremiyorum	değiş+Verb^DB+Verb+Caus^DB+Verb+Able+Neg+Prog1+A1sg
göremeyecektir	gör+Verb^DB+Verb+Able+Neg+Fut+A3sg+Cop
olmasanız	ol+Verb+Neg+Desr+A2pl
desteklemediğini	destekle+Verb+Neg^DB+Noun+PastPart+A3sg+P3sg+Acc
gidermezse	gider+Verb+Neg+Aor+Cond+A3sg
oluşturulamaz	oluş+Verb^DB+Verb+Caus^DB+Verb+Pass^DB+Verb+Able+Neg+Aor+A3sg
gruplandırılamaz	grup+Noun+A3sg+Pnon+Nom^DB+Verb+Acquire^DB+Verb+Caus^DB+Verb+Pass^DB+Verb+Able+Neg+Aor+A3sg
içermemesini	içer+Verb+Neg^DB+Noun+Inf2+A3sg+P3sg+Acc
bulmayacağını	bul+Verb+Neg^DB+Noun+FutPart+A3sg+P3sg+Acc
çalışmıyorsa	çalış+Verb+Neg+Prog1+Cond+A3sg
kullanmayacaksanız	kullan+Verb+Neg+Fut+Cond+A2pl
olmamaktadır	ol+Verb+Neg+Prog2+A3sg+Cop
kullanmıyorsanız	kullan+Verb+Neg+Prog1+Cond+A2pl
olmuyorsa	ol+Verb+Neg+Prog1+Cond+A3sg
atmayın	at+Verb+Neg+Imp+A2pl
iyileştirmezse	iyi+Adj^DB+Verb+Become^DB+Verb+Caus+Neg+Aor+Cond+A3sg
taşıyamıyorum	taşı+Verb^DB+Verb+Able+Neg+Prog1+A1sg
izleyemezler	izle+Verb^DB+Verb+Able+Neg+Aor+A3pl
dönüştüremez	dönüş+Verb^DB+Verb+Caus^DB+Verb+Able+Neg+Aor+A3sg
görüntülemeyebilirsiniz	görüntüle+Verb+Neg^DB+Verb+Able+Aor+A2pl
sığmayan	sığ+Verb+Neg^DB+Adj+PresPart
yazdırılmaz	yaz+Verb^DB+Verb+Caus^DB+Verb+Pass+Neg+Aor+A3sg
görüntülenemez	görüntüle+Verb^DB+Verb+Pass^DB+Verb+Able+Neg+Aor+A3sg
görünmeyebilir	görün+Verb+Neg^DB+Verb+Able+Aor+A3sg
yüklenmez	yükle+Verb^DB+Verb+Pass+Neg+Aor+A3sg
koyamıyorum	koy+Verb^DB+Verb+Able+Neg+Prog1+A1sg
aktarılmamış	aktar+Verb^DB+Verb+Pass+Neg+Narr+A3sg
bilmeme	bil+Verb+Neg^DB+Noun+Inf2+A3sg+Pnon+Nom
istemediğinizde	iste+Verb+Neg^DB+Noun+PastPart+A3sg+P2pl+Loc
amaçlamıyorsanız	amaçla+Verb+Neg+Prog1+Cond+A2pl
silmemeniz	sil+Verb+Neg^DB+Noun+Inf2+A3sg+P2pl+Nom
istemediğim	iste+Verb+Neg^DB+Noun+PastPart+A3sg+P1sg+Nom
vermemenizi	ver+Verb+Neg^DB+Noun+Inf2+A3sg+P2pl+Acc
okunmamış	oku+Verb^DB+Verb+Pass+Neg+Narr+A3sg
eşleşmezse	eş+Noun+A3sg+Pnon+Nom^DB+Verb+Become+Neg+Aor+Cond+A3sg
ilişkilendirilmez	ilişki+Noun+A3sg+Pnon+Nom^DB+Verb+Acquire^DB+Verb+Caus^DB+Verb+Pass+Neg+Aor+A3sg
yüklenmemesini	yükle+Verb^DB+Verb+Pass+Neg^DB+Noun+Inf2+A3sg+P3sg+Acc
istemeyeceğiniz	iste+Verb+Neg^DB+Noun+FutPart+A3sg+P2pl+Nom
değiştirmezsiniz	değiş+Verb^DB+Verb+Caus+Neg+Aor+A2pl
belirleyemezsiniz	belirle+Verb^DB+Verb+Able+Neg+Aor+A2pl
yansıtılmaz	yansı+Verb^DB+Verb+Caus^DB+Verb+Pass+Neg+Aor+A3sg
kullanmayacak	kullan+Verb+Neg+Fut+A3sg
vermemek	ver+Verb+Neg^DB+Noun+Inf1+A3sg+Pnon+Nom
hizalanmazsa	hizala+Verb^DB+Verb+Pass+Neg+Aor+Cond+A3sg
çalışmaz	çalış+Verb+Neg+Aor+A3sg
bükmeyin	bük+Verb+Neg+Imp+A2pl
yüklenmediyse	yükle+Verb^DB+Verb+Pass+Neg+Past+Cond+A3sg
başlayamıyorsanız	başla+Verb^DB+Verb+Able+Neg+Prog1+Cond+A2pl
başlamamaya	başla+Verb+Neg^DB+Noun+Inf2+A3sg+Pnon+Dat
vermeyin	ver+Verb+Neg+Imp+A2pl
değiştirmemem	değiş+Verb^DB+Verb+Caus+Neg^DB+Noun+Inf2+A3sg+P1sg+Nom
eşitlenmez	eşitle+Verb^DB+Verb+Pass+Neg+Aor+A3sg
yerleştiremezseniz	yerleş+Verb^DB+Verb+Caus^DB+Verb+Able+Neg+Aor+Cond+A2pl
desteklenmiyor	destekle+Verb^DB+Verb+Pass+Neg+Prog1+A3sg
saklanmaz	sakla+Verb^DB+Verb+Pass+Neg+Aor+A3sg
görüntülemeyebilir	görüntüle+Verb+Neg^DB+Verb+Able+Aor+A3sg
tıklatmadığınız	tıkla+Verb^DB+Verb+Caus+Neg^DB+Adj+PastPart+P2pl
depolanmaz	depola+Verb^DB+Verb+Pass+Neg+Aor+A3sg
açmaz	aç+Verb+Neg+Aor+A3sg
girmezseniz	gir+Verb+Neg+Aor+Cond+A2pl
gönderemiyorum	gönder+Verb^DB+Verb+Able+Neg+Prog1+A1sg
duymaması	duy+Verb+Neg^DB+Noun+Inf2+A3sg+P3sg+Nom
görüntülenmeyen	görüntüle+Verb^DB+Verb+Pass+Neg^DB+Adj+PresPart
göremeyebilirsiniz	gör+Verb^DB+Verb+Able+Neg^DB+Verb+Able+Aor+A2pl
değiştirmemeye	değiş+Verb^DB+Verb+Caus+Neg^DB+Noun+Inf2+A3sg+Pnon+Dat
karşılamıyor	karşıla+Verb+Neg+Prog1+A3sg
depolanmazlar	depola+Verb^DB+Verb+Pass+Neg+Aor+A3pl
dönüştürülemeyebilir	dönüş+Verb^DB+Verb+Caus^DB+Verb+Pass^DB+Verb+Able+Neg^DB+Verb+Able+Aor+A3sg
depolayamazsınız	depola+Verb^DB+Verb+Able+Neg+Aor+A2pl
bozmadığından	boz+Verb+Neg^DB+Noun+PastPart+A3sg+P3sg+Abl
içermediğinden	içer+Verb+Neg^DB+Noun+PastPart+A3sg+P3sg+Abl
kaydedilemiyorsa	kaydet+Verb^DB+Verb+Pass^DB+Verb+Able+Neg+Prog1+Cond+A3sg
sürükleyemezsiniz	sürükle+Verb^DB+Verb+Able+Neg+Aor+A2pl
gizlenmemesi	gizle+Verb^DB+Verb+Pass+Neg^DB+Noun+Inf2+A3sg+P3sg+Nom
görüntülenmemiştir	görüntüle+Verb^DB+Verb+Pass+Neg+Narr+A3sg+Cop
değiştirilmediğini	değiş+Verb^DB+Verb+Caus^DB+Verb+Pass+Neg^DB+Noun+PastPart+A3sg+P3sg+Acc
bilmiyorsanız	bil+Verb+Neg+Prog1+Cond+A2pl
çevrilemeyen	çevir+Verb^DB+Verb+Pass^DB+Verb+Able+Neg^DB+Adj+PresPart
etmediğini	et+Verb+Neg^DB+Noun+PastPart+A3sg+P3sg+Acc
çakışmaması	çakış+Verb+Neg^DB+Noun+Inf2+A3sg+P3sg+Nom
boyutlandırılamaz	boyut+Noun+A3sg+Pnon+Nom^DB+Verb+Acquire^DB+Verb+Caus^DB+Verb+Pass^DB+Verb+Able+Neg+Aor+A3sg
hatırlamıyorsanız	hatırla+Verb+Neg+Prog1+Cond+A2pl
etkilenmezler	etkile+Verb^DB+Verb+Pass+Neg+Aor+A3pl
edilmeyen	et+Verb^DB+Verb+Pass+Neg^DB+Adj+PresPart
tanımıyorsanız	tanı+Verb+Neg+Prog1+Cond+A2pl
kullanmadıysanız	kullan+Verb+Neg+Past+Cond+A2pl
bulamazsa	bul+Verb^DB+Verb+Able+Neg+Aor+Cond+A3sg
çalışmazsa	çalış+Verb+Neg+Aor+Cond+A3sg
alınmadığından	al+Verb^DB+Verb+Pass+Neg^DB+Noun+PastPart+A3sg+P3sg+Abl
görmeyen	gör+Verb+Neg^DB+Adj+PresPart
olmayanların	ol+Verb+Neg^DB+Adj+PresPart^DB+Noun+Zero+A3pl+Pnon+Gen
etkinleştirilmediyse	etkin+Adj^DB+Verb+Become^DB+Verb+Caus^DB+Verb+Pass+Neg+Past+Cond+A3sg
başlatmaz	başla+Verb^DB+Verb+Caus+Neg+Aor+A3sg
vermiyorsa	ver+Verb+Neg+Prog1+Cond+A3sg
zamanlanmamışsa	zamanla+Verb^DB+Verb+Pass+Neg+Narr+Cond+A3sg
adlandıramazsınız	ad+Noun+A3sg+Pnon+Nom^DB+Verb+Acquire^DB+Verb+Caus^DB+Verb+Able+Neg+Aor+A2pl
yüklenmemesi	yükle+Verb^DB+Verb+Pass+Neg^DB+Noun+Inf2+A3sg+P3sg+Nom
başlatılmaz	başla+Verb^DB+Verb+Caus^DB+Verb+Pass+Neg+Aor+A3sg
veremezler	ver+Verb^DB+Verb+Able+Neg+Aor+A3pl
algılanmaz	algıla+Verb^DB+Verb+Pass+Neg+Aor+A3sg
belirtmedikçe	belir+Verb^DB+Verb+Caus+Neg^DB+Adverb+AsLongAs
başlatamaz	başla+Verb^DB+Verb+Caus^DB+Verb+Able+Neg+Aor+A3sg
kapatmayın	kapa+Verb^DB+Verb+Caus+Neg+Imp+A2pl
başlatılmamasına	başla+Verb^DB+Verb+Caus^DB+Verb+Pass+Neg^DB+Noun+Inf2+A3sg+P3sg+Dat
başlatılmazsa	başla+Verb^DB+Verb+Caus^DB+Verb+Pass+Neg+Aor+Cond+A3sg
kullanamaz	kullan+Verb^DB+Verb+Able+Neg+Aor+A3sg
yapılandıramazsınız	yapı+Noun+A3sg+Pnon+Nom^DB+Verb+Acquire^DB+Verb+Caus^DB+Verb+Able+Neg+Aor+A2pl
çalıştırılmamışsa	çalış+Verb^DB+Verb+Caus^DB+Verb+Pass+Neg+Narr+Cond+A3sg
seçilmezse	seç+Verb^DB+Verb+Pass+Neg+Aor+Cond+A3sg
döndürülmezse	dön+Verb^DB+Verb+Caus^DB+Verb+Pass+Neg+Aor+Cond+A3sg
azaltmadığını	azal+Verb^DB+Verb+Caus+Neg^DB+Noun+PastPart+A3sg+P3sg+Acc
girmeyen	gir+Verb+Neg^DB+Adj+PresPart
kapatılmadığını	kapa+Verb^DB+Verb+Caus^DB+Verb+Pass+Neg^DB+Noun+PastPart+A3sg+P3sg+Acc
çözümlenemeyen	çözümle+Verb^DB+Verb+Pass^DB+Verb+Able+Neg^DB+Adj+PresPart
başlamadığını	başla+Verb+Neg^DB+Noun+PastPart+A3sg+P3sg+Acc
paylaşılmadı	paylaş+Verb^DB+Verb+Pass+Neg+Past+A3sg
çözümleyemiyor	çözümle+Verb^DB+Verb+Able+Neg+Prog1+A3sg
karşılayamayan	karşıla+Verb^DB+Verb+Able+Neg^DB+Adj+PresPart
bırakmayın	bırak+Verb+Neg+Imp+A2pl
doğrulamaz	doğrula+Verb+Neg+Aor+A3sg
gerçekleştirilmezse	gerçek+Adj^DB+Verb+Become^DB+Verb+Caus^DB+Verb+Pass+Neg+Aor+Cond+A3sg
kullanılmadığı	kullan+Verb^DB+Verb+Pass+Neg^DB+Noun+PastPart+A3sg+P3sg+Nom
yapılandırılmayan	yapı+Noun+A3sg+Pnon+Nom^DB+Verb+Acquire^DB+Verb+Caus^DB+Verb+Pass+Neg^DB+Adj+PresPart
açmadığı	aç+Verb+Neg^DB+Adj+PastPart+P3sg
çalışmayacağını	çalış+Verb+Neg^DB+Noun+FutPart+A3sg+P3sg+Acc
alamaz	al+Verb^DB+Verb+Able+Neg+Aor+A3sg
biçimlendiremeyeceklerini	biçim+Noun+A3sg+Pnon+Nom^DB+Verb+Acquire^DB+Verb+Caus^DB+Verb+Able+Neg^DB+Noun+FutPart+A3pl+P3pl+Acc
bağlanamayacaklarını	bağla+Verb^DB+Verb+Pass^DB+Verb+Able+Neg^DB+Noun+FutPart+A3pl+P3pl+Acc
iletilemiyor	ilet+Verb^DB+Verb+Pass^DB+Verb+Able+Neg+Prog1+A3sg
gönderilemez	gönder+Verb^DB+Verb+Pass^DB+Verb+Able+Neg+Aor+A3sg
almayacağını	al+Verb+Neg^DB+Noun+FutPart+A3sg+P3sg+Acc
sıralanmamış	sırala+Verb^DB+Verb+Pass+Neg+Narr+A3sg
gönderemez	gönder+Verb^DB+Verb+Able+Neg+Aor+A3sg
oluşturulmayacağını	oluş+Verb^DB+Verb+Caus^DB+Verb+Pass+Neg^DB+Noun+FutPart+A3sg+P3sg+Acc
uygulamaz	uygula+Verb+Neg+Aor+A3sg
işleyemeyeceği	işle+Verb^DB+Verb+Able+Neg^DB+Adj+FutPart+P3sg
taşıyamazlar	taşı+Verb^DB+Verb+Able+Neg+Aor+A3pl
ulaşmadığını	ulaş+Verb+Neg^DB+Noun+PastPart+A3sg+P3sg+Acc
alınmadığını	alın+Verb+Neg^DB+Noun+PastPart+A3sg+P3sg+Acc
çalıştırmamanız	çalış+Verb^DB+Verb+Caus+Neg^DB+Noun+Inf2+A3sg+P2pl+Nom
kullanmaz	kullan+Verb+Neg+Aor+A3sg
denenmeyeceğinden	dene+Verb^DB+Verb+Pass+Neg^DB+Noun+FutPart+A3sg+P2sg+Abl
eklenmedikçe	ekle+Verb^DB+Verb+Pass+Neg^DB+Adverb+AsLongAs
görünmezler	görün+Verb+Neg+Aor+A3pl
zorlayamaz	zorla+Verb^DB+Verb+Able+Neg+Aor+A3sg
engellemezseniz	engelle+Verb+Neg+Aor+Cond+A2pl
korunmaz	koru+Verb^DB+Verb+Pass+Neg+Aor+A3sg
bağlanamadığında	bağla+Verb^DB+Verb+Pass^DB+Verb+Able+Neg^DB+Noun+PastPart+A3sg+P3sg+Loc
taşınamayan	taşı+Verb^DB+Verb+Pass^DB+Verb+Able+Neg^DB+Adj+PresPart
daraltamazsınız	daral+Verb^DB+Verb+Caus^DB+Verb+Able+Neg+Aor+A2pl
tamamlanmamıştır	tamamla+Verb^DB+Verb+Pass+Neg+Narr+A3sg+Cop
çalışmadığında	çalış+Verb+Neg^DB+Noun+PastPart+A3sg+P3sg+Loc
gerçekleştirmediği	gerçek+Adj^DB+Verb+Become^DB+Verb+Caus+Neg^DB+Adj+PastPart+P3sg
gerekmediğini	gerek+Verb+Neg^DB+Noun+PastPart+A3sg+P3sg+Acc
uygulanamaz	uygula+Verb^DB+Verb+Pass^DB+Verb+Able+Neg+Aor+A3sg
etkinleştirilmez	etkin+Adj^DB+Verb+Become^DB+Verb+Caus^DB+Verb+Pass+Neg+Aor+A3sg
bırakılmaz	bırak+Verb^DB+Verb+Pass+Neg+Aor+A3sg
başlatılamaz	başla+Verb^DB+Verb+Caus^DB+Verb+Pass^DB+Verb+Able+Neg+Aor+A3sg
kaydedilmediğini	kaydet+Verb^DB+Verb+Pass+Neg^DB+Noun+PastPart+A3sg+P3sg+Acc
kullanılmadığını	kullan+Verb^DB+Verb+Pass+Neg^DB+Noun+PastPart+A3sg+P3sg+Acc
kullanmadığını	kullan+Verb+Neg^DB+Noun+PastPart+A3sg+P3sg+Acc
yönetemez	yönet+Verb^DB+Verb+Able+Neg+Aor+A3sg
silemezler	sil+Verb^DB+Verb+Able+Neg+Aor+A3pl
istemeyebilirsiniz	iste+Verb+Neg^DB+Verb+Able+Aor+A2pl
olmamasıdır	ol+Verb+Neg^DB+Noun+Inf2+A3sg+P3sg+Nom^DB+Verb+Zero+Pres+A3sg+Cop
eşitlenmemişse	eşitle+Verb^DB+Verb+Pass+Neg+Narr+Cond+A3sg
gerçekleştiremeyeceğini	gerçek+Adj^DB+Verb+Become^DB+Verb+Caus^DB+Verb+Able+Neg^DB+Noun+FutPart+A3sg+P3sg+Acc
düzenlenemez	düzenle+Verb^DB+Verb+Pass^DB+Verb+Able+Neg+Aor+A3sg
çözülmez	çöz+Verb^DB+Verb+Pass+Neg+Aor+A3sg
görmeyeceklerinden	gör+Verb+Neg^DB+Noun+FutPart+A3pl+P3sg+Abl
değiştirilmediğine	değiş+Verb^DB+Verb+Caus^DB+Verb+Pass+Neg^DB+Noun+PastPart+A3sg+P3sg+Dat
edememe	et+Verb^DB+Verb+Able+Neg^DB+Noun+Inf2+A3sg+Pnon+Nom
değerlendirilmez	değer+Noun+A3sg+Pnon+Nom^DB+Verb+Acquire^DB+Verb+Caus^DB+Verb+Pass+Neg+Aor+A3sg
alınamamasına	al+Verb^DB+Verb+Pass^DB+Verb+Able+Neg^DB+Noun+Inf2+A3sg+P3sg+Dat
anlamamakta	anla+Verb+Neg^DB+Noun+Inf1+A3sg+Pnon+Loc
etmemektedir	et+Verb+Neg+Prog2+A3sg+Cop
kullanılmayacaksa	kullan+Verb^DB+Verb+Pass+Neg+Fut+Cond+A3sg
kullanılmamalıdır	kullan+Verb^DB+Verb+Pass+Neg+Neces+A3sg+Cop
düzenlenemediğinden	düzenle+Verb^DB+Verb+Pass^DB+Verb+Able+Neg^DB+Noun+PastPart+A3sg+P3sg+Abl
tanımlayamazsınız	tanımla+Verb^DB+Verb+Able+Neg+Aor+A2pl
sunmaz	sun+Verb+Neg+Aor+A3sg
üretmez	üre+Verb^DB+Verb+Caus+Neg+Aor+A3sg
kullanmayacağını	kullan+Verb+Neg^DB+Noun+FutPart+A3sg+P3sg+Acc
kaydetmeyeceğini	kaydet+Verb+Neg^DB+Noun+FutPart+A3sg+P3sg+Acc
belirtmeyen	belir+Verb^DB+Verb+Caus+Neg^DB+Adj+PresPart
korumadıklarına	koru+Verb+Neg^DB+Noun+PastPart+A3sg+P3pl+Dat
içermeyeceğini	içer+Verb+Neg^DB+Noun+FutPart+A3sg+P3sg+Acc
çıkarılmamalıdır	çık+Verb^DB+Verb+Caus^DB+Verb+Pass+Neg+Neces+A3sg+Cop
içermeyebilir	içer+Verb+Neg^DB+Verb+Able+Aor+A3sg
bitirmem	bit+Verb^DB+Verb+Caus+Neg+Aor+A1sg
başlatmam	başla+Verb^DB+Verb+Caus+Neg+Aor+A1sg
çözemiyorum	çöz+Verb^DB+Verb+Able+Neg+Prog1+A1sg
bulamazsanız	bul+Verb^DB+Verb+Able+Neg+Aor+Cond+A2pl
kaldırmamanız	kal+Verb^DB+Verb+Caus+Neg^DB+Noun+Inf2+A3sg+P2pl+Nom
istemedikleri	iste+Verb+Neg^DB+Noun+PastPart+A3pl+P3pl+Nom
kıramadı	kır+Verb^DB+Verb+Able+Neg+Past+A3sg
gelmeyen	gel+Verb+Neg^DB+Adj+PresPart
bakamıyoruz	bak+Verb^DB+Verb+Able+Neg+Prog1+A1pl
uğraşmıyor	uğraş+Verb+Neg+Prog1+A3sg
düşünmüyor	düşün+Verb+Neg+Prog1+A3sg
unutmuyordu	unut+Verb+Neg+Prog1+Past+A3sg
taslamıyor	tasla+Verb+Neg+Prog1+A3sg
gitmeyecektik	git+Verb+Neg+Fut+Past+A1pl
çalmamaları	çal+Verb+Neg^DB+Noun+Inf2+A3pl+P3sg+Nom
yazamadım	yaz+Verb^DB+Verb+Able+Neg+Past+A1sg
bulunmaması	bulun+Verb+Neg^DB+Noun+Inf2+A3sg+P3sg+Nom
kurtulamadığı	kurtul+Verb^DB+Verb+Able+Neg^DB+Adj+PastPart+P3sg
alamazsan	al+Verb^DB+Verb+Able+Neg+Aor+Cond+A2sg
bırakmıyor	bırak+Verb+Neg+Prog1+A3sg
alınamadı	alın+Verb^DB+Verb+Able+Neg+Past+A3sg
alamayınca	al+Verb^DB+Verb+Able+Neg^DB+Adverb+When
yapılmamasını	yap+Verb^DB+Verb+Pass+Neg^DB+Noun+Inf2+A3sg+P3sg+Acc
gidilmemesi	git+Verb^DB+Verb+Pass+Neg^DB+Noun+Inf2+A3sg+P3sg+Nom
takmayanlara	tak+Verb+Neg^DB+Adj+PresPart^DB+Noun+Zero+A3pl+Pnon+Dat
yakalanmadıkları	yakala+Verb^DB+Verb+Pass+Neg^DB+Adj+PastPart+P3pl
beklemiyordum	bekle+Verb+Neg+Prog1+Past+A1sg
kopmayacağım	kop+Verb+Neg+Fut+A1sg
çıkmadım	çık+Verb+Neg+Past+A1sg
istemiyordum	iste+Verb+Neg+Prog1+Past+A1sg
bırakmama	bırak+Verb+Neg^DB+Noun+Inf2+A3sg+Pnon+Nom
istemediğin	iste+Verb+Neg^DB+Noun+PastPart+A3sg+P2sg+Nom
seyretmezdim	seyret+Verb+Neg+Aor+Past+A1sg
inanmıyorum	inan+Verb+Neg+Prog1+A1sg
almamıştım	al+Verb+Neg+Narr+Past+A1sg
okuyamamış	oku+Verb^DB+Verb+Able+Neg+Narr+A3sg
düşmemesi	düş+Verb+Neg^DB+Noun+Inf2+A3sg+P3sg+Nom
duramazsın	dur+Verb^DB+Verb+Able+Neg+Aor+A2sg
almıyorlar	al+Verb+Neg+Prog1+A3pl
atmam	at+Verb+Neg+Aor+A1sg
bozulmaması	boz+Verb^DB+Verb+Pass+Neg^DB+Noun+Inf2+A3sg+P3sg+Nom
büyümedim	büyü+Verb+Neg+Past+A1sg
gitmezler	git+Verb+Neg+Aor+A3pl
kurmazlar	kur+Verb+Neg+Aor+A3pl
görmemişim	gör+Verb+Neg+Narr+A1sg
olamazdım	ol+Verb^DB+Verb+Able+Neg+Aor+Past+A1sg
gitmedim	git+Verb+Neg+Past+A1sg
verilmezken	ver+Verb^DB+Verb+Pass+Neg+Aor^DB+Adverb+While
yapmamaları	yap+Verb+Neg^DB+Noun+Inf2+A3pl+P3sg+Nom
uymaması	uy+Verb+Neg^DB+Noun+Inf2+A3sg+P3sg+Nom
kalmadıkça	kal+Verb+Neg^DB+Adverb+AsLongAs
sollamayın	solla+Verb+Neg+Imp+A2pl
olmadıklarının	ol+Verb+Neg^DB+Noun+PastPart+A3sg+P3pl+Gen
bulunmadığının	bul+Verb^DB+Verb+Pass+Neg^DB+Noun+PastPart+A3sg+P3sg+Gen
kalmıyor	kal+Verb+Neg+Prog1+A3sg
uyuyamamış	uyu+Verb^DB+Verb+Able+Neg+Narr+A3sg
dayanamamış	daya+Verb^DB+Verb+Pass^DB+Verb+Able+Neg+Narr+A3sg
açılmamış	aç+Verb^DB+Verb+Pass+Neg+Narr+A3sg
almadılar	al+Verb+Neg+Past+A3pl
başlamasın	başla+Verb+Neg+Imp+A3sg
yapmasın	yap+Verb+Neg+Imp+A3sg
etmeyenin	et+Verb+Neg^DB+Adj+PresPart^DB+Noun+Zero+A3sg+Pnon+Gen
etmeyenlere	et+Verb+Neg^DB+Adj+PresPart^DB+Noun+Zero+A3pl+Pnon+Dat
bilinmemesi	bil+Verb^DB+Verb+Pass+Neg^DB+Noun+Inf2+A3sg+P3sg+Nom
değerlendiremiyoruz	değer+Noun+A3sg+Pnon+Nom^DB+Verb+Acquire^DB+Verb+Caus^DB+Verb+Able+Neg+Prog1+A1pl
değerlendiremediğini	değer+Noun+A3sg+Pnon+Nom^DB+Verb+Acquire^DB+Verb+Caus^DB+Verb+Able+Neg^DB+Noun+PastPart+A3sg+P3sg+Acc
bulmuyor	bul+Verb+Neg+Prog1+A3sg
yapılamıyor	yap+Verb^DB+Verb+Pass^DB+Verb+Able+Neg+Prog1+A3sg
istemediklerini	iste+Verb+Neg^DB+Noun+PastPart+A3pl+P3pl+Acc
tutmuyor	tut+Verb+Neg+Prog1+A3sg
giderilemez	gider+Verb^DB+Verb+Pass^DB+Verb+Able+Neg+Aor+A3sg
almama	al+Verb+Neg^DB+Noun+Inf2+A3sg+Pnon+Nom
güçlendirmeyeceğidir	güç+Noun+A3sg+Pnon+Nom^DB+Verb+Acquire^DB+Verb+Caus+Neg^DB+Noun+FutPart+A3sg+P3sg+Nom^DB+Verb+Zero+Pres+A3sg+Cop
çıkarılmadı	çık+Verb^DB+Verb+Caus^DB+Verb+Pass+Neg+Past+A3sg
edemeyince	et+Verb^DB+Verb+Able+Neg^DB+Adverb+When
içmeyen	iç+Verb+Neg^DB+Adj+PresPart
vurmaması	vur+Verb+Neg^DB+Noun+Inf2+A3sg+P3sg+Nom
çıkmaması	çık+Verb+Neg^DB+Noun+Inf2+A3sg+P3sg+Nom
hissettirmemeye	hisset+Verb^DB+Verb+Caus+Neg^DB+Noun+Inf2+A3sg+Pnon+Dat
gelemeyen	gel+Verb^DB+Verb+Able+Neg^DB+Adj+PresPart
yaşanmaması	yaşa+Verb^DB+Verb+Pass+Neg^DB+Noun+Inf2+A3sg+P3sg+Nom
yapmazken	yap+Verb+Neg+Aor^DB+Adverb+While
girmeseydik	gir+Verb+Neg+Desr+Past+A1pl
dinlenmiyor	dinle+Verb^DB+Verb+Pass+Neg+Prog1+A3sg
öğrenememişler	öğren+Verb^DB+Verb+Able+Neg+Narr+A3pl
hazmedemedi	hazmet+Verb^DB+Verb+Able+Neg+Past+A3sg
satmadığım	sat+Verb+Neg^DB+Noun+PastPart+A3sg+P1sg+Nom
oynanmamıştır	oyna+Verb^DB+Verb+Pass+Neg+Narr+A3sg+Cop
kullanamadı	kullan+Verb^DB+Verb+Able+Neg+Past+A3sg
sorulmuyor	sor+Verb^DB+Verb+Pass+Neg+Prog1+A3sg
bilinmez	bil+Verb^DB+Verb+Pass+Neg+Aor+A3sg
sönmeyeceğine	sön+Verb+Neg^DB+Noun+FutPart+A3sg+P3sg+Dat
harcamamak	harca+Verb+Neg^DB+Noun+Inf1+A3sg+Pnon+Nom
kalmayacağını	kal+Verb+Neg^DB+Noun+FutPart+A3sg+P3sg+Acc
ayırtmadıysanız	ayır+Verb^DB+Verb+Caus+Neg+Past+Cond+A2pl
dolmuyor	dol+Verb+Neg+Prog1+A3sg
kestiremeyen	kes+Verb^DB+Verb+Caus^DB+Verb+Able+Neg^DB+Adj+PresPart
istemeyen	iste+Verb+Neg^DB+Adj+PresPart
çalışılmaması	çalış+Verb^DB+Verb+Pass+Neg^DB+Noun+Inf2+A3sg+P3sg+Nom
verilmese	ver+Verb^DB+Verb+Pass+Neg+Desr+A3sg
sağlamayacağı	sağla+Verb+Neg^DB+Noun+FutPart+A3sg+P3sg+Nom
kaldıramayan	kal+Verb^DB+Verb+Caus^DB+Verb+Able+Neg^DB+Adj+PresPart
gitmeyelim	git+Verb+Neg+Opt+A1pl
beklemiyorum	bekle+Verb+Neg+Prog1+A1sg
sağlayamaz	sağla+Verb^DB+Verb+Able+Neg+Aor+A3sg
yapmıyorlar	yap+Verb+Neg+Prog1+A3pl
addetmeyen	addet+Verb+Neg^DB+Adj+PresPart
yapılamayacağını	yap+Verb^DB+Verb+Pass^DB+Verb+Able+Neg^DB+Noun+FutPart+A3sg+P3sg+Acc
aşamaz	aş+Verb^DB+Verb+Able+Neg+Aor+A3sg
yaratamazsınız	yara+Verb^DB+Verb+Caus^DB+Verb+Able+Neg+Aor+A2pl
aşmama	aş+Verb+Neg^DB+Noun+Inf2+A3sg+Pnon+Nom
demiyor	de+Verb+Neg+Prog1+A3sg
geçmeyecek	geç+Verb+Neg^DB+Adj+FutPart+Pnon
veremezsiniz	ver+Verb^DB+Verb+Able+Neg+Aor+A2pl
aşmayın	aş+Verb+Neg+Imp+A2pl
bakmasınlar	bak+Verb+Neg+Imp+A3pl
korkmayın	kork+Verb+Neg+Imp+A2pl
görülmeyecek	gör+Verb^DB+Verb+Pass+Neg+Fut+A3sg
karşılayamayacağını	karşıla+Verb^DB+Verb+Able+Neg^DB+Noun+FutPart+A3sg+P3sg+Acc
kapışma	kapış+Verb+Neg+Imp+A2sg
yapamadı	yap+Verb^DB+Verb+Able+Neg+Past+A3sg
bakmadı	bak+Verb+Neg+Past+A3sg
beğenmeyin	beğen+Verb+Neg+Imp+A2pl
gitmediği	git+Verb+Neg^DB+Noun+PastPart+A3sg+P3sg+Nom
yapmıyoruz	yap+Verb+Neg+Prog1+A1pl
çalışmadı	çalış+Verb+Neg+Past+A3sg
edilmiyor	et+Verb^DB+Verb+Pass+Neg+Prog1+A3sg
kaçırılmamış	kaç+Verb^DB+Verb+Caus^DB+Verb+Pass+Neg+Narr+A3sg
dışlanmamalıdır	dışla+Verb^DB+Verb+Pass+Neg+Neces+A3sg+Cop
gitmeyince	git+Verb+Neg^DB+Adverb+When
yapmadığım	yap+Verb+Neg^DB+Adj+PastPart+P1sg
değiştiremem	değiş+Verb^DB+Verb+Caus^DB+Verb+Able+Neg+Aor+A1sg
yaşayamayacağını	yaşa+Verb^DB+Verb+Able+Neg^DB+Noun+FutPart+A3sg+P3sg+Acc
almasa	al+Verb+Neg+Desr+A3sg
kestiremiyor	kes+Verb^DB+Verb+Caus^DB+Verb+Able+Neg+Prog1+A3sg
verilmeseydi	ver+Verb^DB+Verb+Pass+Neg+Desr+Past+A3sg
gelemiyordum	gel+Verb^DB+Verb+Able+Neg+Prog1+Past+A1sg
inanmamış	inan+Verb+Neg+Narr+A3sg
reddetmiyor	reddet+Verb+Neg+Prog1+A3sg
yitirmiyor	yit+Verb^DB+Verb+Caus+Neg+Prog1+A3sg
kalmayacaktım	kal+Verb+Neg+Fut+Past+A1sg
olmamasına	ol+Verb+Neg^DB+Noun+Inf2+A3sg+P3sg+Dat
etmememi	et+Verb+Neg^DB+Noun+Inf2+A3sg+P1sg+Acc
toparlayamıyordum	toparla+Verb^DB+Verb+Able+Neg+Prog1+Past+A1sg
yapılmamış	yap+Verb^DB+Verb+Pass+Neg+Narr+A3sg
anlatamadığım	anla+Verb^DB+Verb+Caus^DB+Verb+Able+Neg^DB+Adj+PastPart+P1sg
yetiştiremiyoruz	yetiş+Verb^DB+Verb+Caus^DB+Verb+Able+Neg+Prog1+A1pl
olmayanlardan	ol+Verb+Neg^DB+Adj+PresPart^DB+Noun+Zero+A3pl+Pnon+Abl
oynanmamış	oyna+Verb^DB+Verb+Pass+Neg+Narr+A3sg
tanımıyor	tanı+Verb+Neg+Prog1+A3sg
sürmüyor	sür+Verb+Neg+Prog1+A3sg
kalmayan	kal+Verb+Neg^DB+Adj+PresPart
uymamış	uy+Verb+Neg+Narr+A3sg
vermiyor	ver+Verb+Neg+Prog1+A3sg
olmazlar	ol+Verb+Neg+Aor+A3pl
yakalanmamaya	yakala+Verb^DB+Verb+Pass+Neg^DB+Noun+Inf2+A3sg+Pnon+Dat
değişmeyecekti	değiş+Verb+Neg+Fut+Past+A3sg
bırakmayarak	bırak+Verb+Neg^DB+Adverb+ByDoingSo
olmadılar	ol+Verb+Neg+Past+A3pl
görülmüyor	gör+Verb^DB+Verb+Pass+Neg+Prog1+A3sg
beklenmediğini	bekle+Verb^DB+Verb+Pass+Neg^DB+Noun+PastPart+A3sg+P3sg+Acc
sormayın	sor+Verb+Neg+Imp+A2pl
veremiyoruz	ver+Verb^DB+Verb+Able+Neg+Prog1+A1pl
çıkmamaları	çık+Verb+Neg^DB+Noun+Inf2+A3pl+P3sg+Nom
bulunamayabilir	bul+Verb^DB+Verb+Pass^DB+Verb+Able+Neg^DB+Verb+Able+Aor+A3sg
etmemeliler	et+Verb+Neg+Neces+A3pl
kalmamaları	kal+Verb+Neg^DB+Noun+Inf2+A3pl+P3sg+Nom
kapılmayın	kap+Verb^DB+Verb+Pass+Neg+Imp+A2pl
bozmayın	boz+Verb+Neg+Imp+A2pl
aksatmamaları	aksa+Verb^DB+Verb+Caus+Neg^DB+Noun+Inf2+A3pl+P3sg+Nom
dolaşmamaları	dolaş+Verb+Neg^DB+Noun+Inf2+A3pl+P3sg+Nom
çıkartamadım	çık+Verb^DB+Verb+Caus^DB+Verb+Caus^DB+Verb+Able+Neg+Past+A1sg
inmez	in+Verb+Neg+Aor+A3sg
girmemek	gir+Verb+Neg^DB+Noun+Inf1+A3sg+Pnon+Nom
çekmeyeceklerdir	çek+Verb+Neg+Fut+A3pl+Cop
yanıltmasın	yanıl+Verb^DB+Verb+Caus+Neg+Imp+A3sg
gidilmiyor	git+Verb^DB+Verb+Pass+Neg+Prog1+A3sg
oluşmuyor	oluş+Verb+Neg+Prog1+A3sg
kapanmıyor	kapa+Verb^DB+Verb+Pass+Neg+Prog1+A3sg
edemiyor	et+Verb^DB+Verb+Able+Neg+Prog1+A3sg
bulunmamak	bul+Verb^DB+Verb+Pass+Neg^DB+Noun+Inf1+A3sg+Pnon+Nom
bitirilemeyen	bit+Verb^DB+Verb+Caus^DB+Verb+Pass^DB+Verb+Able+Neg^DB+Adj+PresPart
geçirmez	geç+Verb^DB+Verb+Caus+Neg+Aor+A3sg
tanışmamıştı	tanış+Verb+Neg+Narr+Past+A3sg
kaybetmeyecek	kaybet+Verb+Neg+Fut+A3sg
şaşırmayın	şaşır+Verb+Neg+Imp+A2pl
olmamalarının	ol+Verb+Neg^DB+Noun+Inf2+A3pl+P3sg+Gen
kaçırılmayacak	kaç+Verb^DB+Verb+Caus^DB+Verb+Pass+Neg+Fut+A3sg
çıkılmaması	çık+Verb^DB+Verb+Pass+Neg^DB+Noun+Inf2+A3sg+P3sg+Nom
engelleyemedi	engelle+Verb^DB+Verb+Able+Neg+Past+A3sg
kazılmadı	kaz+Verb^DB+Verb+Pass+Neg+Past+A3sg
rastlanmayan	rastla+Verb^DB+Verb+Pass+Neg^DB+Adj+PresPart
giremiyor	gir+Verb^DB+Verb+Able+Neg+Prog1+A3sg
görülmeyen	gör+Verb^DB+Verb+Pass+Neg^DB+Adj+PresPart
geçmeyen	geç+Verb+Neg^DB+Adj+PresPart
anlamayanlara	anla+Verb+Neg^DB+Adj+PresPart^DB+Noun+Zero+A3pl+Pnon+Dat
keşfetmediği	keşfet+Verb+Neg^DB+Adj+PastPart+P3sg
karşılaştırılmayacak	karşılaş+Verb^DB+Verb+Caus^DB+Verb+Pass+Neg^DB+Adj+FutPart+Pnon
taşımadığını	taşı+Verb+Neg^DB+Noun+PastPart+A3sg+P3sg+Acc
denemiyor	de+Verb^DB+Verb+Pass^DB+Verb+Able+Neg+Prog1+A3sg
çıkmamış	çık+Verb+Neg+Narr+A3sg
getirmediğimiz	getir+Verb+Neg^DB+Noun+PastPart+A3sg+P1pl+Nom
koruyamamışız	koru+Verb^DB+Verb+Able+Neg+Narr+A1pl
çıkarılmazsa	çık+Verb^DB+Verb+Caus^DB+Verb+Pass+Neg+Aor+Cond+A3sg
yapmıyor	yap+Verb+Neg+Prog1+A3sg
onaylatmadığı	onayla+Verb^DB+Verb+Caus+Neg^DB+Adj+PastPart+P3sg
almaması	al+Verb+Neg^DB+Noun+Inf2+A3sg+P3sg+Nom
bulunmamaktadır	bulun+Verb+Neg+Prog2+A3sg+Cop
durmayacağını	dur+Verb+Neg^DB+Noun+FutPart+A3sg+P3sg+Acc
yakışmayacağını	yakış+Verb+Neg^DB+Noun+FutPart+A3sg+P3sg+Acc
dinlemiyorlar	dinle+Verb+Neg+Prog1+A3pl
bilmedikten	bil+Verb+Neg^DB+Noun+PastPart+A3sg+Pnon+Abl
çıkmıyorsa	çık+Verb+Neg+Prog1+Cond+A3sg
dinlemedi	dinle+Verb+Neg+Past+A3sg
heyecanlandırmıyordu	heyecan+Noun+A3sg+Pnon+Nom^DB+Verb+Acquire^DB+Verb+Caus+Neg+Prog1+Past+A3sg
bilmesem	bil+Verb+Neg+Desr+A1sg
aşmadığını	aş+Verb+Neg^DB+Noun+PastPart+A3sg+P3sg+Acc
göremiyorlarsa	gör+Verb^DB+Verb+Able+Neg+Prog1+A3pl+Cond
istemediğimi	iste+Verb+Neg^DB+Noun+PastPart+A3sg+P1sg+Acc
rahatlattı	rahatla+Verb^DB+Verb+Caus+Pos+Past+A3sg
yapan	yap+Verb+Pos^DB+Adj+PresPart
kullanabileceği	kullan+Verb+Pos^DB+Verb+Able^DB+Adj+FutPart+P3sg
erime	eri+Verb+Pos^DB+Noun+Inf2+A3sg+Pnon+Nom
gözlendi	gözle+Verb^DB+Verb+Pass+Pos+Past+A3sg
yüklenen	yükle+Verb^DB+Verb+Pass+Pos^DB+Adj+PresPart
geçen	geç+Verb+Pos^DB+Adj+PresPart
düzeltti	düzel+Verb^DB+Verb+Caus+Pos+Past+A3sg
kapatan	kapa+Verb^DB+Verb+Caus+Pos^DB+Adj+PresPart
çıkardı	çık+Verb^DB+Verb+Caus+Pos+Past+A3sg
göre	gör+Verb+Pos+Opt+A3sg
olan	ol+Verb+Pos^DB+Adj+PresPart
azalışla	azal+Verb+Pos^DB+Noun+Inf3+A3sg+Pnon+Ins
indi	in+Verb+Pos+Past+A3sg
geriledi	gerile+Verb+Pos+Past+A3sg
düştü	düş+Verb+Pos+Past+A3sg
açılan	aç+Verb^DB+Verb+Pass+Pos^DB+Adj+PresPart
gerilemesi	gerile+Verb+Pos^DB+Noun+Inf2+A3sg+P3sg+Nom
çekilen	çek+Verb^DB+Verb+Pass+Pos^DB+Adj+PresPart
azalışı	azal+Verb+Pos^DB+Noun+Inf3+A3sg+P3sg+Nom
gerileme	gerile+Verb+Pos^DB+Noun+Inf2+A3sg+Pnon+Nom
artışla	art+Verb+Pos^DB+Noun+Inf3+A3sg+Pnon+Ins
çıktı	çık+Verb+Pos+Past+A3sg
ise	i+Verb+Pos+Cond+A3sg
rahatlarken	rahatla+Verb+Pos+Aor^DB+Adverb+While
azalarak	azal+Verb+Pos^DB+Adverb+ByDoingSo
ödendi	öde+Verb^DB+Verb+Pass+Pos+Past+A3sg
ödemeleri	öde+Verb+Pos^DB+Noun+Inf2+A3pl+Pnon+Acc
olarak	ol+Verb+Pos^DB+Adverb+ByDoingSo
gerçekleşti	gerçek+Noun+A3sg+Pnon+Nom^DB+Verb+Become+Pos+Past+A3sg
bulunuyor	bulun+Verb+Pos+Prog1+A3sg
gerçekleştirilen	gerçek+Noun+A3sg+Pnon+Nom^DB+Verb+Become^DB+Verb+Caus^DB+Verb+Pass+Pos^DB+Adj+PresPart
olmuştu	ol+Verb+Pos+Narr+Past+A3sg
akmasını	ak+Verb+Pos^DB+Noun+Inf2+A3sg+P3sg+Acc
sağlayan	sağla+Verb+Pos^DB+Adj+PresPart
uygulanması	uygula+Verb^DB+Verb+Pass+Pos^DB+Noun+Inf2+A3sg+P3sg+Nom
beklenenin	bekle+Verb^DB+Verb+Pass+Pos^DB+Adj+PresPart^DB+Noun+Zero+A3sg+Pnon+Gen
artmasına	art+Verb+Pos^DB+Noun+Inf2+A3sg+P3sg+Dat
olurken	ol+Verb+Pos+Aor^DB+Adverb+While
satış	sat+Verb+Pos^DB+Noun+Inf3+A3sg+Pnon+Nom
belirlendiği	belirle+Verb^DB+Verb+Pass+Pos^DB+Noun+PastPart+A3sg+P3sg+Nom
imzaladığı	imzala+Verb+Pos^DB+Adj+PastPart+P3sg
ediliyor	et+Verb^DB+Verb+Pass+Pos+Prog1+A3sg
veren	ver+Verb+Pos^DB+Adj+PresPart
satmasına	sat+Verb+Pos^DB+Noun+Inf2+A3sg+P3sg+Dat
veriyor	ver+Verb+Pos+Prog1+A3sg
tanınan	tanı+Verb^DB+Verb+Pass+Pos^DB+Adj+PresPart
dolduracak	dol+Verb^DB+Verb+Caus+Pos^DB+Adj+FutPart+Pnon
imzalayan	imzala+Verb+Pos^DB+Adj+PresPart
çıkacak	çık+Verb+Pos^DB+Adj+FutPart+Pnon
karşılaşacağı	karşılaş+Verb+Pos^DB+Noun+FutPart+A3sg+P3sg+Nom
arttırılmasını	art+Verb^DB+Verb+Caus^DB+Verb+Pass+Pos^DB+Noun+Inf2+A3sg+P3sg+Acc
isteyeceği	iste+Verb+Pos^DB+Noun+FutPart+A3sg+P3sg+Nom
belirtiliyor	belir+Verb^DB+Verb+Caus^DB+Verb+Pass+Pos+Prog1+A3sg
olmak	ol+Verb+Pos^DB+Noun+Inf1+A3sg+Pnon+Nom
doluncaya	dol+Verb+Pos^DB+Adverb+When^DB+Noun+Zero+A3sg+Pnon+Dat
bildirdiler	bil+Verb^DB+Verb+Caus+Pos+Past+A3pl
bulunduğu	bulun+Verb+Pos^DB+Noun+PastPart+A3sg+P3sg+Nom
tanıdığı	tanı+Verb+Pos^DB+Noun+PastPart+A3sg+P3sg+Nom
kalabilmek	kal+Verb+Pos^DB+Verb+Able^DB+Noun+Inf1+A3sg+Pnon+Nom
azalttığını	azal+Verb^DB+Verb+Caus+Pos^DB+Noun+PastPart+A3sg+P3sg+Acc
bildirdi	bil+Verb^DB+Verb+Caus+Pos+Past+A3sg
açıklama	açıkla+Verb+Pos^DB+Noun+Inf2+A3sg+Pnon+Nom
beklenenden	bekle+Verb^DB+Verb+Pass+Pos^DB+Adj+PresPart^DB+Noun+Zero+A3sg+Pnon+Abl
akacağı	ak+Verb+Pos^DB+Noun+FutPart+A3sg+P3sg+Nom
verince	ver+Verb+Pos^DB+Adverb+When
yükseltici	yüksel+Verb^DB+Verb+Caus+Pos^DB+Adj+Agt
yaptı	yap+Verb+Pos+Past+A3sg
arttığı	art+Verb+Pos^DB+Adj+PastPart+P3sg
satmak	sat+Verb+Pos^DB+Noun+Inf1+A3sg+Pnon+Nom
kalacak	kal+Verb+Pos^DB+Adj+FutPart+Pnon
ettiği	et+Verb+Pos^DB+Noun+PastPart+A3sg+P3sg+Nom
suçlamalarda	suçla+Verb+Pos^DB+Noun+Inf2+A3pl+Pnon+Loc
bulundu	bulun+Verb+Pos+Past+A3sg
verdiği	ver+Verb+Pos^DB+Noun+PastPart+A3sg+P3sg+Nom
yaptığı	yap+Verb+Pos^DB+Adj+PastPart+P3sg
açıklamalarda	açıkla+Verb+Pos^DB+Noun+Inf2+A3pl+Pnon+Loc
bulunduğunu	bulun+Verb+Pos^DB+Noun+PastPart+A3sg+P3sg+Acc
etti	et+Verb+Pos+Past+A3sg
olmasından	ol+Verb+Pos^DB+Noun+Inf2+A3sg+P3sg+Abl
olduğunu	ol+Verb+Pos^DB+Noun+PastPart+A3sg+P3sg+Acc
söyledi	söyle+Verb+Pos+Past+A3sg
açtığı	aç+Verb+Pos^DB+Noun+PastPart+A3sg+P3sg+Nom
yapılacak	yap+Verb^DB+Verb+Pass+Pos^DB+Adj+FutPart+Pnon
getirme	getir+Verb+Pos^DB+Noun+Inf2+A3sg+Pnon+Nom
başlayan	başla+Verb+Pos^DB+Adj+PresPart
büyürken	büyü+Verb+Pos+Aor^DB+Adverb+While
hazırlanan	hazırla+Verb^DB+Verb+Pass+Pos^DB+Adj+PresPart
uyguladıkları	uygula+Verb+Pos^DB+Noun+PastPart+A3pl+P3pl+Nom
seçti	seç+Verb+Pos+Past+A3sg
oluşturduğu	oluş+Verb^DB+Verb+Caus+Pos^DB+Noun+PastPart+A3sg+P3sg+Nom
araştırmalar	araştır+Verb+Pos^DB+Noun+Inf2+A3pl+Pnon+Nom
ulaştırdığı	ulaş+Verb^DB+Verb+Caus+Pos^DB+Adj+PastPart+P3sg
savunduğu	savun+Verb+Pos^DB+Noun+PastPart+A3sg+P3sg+Nom
koydu	koy+Verb+Pos+Past+A3sg
uygulandığı	uygula+Verb^DB+Verb+Pass+Pos^DB+Noun+PastPart+A3sg+P3sg+Nom
olmalarına	ol+Verb+Pos^DB+Noun+Inf2+A3pl+P3pl+Dat
çekildi	çek+Verb^DB+Verb+Pass+Pos+Past+A3sg
sağlanan	sağla+Verb^DB+Verb+Pass+Pos^DB+Adj+PresPart
alınmaları	al+Verb^DB+Verb+Pass+Pos^DB+Noun+Inf2+A3pl+P3pl+Nom
istendi	iste+Verb^DB+Verb+Pass+Pos+Past+A3sg
bırakma	bırak+Verb+Pos^DB+Noun+Inf2+A3sg+Pnon+Nom
geldi	gel+Verb+Pos+Past+A3sg
yapılan	yap+Verb^DB+Verb+Pass+Pos^DB+Adj+PresPart
açıklamada	açıkla+Verb+Pos^DB+Noun+Inf2+A3sg+Pnon+Loc
yıkmaya	yık+Verb+Pos^DB+Noun+Inf2+A3sg+Pnon+Dat
ulaştığı	ulaş+Verb+Pos^DB+Noun+PastPart+A3sg+P3sg+Nom
edildi	et+Verb^DB+Verb+Pass+Pos+Past+A3sg
sığınılarak	sığın+Verb^DB+Verb+Pass+Pos^DB+Adverb+ByDoingSo
yürütülen	yürü+Verb^DB+Verb+Caus^DB+Verb+Pass+Pos^DB+Adj+PresPart
çalışmaların	çalış+Verb+Pos^DB+Noun+Inf2+A3pl+Pnon+Gen
düzenlemeler	düzenle+Verb+Pos^DB+Noun+Inf2+A3pl+Pnon+Nom
olduğuna	ol+Verb+Pos^DB+Noun+PastPart+A3sg+P3sg+Dat
yumuşatır	yumuşa+Verb^DB+Verb+Caus+Pos+Aor+A3sg
söylediğin	söyle+Verb+Pos^DB+Adj+PastPart+P2sg
verdi	ver+Verb+Pos+Past+A3sg
konuştuğumu	konuş+Verb+Pos^DB+Noun+PastPart+A3sg+P1sg+Acc
biliyorum	bile+Verb+Pos+Prog1+A1sg
ilgileneceğini	ilgilen+Verb+Pos^DB+Noun+FutPart+A3sg+P3sg+Acc
olsaydım	ol+Verb+Pos+Desr+Past+A1sg
olsaydı	ol+Verb+Pos+Desr+Past+A3sg
yapardım	yap+Verb+Pos+Aor+Past+A1sg
endişelenme	endişe+Noun+A3sg+Pnon+Nom^DB+Verb+Acquire+Pos^DB+Noun+Inf2+A3sg+Pnon+Nom
oynamaya	oyna+Verb+Pos^DB+Noun+Inf2+A3sg+Pnon+Dat
olduğu	ol+Verb+Pos^DB+Noun+PastPart+A3sg+P3sg+Nom
benziyorsun	benze+Verb+Pos+Prog1+A2sg
gördüm	gör+Verb+Pos+Past+A1sg
görmek	gör+Verb+Pos^DB+Noun+Inf1+A3sg+Pnon+Nom
sevdiğin	sev+Verb+Pos^DB+Noun+PastPart+A3sg+P2sg+Nom
sanırım	san+Verb+Pos+Aor+A1sg
seveceğim	sev+Verb+Pos+Fut+A1sg
bağırdı	bağır+Verb+Pos+Past+A3sg
sevecek	sev+Verb+Pos^DB+Adj+FutPart+Pnon
yapmış	yap+Verb+Pos+Narr+A3sg
olur	ol+Verb+Pos+Aor+A3sg
çekindi	çekin+Verb+Pos+Past+A3sg
gülerek	gül+Verb+Pos^DB+Adverb+ByDoingSo
idi	i+Verb+Pos+Past+A3sg
bindiler	bin+Verb+Pos+Past+A3pl
eskimiş	eski+Verb+Pos+Narr+A3sg
indiler	in+Verb+Pos+Past+A3pl
geçmişti	geç+Verb+Pos+Narr+Past+A3sg
etmesi	et+Verb+Pos^DB+Noun+Inf2+A3sg+P3sg+Nom
gerekiyordu	gerek+Verb+Pos+Prog1+Past+A3sg
dinlemesi	dinle+Verb+Pos^DB+Noun+Inf2+A3sg+P3sg+Nom
gitmek	git+Verb+Pos^DB+Noun+Inf1+A3sg+Pnon+Nom
istiyordu	iste+Verb+Pos+Prog1+Past+A3sg
geldiğinde	gel+Verb+Pos^DB+Noun+PastPart+A3sg+P3sg+Loc
yaratacaktı	yara+Verb^DB+Verb+Caus+Pos+Fut+Past+A3sg
tiksiniyordu	tiksin+Verb+Pos+Prog1+Past+A3sg
ayrıldılar	ayır+Verb^DB+Verb+Pass+Pos+Past+A3pl
girdiğini	gir+Verb+Pos^DB+Noun+PastPart+A3sg+P3sg+Acc
hissettiği	hisset+Verb+Pos^DB+Noun+PastPart+A3sg+P3sg+Nom
dolanmış	dola+Verb^DB+Verb+Pass+Pos+Narr+A3sg
dururken	dur+Verb+Pos+Aor^DB+Adverb+While
oynarken	oyna+Verb+Pos+Aor^DB+Adverb+While
öpüp	öp+Verb+Pos^DB+Adverb+AfterDoingSo
okşadı	okşa+Verb+Pos+Past+A3sg
inerken	in+Verb+Pos+Aor^DB+Adverb+While
bekliyordu	bekle+Verb+Pos+Prog1+Past+A3sg
girdiğinde	gir+Verb+Pos^DB+Noun+PastPart+A3sg+P3sg+Loc
vermeden	ver+Verb+Pos^DB+Adverb+WithoutHavingDoneSo
oturdu	otur+Verb+Pos+Past+A3sg
uçuşup	uçuş+Verb+Pos^DB+Adverb+AfterDoingSo
dolaşıyorlardı	dolaş+Verb+Pos+Prog1+A3pl+Past
kalan	kal+Verb+Pos^DB+Adj+PresPart
durmaksızın	dur+Verb+Pos^DB+Adverb+WithoutHavingDoneSo
yiyip	ye+Verb+Pos^DB+Adverb+AfterDoingSo
bitiren	bit+Verb^DB+Verb+Caus+Pos^DB+Adj+PresPart
işitiyordu	işit+Verb+Pos+Prog1+Past+A3sg
itti	it+Verb+Pos+Past+A3sg
aldı	al+Verb+Pos+Past+A3sg
bilmek	bil+Verb+Pos^DB+Noun+Inf1+A3sg+Pnon+Nom
düşünüyordu	düşün+Verb+Pos+Prog1+Past+A3sg
verilmiş	ver+Verb^DB+Verb+Pass+Pos+Narr+A3sg
olmalıydı	ol+Verb+Pos+Neces+Past+A3sg
izliyordu	izle+Verb+Pos+Prog1+Past+A3sg
çıkarmış	çık+Verb+Pos+Aor+Narr+A3sg
dökülüyordu	dök+Verb^DB+Verb+Pass+Pos+Prog1+Past+A3sg
çekiştirip	çekiş+Verb^DB+Verb+Caus+Pos^DB+Adverb+AfterDoingSo
durmaktaydı	dur+Verb+Pos^DB+Noun+Inf1+A3sg+Pnon+Loc^DB+Verb+Zero+Past+A3sg
vurduğunda	vur+Verb+Pos^DB+Noun+PastPart+A3sg+P3sg+Loc
kalkarak	kalk+Verb+Pos^DB+Adverb+ByDoingSo
gitti	git+Verb+Pos+Past+A3sg
dönerek	dön+Verb+Pos^DB+Adverb+ByDoingSo
baktı	bak+Verb+Pos+Past+A3sg
ıslanmıştı	ısla+Verb^DB+Verb+Pass+Pos+Narr+Past+A3sg
dileyen	dile+Verb+Pos^DB+Adj+PresPart
yalvarış	yalvar+Verb+Pos^DB+Noun+Inf3+A3sg+Pnon+Nom
gördü	gör+Verb+Pos+Past+A3sg
döndürdü	dön+Verb^DB+Verb+Caus+Pos+Past+A3sg
dedi	de+Verb+Pos+Past+A3sg
bakışlarını	bak+Verb+Pos^DB+Noun+Inf3+A3pl+P3sg+Acc
dolandırıyordu	dolan+Verb^DB+Verb+Caus+Pos+Prog1+Past+A3sg
söyle	söyle+Verb+Pos+Imp+A2sg
geçirdi	geç+Verb^DB+Verb+Caus+Pos+Past+A3sg
ferahlama	ferahla+Verb+Pos^DB+Noun+Inf2+A3sg+Pnon+Nom
solumasıydı	solu+Verb+Pos^DB+Noun+Inf2+A3sg+P3sg+Nom^DB+Verb+Zero+Past+A3sg
çektiği	çek+Verb+Pos^DB+Noun+PastPart+A3sg+P3sg+Nom
gelip	gel+Verb+Pos^DB+Adverb+AfterDoingSo
çatmıştı	çat+Verb+Pos+Narr+Past+A3sg
yaratıyordu	yara+Verb^DB+Verb+Caus+Pos+Prog1+Past+A3sg
olmuş	ol+Verb+Pos^DB+Adj+NarrPart
hatırlatmıştı	hatırla+Verb^DB+Verb+Caus+Pos+Narr+Past+A3sg
acı	acı+Verb+Pos+Imp+A2sg
ederek	et+Verb+Pos^DB+Adverb+ByDoingSo
sıkarak	sık+Verb+Pos^DB+Adverb+ByDoingSo
salladı	salla+Verb+Pos+Past+A3sg
biliyordum	bile+Verb+Pos+Prog1+Past+A1sg
sevdik	sev+Verb+Pos+Past+A1pl
yaşasaydı	yaşa+Verb+Pos+Desr+Past+A3sg
geçinmemizi	geçin+Verb+Pos^DB+Noun+Inf2+A3sg+P1pl+Acc
ederdi	et+Verb+Pos+Aor+Past+A3sg
konuşma	konuş+Verb+Pos^DB+Noun+Inf2+A3sg+Pnon+Nom
haykırdı	haykır+Verb+Pos+Past+A3sg
verme	ver+Verb+Pos^DB+Noun+Inf2+A3sg+Pnon+Nom
seven	sev+Verb+Pos^DB+Adj+PresPart
söylüyor	söyle+Verb+Pos+Prog1+A3sg
doldu	dol+Verb+Pos+Past+A3sg
sildi	sil+Verb+Pos+Past+A3sg
fısıldadı	fısılda+Verb+Pos+Past+A3sg
duygulanmıştı	duygu+Noun+A3sg+Pnon+Nom^DB+Verb+Acquire+Pos+Narr+Past+A3sg
eğilip	eğ+Verb^DB+Verb+Pass+Pos^DB+Adverb+AfterDoingSo
öptü	öp+Verb+Pos+Past+A3sg
verdimse	ver+Verb+Pos+Past+A1sg+Cond
kal	kal+Verb+Pos+Imp+A2sg
ilgilenmen	ilgilen+Verb+Pos^DB+Noun+Inf2+A3sg+P2sg+Nom
gereken	gerek+Verb+Pos^DB+Adj+PresPart
unutma	unut+Verb+Pos^DB+Noun+Inf2+A3sg+Pnon+Nom
verirse	ver+Verb+Pos+Aor+Cond+A3sg
bulacak	bul+Verb+Pos+Fut+A3sg
sürecek	sür+Verb+Pos^DB+Adj+FutPart+Pnon
öldüreceğim	öl+Verb^DB+Verb+Caus+Pos+Fut+A1sg
ederim	et+Verb+Pos+Aor+A1sg
eden	et+Verb+Pos^DB+Adj+PresPart
gösterdi	göster+Verb+Pos+Past+A3sg
etmesinden	et+Verb+Pos^DB+Noun+Inf2+A3sg+P3sg+Abl
olurdu	ol+Verb+Pos+Aor+Past+A3sg
kesti	kes+Verb+Pos+Past+A3sg
taşınması	taşı+Verb^DB+Verb+Pass+Pos^DB+Noun+Inf2+A3sg+P3sg+Nom
edilmesi	et+Verb^DB+Verb+Pass+Pos^DB+Noun+Inf2+A3sg+P3sg+Nom
koşturuyorlardı	koş+Verb^DB+Verb+Caus+Pos+Prog1+A3pl+Past
yerleştirilmesi	yerleş+Verb^DB+Verb+Caus^DB+Verb+Pass+Pos^DB+Noun+Inf2+A3sg+P3sg+Nom
kayboluyordu	kaybol+Verb+Pos+Prog1+Past+A3sg
uğurlama	uğurla+Verb+Pos^DB+Noun+Inf2+A3sg+Pnon+Nom
yıpranmış	yıpran+Verb+Pos+Narr+A3sg
sallarken	salla+Verb+Pos+Aor^DB+Adverb+While
duydu	duy+Verb+Pos+Past+A3sg
olduğunun	ol+Verb+Pos^DB+Noun+PastPart+A3sg+P3sg+Gen
kalmış	kal+Verb+Pos+Narr+A3sg
kederlendiğini	keder+Noun+A3sg+Pnon+Nom^DB+Verb+Acquire+Pos^DB+Noun+PastPart+A3sg+P3sg+Acc
ilgilenmek	ilgilen+Verb+Pos^DB+Noun+Inf1+A3sg+Pnon+Nom
söyleyerek	söyle+Verb+Pos^DB+Adverb+ByDoingSo
hatırladı	hatırla+Verb+Pos+Past+A3sg
bulunmuştu	bulun+Verb+Pos+Narr+Past+A3sg
açıklanmış	açıkla+Verb^DB+Verb+Pass+Pos+Narr+A3sg
güleceklerini	gül+Verb+Pos^DB+Noun+FutPart+A3pl+P3pl+Acc
hissetti	hisset+Verb+Pos+Past+A3sg
hazırlanmış	hazırla+Verb^DB+Verb+Pass+Pos+Narr+A3sg
katılmak	kat+Verb^DB+Verb+Pass+Pos^DB+Noun+Inf1+A3sg+Pnon+Nom
göründüğünde	görün+Verb+Pos^DB+Noun+PastPart+A3sg+P3sg+Loc
eğilmiş	eğ+Verb^DB+Verb+Pass+Pos+Narr+A3sg
bekleyen	bekle+Verb+Pos^DB+Adj+PresPart
yapılmaya	yap+Verb^DB+Verb+Pass+Pos^DB+Noun+Inf2+A3sg+Pnon+Dat
bulunur	bulun+Verb+Pos+Aor+A3sg
geçirilseler	geç+Verb^DB+Verb+Caus^DB+Verb+Pass+Pos+Desr+A3pl
görünürler	görün+Verb+Pos^DB+Adj+AorPart^DB+Noun+Zero+A3pl+Pnon+Nom
konuşurken	konuş+Verb+Pos+Aor^DB+Adverb+While
bakarak	bak+Verb+Pos^DB+Adverb+ByDoingSo
evlenmek	evlen+Verb+Pos^DB+Noun+Inf1+A3sg+Pnon+Nom
nişanlandı	nişanla+Verb^DB+Verb+Pass+Pos+Past+A3sg
silkindi	silkin+Verb+Pos+Past+A3sg
çattı	çat+Verb+Pos+Past+A3sg
yapmak	yap+Verb+Pos^DB+Noun+Inf1+A3sg+Pnon+Nom
kaybediyor	kaybet+Verb+Pos+Prog1+A3sg
yapabileceği	yap+Verb+Pos^DB+Verb+Able^DB+Adj+FutPart+P3sg
kıyılan	kıy+Verb^DB+Verb+Pass+Pos^DB+Adj+PresPart
diyerek	de+Verb+Pos^DB+Adverb+ByDoingSo
evlendiğini	evlen+Verb+Pos^DB+Noun+PastPart+A3sg+P3sg+Acc
söyledim	söyle+Verb+Pos+Past+A1sg
saklıyorum	sakla+Verb+Pos+Prog1+A1sg
düşüneceğim	düşün+Verb+Pos+Fut+A1sg
düşün	düşün+Verb+Pos+Imp+A2sg
bulunan	bulun+Verb+Pos^DB+Adj+PresPart
davranış	davran+Verb+Pos^DB+Noun+Inf3+A3sg+Pnon+Nom
olacak	ol+Verb+Pos^DB+Adj+FutPart+Pnon
evlenmesini	evlen+Verb+Pos^DB+Noun+Inf2+A3sg+P3sg+Acc
sağlamak	sağla+Verb+Pos^DB+Noun+Inf1+A3sg+Pnon+Nom
istiyorsan	iste+Verb+Pos+Prog1+Cond+A2sg
söylemen	söyle+Verb+Pos^DB+Noun+Inf2+A3sg+P2sg+Nom
evlenecektir	evlen+Verb+Pos+Fut+A3sg+Cop
yapıyorsa	yap+Verb+Pos+Prog1+Cond+A3sg
gelir	gel+Verb+Pos+Aor+A3sg
bozacak	boz+Verb+Pos^DB+Adj+FutPart+Pnon
edecek	et+Verb+Pos^DB+Adj+FutPart+Pnon
bağlanmış	bağla+Verb^DB+Verb+Pass+Pos^DB+Adj+NarrPart
yudumlayarak	yudumla+Verb+Pos^DB+Adverb+ByDoingSo
değerlendirmelerde	değer+Noun+A3sg+Pnon+Nom^DB+Verb+Acquire^DB+Verb+Caus+Pos^DB+Noun+Inf2+A3pl+Pnon+Loc
çizdiğin	çiz+Verb+Pos^DB+Noun+PastPart+A3sg+P2sg+Nom
görünüşlerini	görün+Verb+Pos^DB+Noun+Inf3+A3pl+P3sg+Acc
değerlendirmekteki	değer+Noun+A3sg+Pnon+Nom^DB+Verb+Acquire^DB+Verb+Caus+Pos^DB+Noun+Inf1+A3sg+Pnon+Loc^DB+Adj+Rel
geliştirmişti	geliş+Verb^DB+Verb+Caus+Pos+Narr+Past+A3sg
görünüş	görün+Verb+Pos^DB+Noun+Inf3+A3sg+Pnon+Nom
göreceğiz	gör+Verb+Pos+Fut+A1pl
üzülürdüm	üz+Verb^DB+Verb+Pass+Pos+Aor+Past+A1sg
yürüyüp	yürü+Verb+Pos^DB+Adverb+AfterDoingSo
ısırarak	ısır+Verb+Pos^DB+Adverb+ByDoingSo
onaylıyor	onayla+Verb+Pos+Prog1+A3sg
sordu	sor+Verb+Pos+Past+A3sg
onaylayabilmen	onayla+Verb+Pos^DB+Verb+Able^DB+Noun+Inf2+A3sg+P2sg+Nom
sermek	ser+Verb+Pos^DB+Noun+Inf1+A3sg+Pnon+Nom
dediklerine	de+Verb+Pos^DB+Noun+PastPart+A3sg+P3pl+Dat
aldırış	al+Verb^DB+Verb+Caus+Pos^DB+Noun+Inf3+A3sg+Pnon+Nom
yaptıklarına	yap+Verb+Pos^DB+Noun+PastPart+A3sg+P3pl+Dat
büyülemişse	büyüle+Verb+Pos+Narr+Cond+A3sg
olursa	ol+Verb+Pos+Aor+Cond+A3sg
olsun	ol+Verb+Pos+Imp+A3sg
geliyor	gel+Verb+Pos+Prog1+A3sg
oynayan	oyna+Verb+Pos^DB+Adj+PresPart
vuruldu	vur+Verb^DB+Verb+Pass+Pos+Past+A3sg
evlenme	evlen+Verb+Pos^DB+Noun+Inf2+A3sg+Pnon+Nom
evlenmiş	evlen+Verb+Pos+Narr+A3sg
bilirsin	bil+Verb+Pos+Aor+A2sg
kılmasıdır	kıl+Verb+Pos^DB+Noun+Inf2+A3sg+P3sg+Nom^DB+Verb+Zero+Pres+A3sg+Cop
yitirirler	yit+Verb^DB+Verb+Caus+Pos+Aor+A3pl
getirir	getir+Verb+Pos+Aor+A3sg
eklerler	ekle+Verb+Pos+Aor+A3pl
yaşamak	yaşa+Verb+Pos^DB+Noun+Inf1+A3sg+Pnon+Nom
kalırlar	kal+Verb+Pos+Aor+A3pl
olurlar	ol+Verb+Pos+Aor+A3pl
sanıyorum	san+Verb+Pos+Prog1+A1sg
sürebilecekleri	sür+Verb+Pos^DB+Verb+Able^DB+Noun+FutPart+A3sg+P3pl+Nom
yapacak	yap+Verb+Pos^DB+Adj+FutPart+Pnon
geçecek	geç+Verb+Pos+Fut+A3sg
etkileyici	etkile+Verb+Pos^DB+Noun+Agt+A3sg+Pnon+Nom
bulmaya	bul+Verb+Pos^DB+Noun+Inf2+A3sg+Pnon+Dat
başlayacak	başla+Verb+Pos^DB+Adj+FutPart+Pnon
söylediklerinin	söyle+Verb+Pos^DB+Noun+PastPart+A3pl+P3sg+Gen
biliyorsun	bile+Verb+Pos+Prog1+A2sg
olacaksa	ol+Verb+Pos+Fut+Cond+A3sg
üzülen	üz+Verb^DB+Verb+Pass+Pos^DB+Adj+PresPart
güldü	gül+Verb+Pos+Past+A3sg
düşünmekten	düşün+Verb+Pos^DB+Noun+Inf1+A3sg+Pnon+Abl
hoşlanmamızın	hoşlan+Verb+Pos^DB+Noun+Inf2+A3sg+P1pl+Gen
korkmamızdır	kork+Verb+Pos^DB+Noun+Inf2+A3sg+P1pl+Nom^DB+Verb+Zero+Pres+A3sg+Cop
oldukları	ol+Verb+Pos^DB+Noun+PastPart+A3pl+P3pl+Nom
güvendiğimiz	güven+Verb+Pos^DB+Noun+PastPart+A3sg+P1pl+Nom
olduğumuzu	ol+Verb+Pos^DB+Noun+PastPart+A3sg+P1pl+Acc
zannederiz	zannet+Verb+Pos+Aor+A1pl
sağlayacaktır	sağla+Verb+Pos+Fut+A3sg+Cop
çekebilmek	çek+Verb+Pos^DB+Verb+Able^DB+Noun+Inf1+A3sg+Pnon+Nom
överiz	öv+Verb+Pos+Aor+A1pl
buluruz	bul+Verb+Pos+Aor+A1pl
geçenlerdir	geç+Verb+Pos^DB+Adj+PresPart^DB+Noun+Zero+A3sg+Pnon+Nom^DB+Verb+Zero+Pres+A3pl+Cop
buluyorum	bula+Verb+Pos+Prog1+A1sg
gelince	gel+Verb+Pos^DB+Adverb+When
gelişmesi	geliş+Verb+Pos^DB+Noun+Inf2+A3sg+P3sg+Nom
kısıtlanmış	kısıtla+Verb^DB+Verb+Pass+Pos^DB+Adj+NarrPart
çürür	çürü+Verb+Pos+Aor+A3sg
bozmak	boz+Verb+Pos^DB+Noun+Inf1+A3sg+Pnon+Nom
vermen	ver+Verb+Pos^DB+Noun+Inf2+A3sg+P2sg+Nom
edeceğim	et+Verb+Pos+Fut+A1sg
büyüleyici	büyüle+Verb+Pos^DB+Adj+Agt
olmanın	ol+Verb+Pos^DB+Noun+Inf2+A3sg+Pnon+Gen
taşır	taşı+Verb+Pos+Aor+A3sg
söyleyebileceklerimden	söyle+Verb+Pos^DB+Verb+Able^DB+Noun+FutPart+A3pl+P1sg+Abl
söyleyecektir	söyle+Verb+Pos+Fut+A3sg+Cop
çıkarıp	çık+Verb^DB+Verb+Caus+Pos^DB+Adverb+AfterDoingSo
tokalaşırken	toka+Noun+A3sg+Pnon+Nom^DB+Verb+Become+Pos+Aor^DB+Adverb+While
kutlamalısınız	kutla+Verb+Pos+Neces+A2pl
oldu	ol+Verb+Pos+Past+A3sg
aradığım	ara+Verb+Pos^DB+Adj+PastPart+P1sg
pembeleşmiş	pembe+Noun+A3sg+Pnon+Nom^DB+Verb+Become+Pos+Narr+A3sg
görünüyordu	görün+Verb+Pos+Prog1+Past+A3sg
olmanı	ol+Verb+Pos^DB+Noun+Inf2+A3sg+P2sg+Acc
nişanlandığından	nişanla+Verb^DB+Verb+Pass+Pos^DB+Noun+PastPart+A3sg+P3sg+Abl
söyledin	söyle+Verb+Pos+Past+A2sg
gelmeni	gel+Verb+Pos^DB+Noun+Inf2+A3sg+P2sg+Acc
karıştı	karış+Verb+Pos+Past+A3sg
koymuştu	koy+Verb+Pos+Narr+Past+A3sg
gelin	gel+Verb+Pos+Imp+A2pl
oturup	otur+Verb+Pos^DB+Adverb+AfterDoingSo
görelim	gör+Verb+Pos+Opt+A1pl
olup	ol+Verb+Pos^DB+Adverb+AfterDoingSo
bittiğini	bit+Verb+Pos^DB+Noun+PastPart+A3sg+P3sg+Acc
anlatırsın	anla+Verb^DB+Verb+Caus+Pos+Aor+A2sg
otururlarken	otur+Verb+Pos+Aor+A3pl^DB+Adverb+While
bitenin	bit+Verb+Pos^DB+Adj+PresPart^DB+Noun+Zero+A3sg+Pnon+Gen
ayrıldıktan	ayır+Verb^DB+Verb+Pass+Pos^DB+Noun+PastPart+A3sg+Pnon+Abl
giyindim	giy+Verb^DB+Verb+Reflex+Pos+Past+A1sg
tanıttığın	tanı+Verb^DB+Verb+Caus+Pos^DB+Noun+PastPart+A3sg+P2sg+Nom
yedim	ye+Verb+Pos+Past+A1sg
gittim	git+Verb+Pos+Past+A1sg
oynuyordu	oyna+Verb+Pos+Prog1+Past+A3sg
görmeliydiniz	gör+Verb+Pos+Neces+Past+A2pl
giymişti	giy+Verb+Pos+Narr+Past+A3sg
süslenmiş	süsle+Verb^DB+Verb+Pass+Pos+Narr+A3sg
taşıyordu	taş+Verb+Pos+Prog1+Past+A3sg
çevreleyen	çevrele+Verb+Pos^DB+Adj+PresPart
toplanmıştı	topla+Verb^DB+Verb+Pass+Pos+Narr+Past+A3sg
göreceksiniz	gör+Verb+Pos+Fut+A2pl
doğmuş	doğ+Verb+Pos+Narr+A3sg
titreyerek	titre+Verb+Pos^DB+Adverb+ByDoingSo
izledim	izle+Verb+Pos+Past+A1sg
olduğumu	ol+Verb+Pos^DB+Noun+PastPart+A3sg+P1sg+Acc
unuttum	unut+Verb+Pos+Past+A1sg
ilerliyordum	ilerle+Verb+Pos+Prog1+Past+A1sg
erdikten	er+Verb+Pos^DB+Noun+PastPart+A3sg+Pnon+Abl
gidip	git+Verb+Pos^DB+Adverb+AfterDoingSo
konuştum	konuş+Verb+Pos+Past+A1sg
otururken	otur+Verb+Pos+Aor^DB+Adverb+While
bakış	bak+Verb+Pos^DB+Noun+Inf3+A3sg+Pnon+Nom
peydahlandı	peydahla+Verb^DB+Verb+Pass+Pos+Past+A3sg
yaklaştı	yaklaş+Verb+Pos+Past+A3sg
öptük	öp+Verb+Pos+Past+A1pl
hissettiğimi	hisset+Verb+Pos^DB+Noun+PastPart+A3sg+P1sg+Acc
geliyordu	gel+Verb+Pos+Prog1+Past+A3sg
titredi	titre+Verb+Pos+Past+A3sg
ürperdi	ürper+Verb+Pos+Past+A3sg
kapanıp	kapa+Verb^DB+Verb+Pass+Pos^DB+Adverb+AfterDoingSo
ellerimi	elle+Verb+Pos^DB+Adj+AorPart^DB+Noun+Zero+A3sg+P1sg+Acc
gerektiğini	gerek+Verb+Pos^DB+Noun+PastPart+A3sg+P3sg+Acc
hissediyorum	hisset+Verb+Pos+Prog1+A1sg
söyleyecekler	söyle+Verb+Pos+Fut+A3pl
sinirlenecek	sinir+Noun+A3sg+Pnon+Nom^DB+Verb+Acquire+Pos+Fut+A3sg
olacağım	ol+Verb+Pos+Fut+A1sg
istediğim	iste+Verb+Pos^DB+Noun+PastPart+A3sg+P1sg+Nom
yapabilirim	yap+Verb+Pos^DB+Verb+Able+Aor+A1sg
kurtarabilir	kurtar+Verb+Pos^DB+Verb+Able+Aor+A3sg
bulabilirim	bul+Verb+Pos^DB+Verb+Able+Aor+A1sg
söyleyen	söyle+Verb+Pos^DB+Adj+PresPart
fısıldadılar	fısılda+Verb+Pos+Past+A3pl
sarıyor	sar+Verb+Pos+Prog1+A3sg
öpüyorum	öp+Verb+Pos+Prog1+A1sg
yaptın	yap+Verb+Pos+Past+A2sg
görüyor	gör+Verb+Pos+Prog1+A3sg
bıraktım	bırak+Verb+Pos+Past+A1sg
bulacağım	bul+Verb+Pos+Fut+A1sg
yudumladı	yudumla+Verb+Pos+Past+A3sg
unuttun	unut+Verb+Pos+Past+A2sg
sunup	sun+Verb+Pos^DB+Adverb+AfterDoingSo
sevdiğimi	sev+Verb+Pos^DB+Noun+PastPart+A3sg+P1sg+Acc
olmaya	ol+Verb+Pos^DB+Noun+Inf2+A3sg+Pnon+Dat
kıyasladığımda	kıyasla+Verb+Pos^DB+Noun+PastPart+A3sg+P1sg+Loc
kalıyor	kal+Verb+Pos+Prog1+A3sg
mırıldandı	mırıldan+Verb+Pos+Past+A3sg
söylemeyi	söyle+Verb+Pos^DB+Noun+Inf2+A3sg+Pnon+Acc
unuturuz	unut+Verb+Pos+Aor+A1pl
hatırlatırlar	hatırla+Verb^DB+Verb+Caus+Pos+Aor+A3pl
sinirlendiriyorsun	sinir+Noun+A3sg+Pnon+Nom^DB+Verb+Acquire^DB+Verb+Caus+Pos+Prog1+A2sg
sordum	sor+Verb+Pos+Past+A1sg
sorabilme	sor+Verb+Pos^DB+Verb+Able^DB+Noun+Inf2+A3sg+Pnon+Nom
kızmam	kız+Verb+Pos^DB+Noun+Inf2+A3sg+P1sg+Nom
gördüğünde	gör+Verb+Pos^DB+Noun+PastPart+A3sg+P3sg+Loc
üzebilecek	üz+Verb+Pos^DB+Verb+Able^DB+Adj+FutPart+Pnon
düşüneceksin	düşün+Verb+Pos+Fut+A2sg
sevdiği	sev+Verb+Pos^DB+Adj+PastPart+P3sg
eder	et+Verb+Pos+Aor+A3sg
seviyorum	sev+Verb+Pos+Prog1+A1sg
yerleştirmek	yerleş+Verb^DB+Verb+Caus+Pos^DB+Noun+Inf1+A3sg+Pnon+Nom
bakmak	bak+Verb+Pos^DB+Noun+Inf1+A3sg+Pnon+Nom
istiyorum	iste+Verb+Pos+Prog1+A1sg
geçiyorsun	geç+Verb+Pos+Prog1+A2sg
yapıyor	yap+Verb+Pos+Prog1+A3sg
olduğumda	ol+Verb+Pos^DB+Noun+PastPart+A3sg+P1sg+Loc
öğrettiğin	öğret+Verb+Pos^DB+Noun+PastPart+A3sg+P2sg+Nom
hayıflanıyorum	hayıf+Noun+A3sg+Pnon+Nom^DB+Verb+Acquire+Pos+Prog1+A1sg
tanıdığın	tanı+Verb+Pos^DB+Noun+PastPart+A3sg+P2sg+Nom
olmaktan	ol+Verb+Pos^DB+Noun+Inf1+A3sg+Pnon+Abl
uzaklaştım	uzak+Adj^DB+Verb+Become+Pos+Past+A1sg
değiştim	değiş+Verb+Pos+Past+A1sg
dokunuşu	doku+Verb^DB+Verb+Pass+Pos^DB+Noun+Inf3+A3sg+P3sg+Nom
zehirleyici	zehirle+Verb+Pos^DB+Noun+Agt+A3sg+Pnon+Nom
unutturdu	unut+Verb^DB+Verb+Caus+Pos+Past+A3sg
alırken	al+Verb+Pos+Aor^DB+Adverb+While
konmaya	kon+Verb+Pos^DB+Noun+Inf2+A3sg+Pnon+Dat
korkarım	kork+Verb+Pos+Aor+A1sg
olduğumuzda	ol+Verb+Pos^DB+Noun+PastPart+A3sg+P1pl+Loc
olduğumuz	ol+Verb+Pos^DB+Noun+PastPart+A3sg+P1pl+Nom
olmayız	ol+Verb+Pos^DB+Noun+Inf2+A3sg+Pnon+Nom^DB+Verb+Zero+Pres+A1pl
derken	de+Verb+Pos+Aor^DB+Adverb+While
kastediyorsun	kastet+Verb+Pos+Prog1+A2sg
yaslanıp	yasla+Verb^DB+Verb+Pass+Pos^DB+Adverb+AfterDoingSo
duran	dur+Verb+Pos^DB+Adj+PresPart
süsen	süs+Verb+Pos^DB+Adj+PresPart
olmasıdır	ol+Verb+Pos^DB+Noun+Inf2+A3sg+P3sg+Nom^DB+Verb+Zero+Pres+A3sg+Cop
dokunarak	dokun+Verb+Pos^DB+Adverb+ByDoingSo
zorlar	zorla+Verb+Pos+Aor+A3sg
istiyorsa	iste+Verb+Pos+Prog1+Cond+A3sg
böbürlenerek	böbürlen+Verb+Pos^DB+Adverb+ByDoingSo
koyabilir	koy+Verb+Pos^DB+Verb+Able+Aor+A3sg
etmeyi	et+Verb+Pos^DB+Noun+Inf2+A3sg+Pnon+Acc
gerektiriyor	gerek+Verb^DB+Verb+Caus+Pos+Prog1+A3sg
ediyorum	et+Verb+Pos+Prog1+A1sg
yaşarsa	yaşa+Verb+Pos+Aor+Cond+A3sg
yüklenmiş	yükle+Verb^DB+Verb+Pass+Pos+Narr+A3sg
almaya	al+Verb+Pos^DB+Noun+Inf2+A3sg+Pnon+Dat
ödemeye	öde+Verb+Pos^DB+Noun+Inf2+A3sg+Pnon+Dat
çekerek	çek+Verb+Pos^DB+Adverb+ByDoingSo
düştüğünün	düş+Verb+Pos^DB+Noun+PastPart+A3sg+P3sg+Gen
varmakla	var+Verb+Pos^DB+Noun+Inf1+A3sg+Pnon+Ins
silkti	silk+Verb+Pos+Past+A3sg
geçti	geç+Verb+Pos+Past+A3sg
kullanabilir	kullan+Verb+Pos^DB+Verb+Able+Aor+A3sg
demek	de+Verb+Pos^DB+Noun+Inf1+A3sg+Pnon+Nom
olunmaktan	ol+Verb^DB+Verb+Pass+Pos^DB+Noun+Inf1+A3sg+Pnon+Abl
oynayarak	oyna+Verb+Pos^DB+Adverb+ByDoingSo
duyulmak	duy+Verb^DB+Verb+Pass+Pos^DB+Noun+Inf1+A3sg+Pnon+Nom
davrandığı	davran+Verb+Pos^DB+Adj+PastPart+P3sg
davranırlar	davran+Verb+Pos+Aor+A3pl
taparlar	tap+Verb+Pos^DB+Adj+AorPart^DB+Noun+Zero+A3pl+Pnon+Nom
yapmamız	yap+Verb+Pos^DB+Noun+Inf2+A3sg+P1pl+Nom
ederler	ederle+Verb+Pos+Aor+A3sg
istedikleri	iste+Verb+Pos^DB+Noun+PastPart+A3pl+P3pl+Nom
vermiştir	ver+Verb+Pos+Narr+A3sg+Cop
yaratıyorlar	yara+Verb^DB+Verb+Caus+Pos+Prog1+A3pl
istemek	iste+Verb+Pos^DB+Noun+Inf1+A3sg+Pnon+Nom
etmelisin	et+Verb+Pos+Neces+A2sg
verirler	ver+Verb+Pos+Aor+A3pl
isterler	iste+Verb+Pos^DB+Adj+AorPart^DB+Noun+Zero+A3pl+Pnon+Nom
dediği	de+Verb+Pos^DB+Adj+PastPart+P3sg
getirip	getir+Verb+Pos^DB+Adverb+AfterDoingSo
yaratma	yarat+Verb+Pos^DB+Noun+Inf2+A3sg+Pnon+Nom
tamamlamamıza	tamamla+Verb+Pos^DB+Noun+Inf2+A3sg+P1pl+Dat
hoşlanıyorum	hoşlan+Verb+Pos+Prog1+A1sg
seveceksin	sev+Verb+Pos+Fut+A2sg
alır	al+Verb+Pos+Aor+A3sg
getir	getir+Verb+Pos+Imp+A2sg
boşver	boşver+Verb+Pos+Imp+A2sg
almalısın	al+Verb+Pos+Neces+A2sg
bırakır	bırak+Verb+Pos+Aor+A3sg
isteyebilir	iste+Verb+Pos^DB+Verb+Able+Aor+A3sg
olacaksın	ol+Verb+Pos+Fut+A2sg
işlemeye	işle+Verb+Pos^DB+Noun+Inf2+A3sg+Pnon+Dat
koyduğu	koy+Verb+Pos^DB+Adj+PastPart+P3sg
yakarken	yak+Verb+Pos+Aor^DB+Adverb+While
konuşuyorsun	konuş+Verb+Pos+Prog1+A2sg
gidelim	git+Verb+Pos+Opt+A1pl
çıktığında	çık+Verb+Pos^DB+Noun+PastPart+A3sg+P3sg+Loc
gösterecek	göster+Verb+Pos^DB+Adj+FutPart+Pnon
bakışla	bak+Verb+Pos^DB+Noun+Inf3+A3sg+Pnon+Ins
heyecanlandırabilir	heyecan+Noun+A3sg+Pnon+Nom^DB+Verb+Acquire^DB+Verb+Caus+Pos^DB+Verb+Able+Aor+A3sg
bayılırım	bayıl+Verb+Pos+Aor+A1sg
geleceksin	gel+Verb+Pos+Fut+A2sg
et	et+Verb+Pos+Imp+A2sg
giyip	giy+Verb+Pos^DB+Adverb+AfterDoingSo
yudumladılar	yudumla+Verb+Pos+Past+A3pl
olabilecek	ol+Verb+Pos^DB+Verb+Able^DB+Adj+FutPart+Pnon
görünmesine	görün+Verb+Pos^DB+Noun+Inf2+A3sg+P3sg+Dat
ayrıldı	ayır+Verb^DB+Verb+Pass+Pos+Past+A3sg
yanıp	yan+Verb+Pos^DB+Adverb+AfterDoingSo
sönen	sön+Verb+Pos^DB+Adj+PresPart
kapladı	kapla+Verb+Pos+Past+A3sg
hissediyordu	hisset+Verb+Pos+Prog1+Past+A3sg
girmişti	gir+Verb+Pos+Narr+Past+A3sg
koyulaştı	koyu+Adj^DB+Verb+Become+Pos+Past+A3sg
bulanıklaştı	bulanık+Adj^DB+Verb+Become+Pos+Past+A3sg
vardığında	var+Verb+Pos^DB+Noun+PastPart+A3sg+P3sg+Loc
yaşlanmış	yaş+Noun+A3sg+Pnon+Nom^DB+Verb+Acquire+Pos+Narr+A3sg
karşılayan	karşıla+Verb+Pos^DB+Adj+PresPart
varmıştı	var+Verb+Pos+Narr+Past+A3sg
sallayıp	salla+Verb+Pos^DB+Adverb+AfterDoingSo
konuşarak	konuş+Verb+Pos^DB+Adverb+ByDoingSo
götürdü	götür+Verb+Pos+Past+A3sg
görmeye	gör+Verb+Pos^DB+Noun+Inf2+A3sg+Pnon+Dat
geldiği	gel+Verb+Pos^DB+Noun+PastPart+A3sg+P3sg+Nom
karşılaşmış	karşılaş+Verb+Pos+Narr+A3sg
girmiş	gir+Verb+Pos+Narr+A3sg
hoşlanmıştı	hoşlan+Verb+Pos+Narr+Past+A3sg
belirterek	belir+Verb^DB+Verb+Caus+Pos^DB+Adverb+ByDoingSo
sallıyor	salla+Verb+Pos+Prog1+A3sg
mahvolan	mahvol+Verb+Pos^DB+Adj+PresPart
keşfeden	keşfet+Verb+Pos^DB+Adj+PresPart
karşılaşmaktan	karşılaş+Verb+Pos^DB+Noun+Inf1+A3sg+Pnon+Abl
duyduğunu	duy+Verb+Pos^DB+Noun+PastPart+A3sg+P3sg+Acc
ediyordu	et+Verb+Pos+Prog1+Past+A3sg
seyrederek	seyret+Verb+Pos^DB+Adverb+ByDoingSo
oyalamaktaydı	oyala+Verb+Pos^DB+Noun+Inf1+A3sg+Pnon+Loc^DB+Verb+Zero+Past+A3sg
benziyordu	benze+Verb+Pos+Prog1+Past+A3sg
asmışlardı	as+Verb+Pos+Narr+A3pl+Past
konuşup	konuş+Verb+Pos^DB+Adverb+AfterDoingSo
oturan	otur+Verb+Pos^DB+Adj+PresPart
yedikleri	ye+Verb+Pos^DB+Noun+PastPart+A3pl+P3pl+Nom
paylaştılar	paylaş+Verb+Pos+Past+A3pl
atan	at+Verb+Pos^DB+Adj+PresPart
fırlatılan	fırla+Verb^DB+Verb+Caus^DB+Verb+Pass+Pos^DB+Adj+PresPart
bulmak	bul+Verb+Pos^DB+Noun+Inf1+A3sg+Pnon+Nom
bulduğum	bul+Verb+Pos^DB+Noun+PastPart+A3sg+P1sg+Nom
unutacaksınız	unut+Verb+Pos+Fut+A2pl
gördüğünüz	gör+Verb+Pos^DB+Noun+PastPart+A3sg+P2pl+Nom
değişirler	değiş+Verb+Pos+Aor+A3pl
izlerler	izle+Verb+Pos+Aor+A3pl
hissettiriyorsa	hisset+Verb^DB+Verb+Caus+Pos+Prog1+Cond+A3sg
yapar	yap+Verb+Pos+Aor+A3sg
gülerler	gül+Verb+Pos^DB+Adj+AorPart^DB+Noun+Zero+A3pl+Pnon+Nom
tinselleştirir	tinsel+Noun+A3sg+Pnon+Nom^DB+Verb+Become^DB+Verb+Caus+Pos+Aor+A3sg
olduklarını	ol+Verb+Pos^DB+Noun+PastPart+A3sg+P3pl+Acc
hisseder	hisset+Verb+Pos+Aor+A3sg
geçirirken	geç+Verb^DB+Verb+Caus+Pos+Aor^DB+Adverb+While
alma	al+Verb+Pos^DB+Noun+Inf2+A3sg+Pnon+Nom
istediğini	iste+Verb+Pos^DB+Noun+PastPart+A3sg+P2sg+Acc
anladım	anla+Verb+Pos+Past+A1sg
inanıyorum	inan+Verb+Pos+Prog1+A1sg
duyduğun	duy+Verb+Pos^DB+Adj+PastPart+P2sg
olmalı	ol+Verb+Pos^DB+Noun+Inf2+A3sg+Pnon+Nom^DB+Adj+With
anlattığın	anlat+Verb+Pos^DB+Adj+PastPart+P2sg
yaratabilen	yara+Verb^DB+Verb+Caus+Pos^DB+Verb+Able^DB+Adj+PresPart
kazandırmak	kazan+Verb^DB+Verb+Caus+Pos^DB+Noun+Inf1+A3sg+Pnon+Nom
yaşamış	yaşa+Verb+Pos^DB+Adj+NarrPart
olanlara	ol+Verb+Pos^DB+Adj+PresPart^DB+Noun+Zero+A3pl+Pnon+Dat
katabilirse	kat+Verb+Pos^DB+Verb+Able+Aor+Cond+A3sg
sürdürenlerin	sür+Verb^DB+Verb+Caus+Pos^DB+Adj+PresPart^DB+Noun+Zero+A3pl+Pnon+Gen
yaratabilirse	yara+Verb^DB+Verb+Caus+Pos^DB+Verb+Able+Aor+Cond+A3sg
kurtarıp	kurtar+Verb+Pos^DB+Adverb+AfterDoingSo
dökebilmeyi	dök+Verb+Pos^DB+Verb+Able^DB+Noun+Inf2+A3sg+Pnon+Acc
öğretebilirse	öğret+Verb+Pos^DB+Verb+Able+Aor+Cond+A3sg
demektir	de+Verb+Pos^DB+Noun+Inf1+A3sg+Pnon+Nom^DB+Verb+Zero+Pres+A3sg+Cop
onaylıyorum	onayla+Verb+Pos+Prog1+A1sg
yaratmış	yarat+Verb+Pos+Narr+A3sg
olacaktın	ol+Verb+Pos+Fut+Past+A2sg
anlayacağını	anla+Verb+Pos^DB+Noun+FutPart+A3sg+P3sg+Acc
mahvediyor	mahvet+Verb+Pos+Prog1+A3sg
sürüyor	sür+Verb+Pos+Prog1+A3sg
kalkacak	kalk+Verb+Pos+Fut+A3sg
vereceğim	ver+Verb+Pos+Fut+A1sg
adayacağım	ada+Verb+Pos+Fut+A1sg
gördüğü	gör+Verb+Pos^DB+Adj+PastPart+P3sg
düşündü	düşün+Verb+Pos+Past+A3sg
andırıyordu	an+Verb^DB+Verb+Caus+Pos+Prog1+Past+A3sg
atarken	at+Verb+Pos+Aor^DB+Adverb+While
beliren	belir+Verb+Pos^DB+Adj+PresPart
düşmüştü	düş+Verb+Pos+Narr+Past+A3sg
attığında	at+Verb+Pos^DB+Noun+PastPart+A3sg+P3sg+Loc
titriyordu	titre+Verb+Pos+Prog1+Past+A3sg
fırlayıp	fırla+Verb+Pos^DB+Adverb+AfterDoingSo
alkışlamaya	alkışla+Verb+Pos^DB+Noun+Inf2+A3sg+Pnon+Dat
başladı	başla+Verb+Pos+Past+A3sg
bakıyor	bak+Verb+Pos+Prog1+A3sg
mırıldanıyordu	mırıldan+Verb+Pos+Prog1+Past+A3sg
geçiyordu	geç+Verb+Pos+Prog1+Past+A3sg
girdi	gir+Verb+Pos+Past+A3sg
giriş	gir+Verb+Pos^DB+Noun+Inf3+A3sg+Pnon+Nom
gelmiş	gel+Verb+Pos+Narr+A3sg
salındı	sal+Verb^DB+Verb+Pass+Pos+Past+A3sg
durdu	dur+Verb+Pos+Past+A3sg
yapılmıştı	yap+Verb^DB+Verb+Pass+Pos+Narr+Past+A3sg
sabitlediğinde	sabitle+Verb+Pos^DB+Noun+PastPart+A3sg+P3sg+Loc
söylemek	söyle+Verb+Pos^DB+Noun+Inf1+A3sg+Pnon+Nom
ediyorsun	et+Verb+Pos+Prog1+A2sg
şereflenir	şeref+Noun+A3sg+Pnon+Nom^DB+Verb+Acquire+Pos+Aor+A3sg
değdiğinden	değ+Verb+Pos^DB+Noun+PastPart+A3sg+P3sg+Abl
öpüşür	öp+Verb^DB+Verb+Recip+Pos^DB+Adj+AorPart
yapmacık	yap+Verb+Pos^DB+Noun+Inf2+A3sg+Pnon+Nom^DB+Noun+Dim+A3sg+Pnon+Nom
konuştu	konuş+Verb+Pos+Past+A3sg
olmasına	ol+Verb+Pos^DB+Noun+Inf2+A3sg+P3sg+Dat
ayarlamakta	ayarla+Verb+Pos^DB+Noun+Inf1+A3sg+Pnon+Loc
çıkışlarını	çık+Verb+Pos^DB+Noun+Inf3+A3pl+P3sg+Acc
edip	et+Verb+Pos^DB+Adverb+AfterDoingSo
yarattı	yarat+Verb+Pos+Past+A3sg
izlerken	izle+Verb+Pos+Aor^DB+Adverb+While
giderek	git+Verb+Pos^DB+Adverb+ByDoingSo
solgunlaştı	solgun+Adj^DB+Verb+Become+Pos+Past+A3sg
sormaya	sor+Verb+Pos^DB+Noun+Inf2+A3sg+Pnon+Dat
görünmüştü	görün+Verb+Pos+Narr+Past+A3sg
uğramışlardı	uğra+Verb+Pos+Narr+A3pl+Past
değerlendirebilecekleri	değer+Noun+A3sg+Pnon+Nom^DB+Verb+Acquire^DB+Verb+Caus+Pos^DB+Verb+Able^DB+Noun+FutPart+A3sg+P3pl+Nom
olacağını	ol+Verb+Pos^DB+Noun+FutPart+A3sg+P3sg+Acc
düşündüklerinden	düşün+Verb+Pos^DB+Noun+PastPart+A3sg+P3pl+Abl
beklediler	bekle+Verb+Pos+Past+A3pl
yapmacıklık	yap+Verb+Pos^DB+Noun+Inf2+A3sg+Pnon+Nom^DB+Noun+Dim+A3sg+Pnon+Nom^DB+Noun+Ness+A3sg+Pnon+Nom
dayanılır	daya+Verb^DB+Verb+Pass+Pos+Aor+A3sg
kötüleşti	kötü+Adj^DB+Verb+Become+Pos+Past+A3sg
denecek	de+Verb^DB+Verb+Pass+Pos+Fut+A3sg
vurguluyordu	vurgula+Verb+Pos+Prog1+Past+A3sg
yaraşır	yaraş+Verb+Pos+Aor+A3sg
okudu	oku+Verb+Pos+Past+A3sg
okuduğunu	oku+Verb+Pos^DB+Noun+PastPart+A3sg+P3sg+Acc
düşündürüyordu	düşün+Verb^DB+Verb+Caus+Pos+Prog1+Past+A3sg
abandığı	aban+Verb+Pos^DB+Adj+PastPart+P3sg
anlaşmamızdan	anlaş+Verb+Pos^DB+Noun+Inf2+A3sg+P1pl+Abl
biten	bit+Verb+Pos^DB+Adj+PresPart
saçıyor	saç+Verb+Pos+Prog1+A3sg
diyemeden	de+Verb+Pos^DB+Adverb+WithoutBeingAbleToHaveDoneSo
yazın	yaz+Verb+Pos+Imp+A2pl
geldiğimizde	gel+Verb+Pos^DB+Noun+PastPart+A3sg+P1pl+Loc
izleyicilerin	izle+Verb+Pos^DB+Noun+Agt+A3pl+Pnon+Gen
dağıldı	dağıl+Verb+Pos+Past+A3sg
çıkarmaya	çık+Verb^DB+Verb+Caus+Pos^DB+Noun+Inf2+A3sg+Pnon+Dat
başladılar	başla+Verb+Pos+Past+A3pl
vurarak	vur+Verb+Pos^DB+Adverb+ByDoingSo
küfretmeye	küfret+Verb+Pos^DB+Noun+Inf2+A3sg+Pnon+Dat
kalabilen	kal+Verb+Pos^DB+Verb+Able^DB+Adj+PresPart
erdiğinde	er+Verb+Pos^DB+Noun+PastPart+A3sg+P3sg+Loc
duyuldu	duy+Verb^DB+Verb+Pass+Pos+Past+A3sg
giydi	giy+Verb+Pos+Past+A3sg
izleyeceğim	izle+Verb+Pos+Fut+A1sg
ettiğim	et+Verb+Pos^DB+Adj+PastPart+P1sg
diliyorum	dile+Verb+Pos+Prog1+A1sg
geliriz	gel+Verb+Pos+Aor+A1pl
göründü	görün+Verb+Pos+Past+A3sg
değişmiş	değiş+Verb+Pos+Narr+A3sg
izlediğim	izle+Verb+Pos^DB+Adj+PastPart+P1sg
kaptırmıştı	kap+Verb^DB+Verb+Caus+Pos+Narr+Past+A3sg
faydalanarak	fayda+Noun+A3sg+Pnon+Nom^DB+Verb+Acquire+Pos^DB+Adverb+ByDoingSo
evlendirmesi	evlen+Verb^DB+Verb+Caus+Pos^DB+Noun+Inf2+A3sg+P3sg+Nom
sayılacaktı	say+Verb^DB+Verb+Pass+Pos+Fut+Past+A3sg
çekiciydi	çek+Verb+Pos^DB+Noun+Agt+A3sg+Pnon+Nom^DB+Verb+Zero+Past+A3sg
sonuçlanırsa	sonuç+Noun+A3sg+Pnon+Nom^DB+Verb+Acquire+Pos+Aor+Cond+A3sg
bildiği	bil+Verb+Pos^DB+Noun+PastPart+A3sg+P3sg+Nom
geçtim	geç+Verb+Pos+Past+A1sg
andırır	an+Verb^DB+Verb+Caus+Pos+Aor+A3sg
inanırdı	inan+Verb+Pos+Aor+Past+A3sg
canlandırıyordu	can+Noun+A3sg+Pnon+Nom^DB+Verb+Acquire^DB+Verb+Caus+Pos+Prog1+Past+A3sg
düşünmek	düşün+Verb+Pos^DB+Noun+Inf1+A3sg+Pnon+Nom
veriyordu	ver+Verb+Pos+Prog1+Past+A3sg
oturuyordu	otur+Verb+Pos+Prog1+Past+A3sg
istediği	iste+Verb+Pos^DB+Noun+PastPart+A3sg+P3sg+Nom
hazırlamıştı	hazırla+Verb+Pos+Narr+Past+A3sg
çizilmişti	çiz+Verb^DB+Verb+Pass+Pos+Narr+Past+A3sg
atılmak	at+Verb^DB+Verb+Pass+Pos^DB+Noun+Inf1+A3sg+Pnon+Nom
sabırsızlanıyordu	sabır+Noun+A3sg+Pnon+Nom^DB+Adj+Without^DB+Verb+Acquire+Pos+Prog1+Past+A3sg
gecikmeleri	gecik+Verb+Pos^DB+Noun+Inf2+A3pl+P3sg+Nom
düşündükçe	düşün+Verb+Pos^DB+Adverb+AsLongAs
kemiriyordu	kemir+Verb+Pos+Prog1+Past+A3sg
gecikmeye	gecik+Verb+Pos^DB+Noun+Inf2+A3sg+Pnon+Dat
gelmişken	gel+Verb+Pos+Narr^DB+Adverb+While
denemişti	dene+Verb+Pos+Narr+Past+A3sg
çalkalandığını	çalkala+Verb^DB+Verb+Pass+Pos^DB+Noun+PastPart+A3sg+P3sg+Acc
biliyordu	bile+Verb+Pos+Prog1+Past+A3sg
kesin	kes+Verb+Pos+Imp+A2pl
gelişinden	gel+Verb+Pos^DB+Noun+Inf3+A3sg+P3sg+Abl
dolaşmaya	dolaş+Verb+Pos^DB+Noun+Inf2+A3sg+Pnon+Dat
başlamıştı	başla+Verb+Pos+Narr+Past+A3sg
sardı	sar+Verb+Pos+Past+A3sg
vereceği	ver+Verb+Pos^DB+Adj+FutPart+P3sg
konuşulmaya	konuş+Verb^DB+Verb+Pass+Pos^DB+Noun+Inf2+A3sg+Pnon+Dat
başlandı	başla+Verb^DB+Verb+Pass+Pos+Past+A3sg
kararlaştırılmıştı	karar+Noun+A3sg+Pnon+Nom^DB+Verb+Become^DB+Verb+Caus^DB+Verb+Pass+Pos+Narr+Past+A3sg
çıkmıştı	çık+Verb+Pos+Narr+Past+A3sg
tanırlar	tanı+Verb+Pos+Aor+A3pl
batan	bat+Verb+Pos^DB+Adj+PresPart
çıktığı	çık+Verb+Pos^DB+Noun+PastPart+A3sg+P3sg+Nom
inandıklarından	inan+Verb+Pos^DB+Noun+PastPart+A3sg+P3pl+Abl
yayıldıkça	yay+Verb^DB+Verb+Pass+Pos^DB+Adverb+AsLongAs
yayıldı	yay+Verb^DB+Verb+Pass+Pos+Past+A3sg
kökleşti	kök+Adj^DB+Verb+Become+Pos+Past+A3sg
konuşmanın	konuş+Verb+Pos^DB+Noun+Inf2+A3sg+Pnon+Gen
çakışmasıydı	çakış+Verb+Pos^DB+Noun+Inf2+A3sg+P3sg+Nom^DB+Verb+Zero+Past+A3sg
süren	sür+Verb+Pos^DB+Adj+PresPart
incelemelerine	incele+Verb+Pos^DB+Noun+Inf2+A3sg+P3pl+Dat
dayanır	dayan+Verb+Pos+Aor+A3sg
saklaması	sakla+Verb+Pos^DB+Noun+Inf2+A3sg+P3sg+Nom
bilir	bil+Verb+Pos+Aor+A3sg
bilirler	bil+Verb+Pos^DB+Adj+AorPart^DB+Noun+Zero+A3pl+Pnon+Nom
doğuştan	doğ+Verb+Pos^DB+Noun+Inf3+A3sg+Pnon+Abl
olması	ol+Verb+Pos^DB+Noun+Inf2+A3sg+P3sg+Nom
rastladıkça	rastla+Verb+Pos^DB+Adverb+AsLongAs
etmekten	et+Verb+Pos^DB+Noun+Inf1+A3sg+Pnon+Abl
umursadığı	umursa+Verb+Pos^DB+Adj+PastPart+P3sg
söyleyelim	söyle+Verb+Pos+Opt+A1pl
ayrılsa	ayır+Verb^DB+Verb+Pass+Pos+Desr+A3sg
arayanlar	ara+Verb+Pos^DB+Adj+PresPart^DB+Noun+Zero+A3pl+Pnon+Nom
basacaktı	bas+Verb+Pos+Fut+Past+A3sg
yaşıyormuş	yaşa+Verb+Pos+Prog1+Narr+A3sg
olmadan	ol+Verb+Pos^DB+Adverb+WithoutHavingDoneSo
davranıyordu	davran+Verb+Pos+Prog1+Past+A3sg
anlatılan	anla+Verb^DB+Verb+Caus^DB+Verb+Pass+Pos^DB+Adj+PresPart
beğenmiş	beğen+Verb+Pos+Narr+A3sg
girecek	gir+Verb+Pos+Fut+A3sg
kalınca	kal+Verb+Pos^DB+Adverb+When
bilebilirdi	bil+Verb+Pos^DB+Verb+Able+Aor+Past+A3sg
biçilmiş	biç+Verb^DB+Verb+Pass+Pos+Narr+A3sg
çıkmaya	çık+Verb+Pos^DB+Noun+Inf2+A3sg+Pnon+Dat
düşürülüp	düş+Verb^DB+Verb+Caus^DB+Verb+Pass+Pos^DB+Adverb+AfterDoingSo
kandırıldığını	kan+Verb^DB+Verb+Caus^DB+Verb+Pass+Pos^DB+Noun+PastPart+A3sg+P3sg+Acc
soyulduğunu	soy+Verb^DB+Verb+Pass+Pos^DB+Noun+PastPart+A3sg+P3sg+Acc
bağırıyorlardı	bağır+Verb+Pos+Prog1+A3pl+Past
yırtıcı	yırt+Verb+Pos^DB+Noun+Agt+A3sg+Pnon+Nom
kurtarmak	kurtar+Verb+Pos^DB+Noun+Inf1+A3sg+Pnon+Nom
kalır	kal+Verb+Pos+Aor+A3sg
evlenebilirlerdi	evlen+Verb+Pos^DB+Verb+Able+Aor+A3pl+Past
bağırıp	bağır+Verb+Pos^DB+Adverb+AfterDoingSo
çağırmaları	çağır+Verb+Pos^DB+Noun+Inf2+A3pl+P3sg+Nom
olmakla	ol+Verb+Pos^DB+Noun+Inf1+A3sg+Pnon+Ins
çıkarmak	çık+Verb^DB+Verb+Caus+Pos^DB+Noun+Inf1+A3sg+Pnon+Nom
geçirmek	geç+Verb^DB+Verb+Caus+Pos^DB+Noun+Inf1+A3sg+Pnon+Nom
isteyenlerle	iste+Verb+Pos^DB+Adj+PresPart^DB+Noun+Zero+A3pl+Pnon+Ins
savaşmak	savaş+Verb+Pos^DB+Noun+Inf1+A3sg+Pnon+Nom
yakalayıp	yakala+Verb+Pos^DB+Adverb+AfterDoingSo
götürse	götür+Verb+Pos+Desr+A3sg
reddedilmesi	reddet+Verb^DB+Verb+Pass+Pos^DB+Noun+Inf2+A3sg+P3sg+Nom
güvenebilirdi	güven+Verb+Pos^DB+Verb+Able+Aor+Past+A3sg
dalarlardı	dal+Verb+Pos+Aor+A3pl+Past
kaybetmenin	kaybet+Verb+Pos^DB+Noun+Inf2+A3sg+Pnon+Gen
gelişmeye	geliş+Verb+Pos^DB+Noun+Inf2+A3sg+Pnon+Dat
bahsetmeyi	bahset+Verb+Pos^DB+Noun+Inf2+A3sg+Pnon+Acc
uçarcasına	uç+Verb+Pos+Aor+A3sg^DB+Adverb+AsIf
gidiyor	git+Verb+Pos+Prog1+A3sg
sokmak	sok+Verb+Pos^DB+Noun+Inf1+A3sg+Pnon+Nom
gerekirse	gerek+Verb+Pos+Aor+Cond+A3sg
dövüşmeye	döv+Verb^DB+Verb+Recip+Pos^DB+Noun+Inf2+A3sg+Pnon+Dat
hazırlanıyordu	hazırla+Verb^DB+Verb+Pass+Pos+Prog1+Past+A3sg
gerçekleştireceğini	gerçek+Noun+A3sg+Pnon+Nom^DB+Verb+Become^DB+Verb+Caus+Pos^DB+Noun+FutPart+A3sg+P3sg+Acc
rastlayacağını	rastla+Verb+Pos^DB+Noun+FutPart+A3sg+P3sg+Acc
batsa	bat+Verb+Pos+Desr+A3sg
inanıyordu	inan+Verb+Pos+Prog1+Past+A3sg
keserek	kes+Verb+Pos^DB+Adverb+ByDoingSo
uğratıp	uğra+Verb^DB+Verb+Caus+Pos^DB+Adverb+AfterDoingSo
getirdiğini	getir+Verb+Pos^DB+Noun+PastPart+A3sg+P3sg+Acc
soranlar	sor+Verb+Pos^DB+Adj+PresPart^DB+Noun+Zero+A3pl+Pnon+Nom
olacaktır	ol+Verb+Pos+Fut+A3sg+Cop
sayılacağını	say+Verb^DB+Verb+Pass+Pos^DB+Noun+FutPart+A3sg+P3sg+Acc
söylemeye	söyle+Verb+Pos^DB+Noun+Inf2+A3sg+Pnon+Dat
gelmek	gel+Verb+Pos^DB+Noun+Inf1+A3sg+Pnon+Nom
yaklaşan	yaklaş+Verb+Pos^DB+Adj+PresPart
ürken	ürk+Verb+Pos^DB+Adj+PresPart
asmadan	as+Verb+Pos^DB+Noun+Inf2+A3sg+Pnon+Abl
bindirdi	bin+Verb^DB+Verb+Caus+Pos+Past+A3sg
almak	al+Verb+Pos^DB+Noun+Inf1+A3sg+Pnon+Nom
giden	git+Verb+Pos^DB+Adj+PresPart
uyardı	uyar+Verb+Pos+Past+A3sg
unuttuğu	unut+Verb+Pos^DB+Adj+PastPart+P3sg
durmadan	dur+Verb+Pos^DB+Noun+Inf2+A3sg+Pnon+Abl
karıştırdığı	karış+Verb^DB+Verb+Caus+Pos^DB+Adj+PastPart+P3sg
gidiyordu	git+Verb+Pos+Prog1+Past+A3sg
içmişti	iç+Verb+Pos+Narr+Past+A3sg
yemekte	ye+Verb+Pos^DB+Noun+Inf1+A3sg+Pnon+Loc
yuvarladı	yuvarla+Verb+Pos+Past+A3sg
cıvıttı	cıvı+Verb^DB+Verb+Caus+Pos+Past+A3sg
dolduruyordu	dol+Verb^DB+Verb+Caus+Pos+Prog1+Past+A3sg
neşelendirmeye	neşe+Noun+A3sg+Pnon+Nom^DB+Verb+Acquire^DB+Verb+Caus+Pos^DB+Noun+Inf2+A3sg+Pnon+Dat
çalışıyordu	çalış+Verb+Pos+Prog1+Past+A3sg
somurtuyorlardı	somur+Verb^DB+Verb+Caus+Pos+Prog1+A3pl+Past
bürünmüştü	bürü+Verb^DB+Verb+Pass+Pos+Narr+Past+A3sg
yiyordu	ye+Verb+Pos+Prog1+Past+A3sg
duymaya	duy+Verb+Pos^DB+Noun+Inf2+A3sg+Pnon+Dat
olacaktı	ol+Verb+Pos+Fut+Past+A3sg
kızarmış	kız+Verb+Pos+Aor+Narr+A3sg
korkutmaya	kork+Verb^DB+Verb+Caus+Pos^DB+Noun+Inf2+A3sg+Pnon+Dat
yetmişti	yet+Verb+Pos+Narr+Past+A3sg
korktuğuna	kork+Verb+Pos^DB+Noun+PastPart+A3sg+P3sg+Dat
uğruyordu	uğra+Verb+Pos+Prog1+Past+A3sg
tutması	tut+Verb+Pos^DB+Noun+Inf2+A3sg+P3sg+Nom
gerekirken	gerek+Verb+Pos+Aor^DB+Adverb+While
oturuyor	otur+Verb+Pos+Prog1+A3sg
oluyordu	ol+Verb+Pos+Prog1+Past+A3sg
kalkarken	kalk+Verb+Pos+Aor^DB+Adverb+While
biter	bit+Verb+Pos+Aor+A3sg
gelerek	gel+Verb+Pos^DB+Adverb+ByDoingSo
üzülerek	üz+Verb^DB+Verb+Pass+Pos^DB+Adverb+ByDoingSo
bozularak	boz+Verb^DB+Verb+Pass+Pos^DB+Adverb+ByDoingSo
anlatayım	anlat+Verb+Pos+Opt+A1sg
verin	ver+Verb+Pos+Imp+A2pl
karşılaştım	karşılaş+Verb+Pos+Past+A1sg
kızdı	kız+Verb+Pos+Past+A3sg
gel	gel+Verb+Pos+Imp+A2sg
tutturdu	tut+Verb^DB+Verb+Caus+Pos+Past+A3sg
kalkar	kalk+Verb+Pos+Aor+A3sg
içer	içer+Verb+Pos+Imp+A2sg
yapayım	yap+Verb+Pos+Opt+A1sg
düşünün	düşün+Verb+Pos+Imp+A2pl
kaybettiği	kaybet+Verb+Pos^DB+Noun+PastPart+A3sg+P3sg+Nom
kurtarmıştı	kurtar+Verb+Pos+Narr+Past+A3sg
etmişti	et+Verb+Pos+Narr+Past+A3sg
evlenirsek	evlen+Verb+Pos+Aor+Cond+A1pl
söylediklerine	söyle+Verb+Pos^DB+Noun+PastPart+A3pl+P3pl+Dat
tutarsak	tut+Verb+Pos+Aor+Cond+A1pl
bırakabilir	bırak+Verb+Pos^DB+Verb+Able+Aor+A3sg
düşünüyorsunuz	düşün+Verb+Pos+Prog1+A2pl
gizleyebiliyordu	gizle+Verb+Pos^DB+Verb+Able+Prog1+Past+A3sg
gidin	git+Verb+Pos+Imp+A2pl
etmeniz	et+Verb+Pos^DB+Noun+Inf2+A3sg+P2pl+Nom
gerekirdi	gerek+Verb+Pos+Aor+Past+A3sg
verdiğinizi	ver+Verb+Pos^DB+Noun+PastPart+A3sg+P2pl+Acc
göstermelisiniz	göster+Verb+Pos+Neces+A2pl
oturanlarla	otur+Verb+Pos^DB+Adj+PresPart^DB+Noun+Zero+A3pl+Pnon+Ins
söylüyordunuz	söyle+Verb+Pos+Prog1+Past+A2pl
yanılabilirim	yan+Verb^DB+Verb+Pass+Pos^DB+Verb+Able+Aor+A1sg
söylediğimi	söyle+Verb+Pos^DB+Noun+PastPart+A3sg+P1sg+Acc
gelmiştir	gel+Verb+Pos+Narr+A3sg+Cop
sayılır	say+Verb^DB+Verb+Pass+Pos+Aor+A3sg
değiştirmeliyim	değiş+Verb^DB+Verb+Caus+Pos+Neces+A1sg
ayıplayacağını	ayıpla+Verb+Pos^DB+Noun+FutPart+A3sg+P3sg+Acc
bakın	bakın+Verb+Pos+Imp+A2sg
bahsedin	bahset+Verb+Pos+Imp+A2pl
saydığımı	say+Verb+Pos^DB+Noun+PastPart+A3sg+P1sg+Acc
duyduğumu	duy+Verb+Pos^DB+Noun+PastPart+A3sg+P1sg+Acc
söyleyin	söyle+Verb+Pos+Imp+A2pl
getirerek	getir+Verb+Pos^DB+Adverb+ByDoingSo
canlandırdınız	can+Noun+A3sg+Pnon+Nom^DB+Verb+Acquire^DB+Verb+Caus+Pos+Past+A2pl
açmaya	aç+Verb+Pos^DB+Noun+Inf2+A3sg+Pnon+Dat
çekiniyordum	çekin+Verb+Pos+Prog1+Past+A1sg
çıkayım	çık+Verb+Pos+Opt+A1sg
anlatın	anla+Verb^DB+Verb+Caus+Pos+Imp+A2pl
değiştirdim	değiş+Verb^DB+Verb+Caus+Pos+Past+A1sg
giderdi	gider+Verb+Pos+Past+A3sg
tıkanacaktı	tıka+Verb^DB+Verb+Pass+Pos+Fut+Past+A3sg
ediyor	et+Verb+Pos+Prog1+A3sg
çıkıp	çık+Verb+Pos^DB+Adverb+AfterDoingSo
giyerken	giy+Verb+Pos+Aor^DB+Adverb+While
kollayan	kolla+Verb+Pos^DB+Adj+PresPart
dikildi	dik+Verb^DB+Verb+Pass+Pos+Past+A3sg
yakalayarak	yakala+Verb+Pos^DB+Adverb+ByDoingSo
gidiyorum	git+Verb+Pos+Prog1+A1sg
gülelim	gül+Verb+Pos+Opt+A1pl
bıraksın	bırak+Verb+Pos+Imp+A3sg
giderseniz	git+Verb+Pos+Aor+Cond+A2pl
edin	et+Verb+Pos+Imp+A2pl
sandığınız	san+Verb+Pos^DB+Adj+PastPart+P2pl
verecekler	ver+Verb+Pos+Fut+A3pl
duydum	duy+Verb+Pos+Past+A1sg
görün	gör+Verb+Pos+Imp+A2pl
dinleyin	dinle+Verb+Pos+Imp+A2pl
dönen	dön+Verb+Pos^DB+Adj+PresPart
basarak	bas+Verb+Pos^DB+Adverb+ByDoingSo
yürüdü	yürü+Verb+Pos+Past+A3sg
gözetleyerek	gözetle+Verb+Pos^DB+Adverb+ByDoingSo
dinlediği	dinle+Verb+Pos^DB+Noun+PastPart+A3sg+P3sg+Nom
bölmeye	böl+Verb+Pos^DB+Noun+Inf2+A3sg+Pnon+Dat
sokulup	sok+Verb^DB+Verb+Pass+Pos^DB+Adverb+AfterDoingSo
dinledikten	dinle+Verb+Pos^DB+Noun+PastPart+A3sg+Pnon+Abl
anlarsınız	anla+Verb+Pos+Aor+A2pl
başlar	başla+Verb+Pos+Aor+A3sg
kandıracakları	kan+Verb^DB+Verb+Caus+Pos^DB+Noun+FutPart+A3pl+P3pl+Nom
çıktığınız	çık+Verb+Pos^DB+Adj+PastPart+P2pl
varması	var+Verb+Pos^DB+Noun+Inf2+A3sg+P3sg+Nom
kandırmaya	kan+Verb^DB+Verb+Caus+Pos^DB+Noun+Inf2+A3sg+Pnon+Dat
uğraştı	uğraş+Verb+Pos+Past+A3sg
bastırıp	bas+Verb^DB+Verb+Caus+Pos^DB+Adverb+AfterDoingSo
bitirivermenin	bit+Verb^DB+Verb+Caus+Pos^DB+Verb+Hastily^DB+Noun+Inf2+A3sg+Pnon+Gen
bulandı	bula+Verb^DB+Verb+Pass+Pos+Past+A3sg
dinledim	dinle+Verb+Pos+Past+A1sg
batırdıklarını	bat+Verb^DB+Verb+Caus+Pos^DB+Noun+PastPart+A3pl+P3pl+Acc
duymalıydınız	duy+Verb+Pos+Neces+Past+A2pl
koydular	koy+Verb+Pos+Past+A3pl
süslenip	süsle+Verb^DB+Verb+Reflex+Pos^DB+Adverb+AfterDoingSo
püslenecektim	püsle+Verb^DB+Verb+Reflex+Pos+Fut+Past+A1sg
duyacaksınız	duy+Verb+Pos+Fut+A2pl
dinleyeyim	dinle+Verb+Pos+Opt+A1sg
dayayın	daya+Verb+Pos+Imp+A2pl
geldikten	gel+Verb+Pos^DB+Noun+PastPart+A3sg+Pnon+Abl
olun	ol+Verb+Pos+Imp+A2pl
gösteriyorum	göster+Verb+Pos+Prog1+A1sg
yapıyorsunuz	yap+Verb+Pos+Prog1+A2pl
gideceğim	git+Verb+Pos+Fut+A1sg
zorlayarak	zorla+Verb+Pos^DB+Adverb+ByDoingSo
yapıştırdı	yapış+Verb^DB+Verb+Caus+Pos+Past+A3sg
çarpıyor	çarp+Verb+Pos+Prog1+A3sg
atıyordu	ata+Verb+Pos+Prog1+Past+A3sg
başlamak	başla+Verb+Pos^DB+Noun+Inf1+A3sg+Pnon+Nom
isteyen	iste+Verb+Pos^DB+Adj+PresPart
hazırladığı	hazırla+Verb+Pos^DB+Noun+PastPart+A3sg+P3sg+Nom
süzerek	süz+Verb+Pos^DB+Adverb+ByDoingSo
eğlendiniz	eğlen+Verb+Pos+Past+A2pl
kopacak	kop+Verb+Pos+Fut+A3sg
yemekten	ye+Verb+Pos^DB+Noun+Inf1+A3sg+Pnon+Abl
geçirmişlerdi	geç+Verb^DB+Verb+Caus+Pos+Narr+A3pl+Past
gevşemişti	gevşe+Verb+Pos+Narr+Past+A3sg
vurmuştu	vur+Verb+Pos+Narr+Past+A3sg
ağırlaşıp	ağır+Adj^DB+Verb+Become+Pos^DB+Adverb+AfterDoingSo
uyumak	uyu+Verb+Pos^DB+Noun+Inf1+A3sg+Pnon+Nom
duyacağını	duy+Verb+Pos^DB+Noun+FutPart+A3sg+P3sg+Acc
anlıyordu	anla+Verb+Pos+Prog1+Past+A3sg
geçirdikten	geç+Verb^DB+Verb+Caus+Pos^DB+Noun+PastPart+A3sg+Pnon+Abl
bakışlarında	bak+Verb+Pos^DB+Noun+Inf3+A3pl+P3sg+Loc
sezdi	sez+Verb+Pos+Past+A3sg
eğ	eğ+Verb+Pos+Imp+A2sg
övülmesine	öv+Verb^DB+Verb+Pass+Pos^DB+Noun+Inf2+A3sg+P3sg+Dat
alevlendi	alev+Noun+A3sg+Pnon+Nom^DB+Verb+Acquire+Pos+Past+A3sg
övmenize	öv+Verb+Pos^DB+Noun+Inf2+A3sg+P2pl+Dat
demeli	de+Verb+Pos+Neces+A3sg
gösteriş	göster+Verb+Pos^DB+Noun+Inf3+A3sg+Pnon+Nom
kaldırın	kaldır+Verb+Pos+Imp+A2pl
bulacaksınız	bul+Verb+Pos+Fut+A2pl
diyorsunuz	de+Verb+Pos+Prog1+A2pl
bak	bak+Verb+Pos+Imp+A2sg
anlatmalıyım	anla+Verb^DB+Verb+Caus+Pos+Neces+A1sg
hatırladın	hatırla+Verb+Pos+Past+A2sg
gösterdiğiniz	göster+Verb+Pos^DB+Adj+PastPart+P2pl
bahsediyorum	bahset+Verb+Pos+Prog1+A1sg
güldürmek	gül+Verb^DB+Verb+Caus+Pos^DB+Noun+Inf1+A3sg+Pnon+Nom
bakar	bak+Verb+Pos+Aor+A3sg
anlatmak	anla+Verb^DB+Verb+Caus+Pos^DB+Noun+Inf1+A3sg+Pnon+Nom
ettik	et+Verb+Pos+Past+A1pl
çıktım	çık+Verb+Pos+Past+A1sg
hatırlıyorum	hatırla+Verb+Pos+Prog1+A1sg
baktım	bak+Verb+Pos+Past+A1sg
dersiniz	de+Verb+Pos+Aor+A2pl
verir	ver+Verb+Pos+Aor+A3sg
di	de+Verb+Pos+Imp+A2sg
yor	yor+Verb+Pos+Imp+A2sg
yemiş	ye+Verb+Pos+Narr+A3sg
buldunuz	bul+Verb+Pos+Past+A2pl
versem	ver+Verb+Pos+Desr+A1sg
ölürüm	öl+Verb+Pos+Aor+A1sg
etmeye	et+Verb+Pos^DB+Noun+Inf2+A3sg+Pnon+Dat
başlayacağım	başla+Verb+Pos+Fut+A1sg
süz	süz+Verb+Pos+Imp+A2sg
yıkasaydı	yıka+Verb+Pos+Desr+Past+A3sg
konuşuyor	konuş+Verb+Pos+Prog1+A3sg
artan	art+Verb+Pos^DB+Adj+PresPart
süzüyordu	süz+Verb+Pos+Prog1+Past+A3sg
eriyecek	eri+Verb+Pos+Fut+A3sg
mırıldanıp	mırılda+Verb^DB+Verb+Pass+Pos^DB+Adverb+AfterDoingSo
duruyordu	dur+Verb+Pos+Prog1+Past+A3sg
çalsana	çal+Verb+Pos+Imp+A2sg
ürperten	ürper+Verb^DB+Verb+Caus+Pos^DB+Adj+PresPart
yürüyüşüyle	yürü+Verb+Pos^DB+Noun+Inf3+A3sg+P3sg+Ins
bilseniz	bil+Verb+Pos+Desr+A2pl
yutkunarak	yutkun+Verb+Pos^DB+Adverb+ByDoingSo
kıyaslanabilecek	kıyasla+Verb^DB+Verb+Pass+Pos^DB+Verb+Able^DB+Adj+FutPart+Pnon
ölen	öl+Verb+Pos^DB+Adj+PresPart
öl	öl+Verb+Pos+Imp+A2sg
evlendi	evlen+Verb+Pos+Past+A3sg
verdirdi	ver+Verb^DB+Verb+Caus+Pos+Past+A3sg
okumuştu	oku+Verb+Pos+Narr+Past+A3sg
geçinirlerdi	geçin+Verb+Pos+Aor+A3pl+Past
soyup	soy+Verb+Pos^DB+Adverb+AfterDoingSo
kayboldu	kaybol+Verb+Pos+Past+A3sg
etmişler	et+Verb+Pos+Narr+A3pl
sever	sev+Verb+Pos+Aor+A3sg
severim	sev+Verb+Pos+Aor+A1sg
tanışmıştım	tanış+Verb+Pos+Narr+Past+A1sg
tanışıyormuş	tanış+Verb+Pos+Prog1+Narr+A3sg
söyleyeyim	söyle+Verb+Pos+Opt+A1sg
bahseden	bahset+Verb+Pos^DB+Adj+PresPart
geçin	geç+Verb+Pos+Imp+A2pl
dikmiş	dik+Verb+Pos+Narr+A3sg
duymuştum	duy+Verb+Pos+Narr+Past+A1sg
okumaya	oku+Verb+Pos^DB+Noun+Inf2+A3sg+Pnon+Dat
başlarken	başla+Verb+Pos+Aor^DB+Adverb+While
söylüyordu	söyle+Verb+Pos+Prog1+Past+A3sg
işliyordu	işle+Verb+Pos+Prog1+Past+A3sg
çevirirken	çevir+Verb+Pos+Aor^DB+Adverb+While
yonttuğu	yont+Verb+Pos^DB+Adj+PastPart+P3sg
inip	in+Verb+Pos^DB+Adverb+AfterDoingSo
kalkan	kalk+Verb+Pos^DB+Adj+PresPart
büyüledi	büyüle+Verb+Pos+Past+A3sg
söylediği	söyle+Verb+Pos^DB+Adj+PastPart+P3sg
tıkanıyordu	tıka+Verb^DB+Verb+Pass+Pos+Prog1+Past+A3sg
canlanmış	can+Noun+A3sg+Pnon+Nom^DB+Verb+Acquire+Pos+Narr+A3sg
coşmuş	coş+Verb+Pos+Narr+A3sg
çarpıyordu	çarp+Verb+Pos+Prog1+Past+A3sg
çökmeye	çök+Verb+Pos^DB+Noun+Inf2+A3sg+Pnon+Dat
bitince	bit+Verb+Pos^DB+Adverb+When
ağlamaklı	ağla+Verb+Pos^DB+Noun+Inf1+A3sg+Pnon+Nom^DB+Adj+With
öperken	öp+Verb+Pos+Aor^DB+Adverb+While
hatırladım	hatırla+Verb+Pos+Past+A1sg
geçmek	geç+Verb+Pos^DB+Noun+Inf1+A3sg+Pnon+Nom
geldiğini	gel+Verb+Pos^DB+Noun+PastPart+A3sg+P3sg+Acc
mahvediyorsunuz	mahvet+Verb+Pos+Prog1+A2pl
çekilmek	çek+Verb^DB+Verb+Pass+Pos^DB+Noun+Inf1+A3sg+Pnon+Nom
kaçmak	kaç+Verb+Pos^DB+Noun+Inf1+A3sg+Pnon+Nom
düzeltin	düzel+Verb^DB+Verb+Caus+Pos+Imp+A2pl
bakışlarla	bak+Verb+Pos^DB+Noun+Inf3+A3pl+Pnon+Ins
diriltin	diril+Verb^DB+Verb+Caus+Pos+Imp+A2pl
canlandırın	can+Noun+A3sg+Pnon+Nom^DB+Verb+Acquire^DB+Verb+Caus+Pos+Imp+A2pl
dönün	dön+Verb+Pos+Imp+A2pl
karışın	karış+Verb+Pos+Imp+A2pl
gösterene	göster+Verb+Pos^DB+Adj+PresPart^DB+Noun+Zero+A3sg+Pnon+Dat
sayan	say+Verb+Pos^DB+Adj+PresPart
anlayan	anla+Verb+Pos^DB+Adj+PresPart
seslenin	seslen+Verb+Pos+Imp+A2pl
koşa	koş+Verb+Pos+Opt+A3sg
geleceklerdir	gel+Verb+Pos+Fut+A3pl+Cop
bırakarak	bırak+Verb+Pos^DB+Adverb+ByDoingSo
koşarım	koş+Verb+Pos+Aor+A1sg
gelirim	gel+Verb+Pos+Aor+A1sg
olurdum	ol+Verb+Pos+Aor+Past+A1sg
isteseydiniz	iste+Verb+Pos+Desr+Past+A2pl
sümküren	sümkür+Verb+Pos^DB+Adj+PresPart
olduğunuza	ol+Verb+Pos^DB+Noun+PastPart+A3sg+P2pl+Dat
geveledi	gevele+Verb+Pos+Past+A3sg
yaşıyoruz	yaşa+Verb+Pos+Prog1+A1pl
koruyucu	koru+Verb+Pos^DB+Noun+Agt+A3sg+Pnon+Nom
reddetti	reddet+Verb+Pos+Past+A3sg
götüreceğiniz	götür+Verb+Pos^DB+Noun+FutPart+A3sg+P2pl+Nom
heyecanlanmıştı	heyecan+Noun+A3sg+Pnon+Nom^DB+Verb+Acquire+Pos+Narr+Past+A3sg
olsa	ol+Verb+Pos+Desr+A3sg
öpmeye	öp+Verb+Pos^DB+Noun+Inf2+A3sg+Pnon+Dat
çökmek	çök+Verb+Pos^DB+Noun+Inf1+A3sg+Pnon+Nom
konuşmaya	konuş+Verb+Pos^DB+Noun+Inf2+A3sg+Pnon+Dat
atıldı	at+Verb^DB+Verb+Pass+Pos+Past+A3sg
davranışların	davran+Verb+Pos^DB+Noun+Inf3+A3pl+Pnon+Gen
okumuştum	oku+Verb+Pos+Narr+Past+A1sg
unutmuştum	unut+Verb+Pos+Narr+Past+A1sg
sayılacağı	say+Verb^DB+Verb+Pass+Pos^DB+Noun+FutPart+A3sg+P3sg+Nom
kazanmıştı	kazan+Verb+Pos+Narr+Past+A3sg
olduğunuzu	ol+Verb+Pos^DB+Noun+PastPart+A3sg+P2pl+Acc
ihtiyarlar	ihtiyarla+Verb+Pos+Aor+A3sg
içmelere	iç+Verb+Pos^DB+Noun+Inf2+A3pl+Pnon+Dat
söylüyorum	söyle+Verb+Pos+Prog1+A1sg
şaşırtıcı	şaşır+Verb^DB+Verb+Caus+Pos^DB+Noun+Agt+A3sg+Pnon+Nom
uyandıracaksınız	uyan+Verb^DB+Verb+Caus+Pos+Fut+A2pl
gezdiriyorsunuz	gez+Verb^DB+Verb+Caus+Pos+Prog1+A2pl
büyülüyorsunuz	büyüle+Verb+Pos+Prog1+A2pl
koşuyor	koş+Verb+Pos+Prog1+A3sg
bahsedecek	bahset+Verb+Pos+Fut+A3sg
ediyorsunuz	et+Verb+Pos+Prog1+A2pl
gevşiyordu	gevşe+Verb+Pos+Prog1+Past+A3sg
söylediğiniz	söyle+Verb+Pos^DB+Noun+PastPart+A3sg+P2pl+Nom
tekrarlayın	tekrarla+Verb+Pos+Imp+A2pl
hatırlıyor	hatırla+Verb+Pos+Prog1+A3sg
yalvarıyordu	yalvar+Verb+Pos+Prog1+Past+A3sg
getirdi	getir+Verb+Pos+Past+A3sg
çöktü	çök+Verb+Pos+Past+A3sg
titreyen	titre+Verb+Pos^DB+Adj+PresPart
bağırıyordu	bağır+Verb+Pos+Prog1+Past+A3sg
bitmiş	bit+Verb+Pos^DB+Adj+NarrPart
görürdüm	gör+Verb+Pos+Aor+Past+A1sg
söylerdik	söyle+Verb+Pos+Aor+Past+A1pl
tıkanarak	tıka+Verb^DB+Verb+Pass+Pos^DB+Adverb+ByDoingSo
boğularak	boğ+Verb^DB+Verb+Pass+Pos^DB+Adverb+ByDoingSo
peltekleşmişti	peltek+Adj^DB+Verb+Become+Pos+Narr+Past+A3sg
duygulandığı	duygu+Noun+A3sg+Pnon+Nom^DB+Verb+Acquire+Pos^DB+Adj+PastPart+P3sg
körükledi	körükle+Verb+Pos+Past+A3sg
olmayasınız	ol+Verb+Pos^DB+Noun+Inf2+A3sg+Pnon+Dat^DB+Verb+Zero+Pres+A2pl
hissetmişti	hisset+Verb+Pos+Narr+Past+A3sg
umduğundan	um+Verb+Pos^DB+Noun+PastPart+A3sg+P3sg+Abl
canlandı	can+Noun+A3sg+Pnon+Nom^DB+Verb+Acquire+Pos+Past+A3sg
durarak	dur+Verb+Pos^DB+Adverb+ByDoingSo
vermeyi	ver+Verb+Pos^DB+Noun+Inf2+A3sg+Pnon+Acc
edebilsem	et+Verb+Pos^DB+Verb+Able+Desr+A1sg
baktıkça	bak+Verb+Pos^DB+Adverb+AsLongAs
bakardım	bak+Verb+Pos+Aor+Past+A1sg
istiyorsunuz	iste+Verb+Pos+Prog1+A2pl
alırlar	al+Verb+Pos+Aor+A3pl
kucakladı	kucakla+Verb+Pos+Past+A3sg
hissediyor	hisset+Verb+Pos+Prog1+A3sg
seyrediyordu	seyret+Verb+Pos+Prog1+Past+A3sg
coşmuştu	coş+Verb+Pos+Narr+Past+A3sg
çevirdi	çevir+Verb+Pos+Past+A3sg
ayrılacağımızı	ayır+Verb^DB+Verb+Pass+Pos^DB+Noun+FutPart+A3sg+P1pl+Acc
baktığının	bak+Verb+Pos^DB+Noun+PastPart+A3sg+P3sg+Gen
ettiniz	et+Verb+Pos+Past+A2pl
ayıracaksınız	ayır+Verb+Pos+Fut+A2pl
bırakıyorsun	bırak+Verb+Pos+Prog1+A2sg
gelen	gel+Verb+Pos^DB+Adj+PresPart
vermek	ver+Verb+Pos^DB+Noun+Inf1+A3sg+Pnon+Nom
uzattı	uza+Verb^DB+Verb+Caus+Pos+Past+A3sg
gülümsemeye	gülümse+Verb+Pos^DB+Noun+Inf2+A3sg+Pnon+Dat
zorladı	zorla+Verb+Pos+Past+A3sg
yaşamaya	yaşa+Verb+Pos^DB+Noun+Inf2+A3sg+Pnon+Dat
kekeliyordu	kekele+Verb+Pos+Prog1+Past+A3sg
tanıdığım	tanı+Verb+Pos^DB+Noun+PastPart+A3sg+P1sg+Nom
olanıdır	ol+Verb+Pos^DB+Adj+PresPart^DB+Noun+Zero+A3sg+P3sg+Nom^DB+Verb+Zero+Pres+A3sg+Cop
biliyor	bile+Verb+Pos+Prog1+A3sg
geldiniz	gel+Verb+Pos+Past+A2pl
veriyorum	ver+Verb+Pos+Prog1+A1sg
yalvaran	yalvar+Verb+Pos^DB+Adj+PresPart
koruyacaksınız	koru+Verb+Pos+Fut+A2pl
kılıcınız	kıl+Verb+Pos^DB+Noun+Agt+A3sg+P2pl+Nom
parlayacak	parla+Verb+Pos+Fut+A3sg
yeter	yet+Verb+Pos+Aor+A3sg
başlıyorum	başla+Verb+Pos+Prog1+A1sg
geveliyordu	gevele+Verb+Pos+Prog1+Past+A3sg
göndermek	gönder+Verb+Pos^DB+Noun+Inf1+A3sg+Pnon+Nom
sereceğim	ser+Verb+Pos+Fut+A1sg
kaçarak	kaç+Verb+Pos^DB+Adverb+ByDoingSo
gömülmeye	göm+Verb^DB+Verb+Pass+Pos^DB+Noun+Inf2+A3sg+Pnon+Dat
kalkışıyorsunuz	kalkış+Verb+Pos+Prog1+A2pl
yaptınız	yap+Verb+Pos+Past+A2pl
tekrarlayacağım	tekrarla+Verb+Pos+Fut+A1sg
hatırladıkça	hatırla+Verb+Pos^DB+Adverb+AsLongAs
duygulanmış	duygu+Noun+A3sg+Pnon+Nom^DB+Verb+Acquire+Pos+Narr+A3sg
ye	ye+Verb+Pos+Imp+A2sg
sokacaklardı	sok+Verb+Pos+Fut+A3pl+Past
gitmiştim	git+Verb+Pos+Narr+Past+A1sg
anlattım	anla+Verb^DB+Verb+Caus+Pos+Past+A1sg
kalmıştım	kal+Verb+Pos+Narr+Past+A1sg
bulunacağım	bulun+Verb+Pos+Fut+A1sg
bakalım	bak+Verb+Pos+Opt+A1pl
evlenmeniz	evlen+Verb+Pos^DB+Noun+Inf2+A3sg+P2pl+Nom
uğratacak	uğra+Verb^DB+Verb+Caus+Pos+Fut+A3sg
anlayacaklar	anla+Verb+Pos+Fut+A3pl
bakabileceksiniz	bak+Verb+Pos^DB+Verb+Able+Fut+A2pl
bakacağım	bak+Verb+Pos+Fut+A1sg
kapadı	kapa+Verb+Pos+Past+A3sg
tüketmeyeyim	tüket+Verb+Pos^DB+Noun+Inf2+A3sg+Pnon+Dat^DB+Verb+Zero+Pres+A1sg
eğilerek	eğ+Verb^DB+Verb+Pass+Pos^DB+Adverb+ByDoingSo
yatışmanız	yatış+Verb+Pos^DB+Noun+Inf2+A3sg+P2pl+Nom
dinlenmeniz	dinle+Verb^DB+Verb+Pass+Pos^DB+Noun+Inf2+A3sg+P2pl+Nom
gerekiyor	gerek+Verb+Pos+Prog1+A3sg
götüreyim	götür+Verb+Pos+Opt+A1sg
yatırırım	yatır+Verb+Pos+Aor+A1sg
bakıyorsunuz	bak+Verb+Pos+Prog1+A2pl
inanır	inan+Verb+Pos+Aor+A3sg
söyleyecektim	söyle+Verb+Pos+Fut+Past+A1sg
yet	yet+Verb+Pos+Imp+A2sg
yollamak	yolla+Verb+Pos^DB+Noun+Inf1+A3sg+Pnon+Nom
istedi	iste+Verb+Pos+Past+A3sg
kalsın	kal+Verb+Pos+Imp+A3sg
kapaklanıyordu	kapaklan+Verb+Pos+Prog1+Past+A3sg
girin	gir+Verb+Pos+Imp+A2pl
kaldı	kal+Verb+Pos+Past+A3sg
duyuyordu	duy+Verb+Pos+Prog1+Past+A3sg
yanıyordu	yan+Verb+Pos+Prog1+Past+A3sg
sıkmış	sık+Verb+Pos+Narr+A3sg
kenetlenmiş	kenetle+Verb^DB+Verb+Pass+Pos+Narr+A3sg
kıpırdamadan	kıpırda+Verb+Pos^DB+Noun+Inf2+A3sg+Pnon+Abl
yaşarmıştı	yaşar+Verb+Pos+Narr+Past+A3sg
açıldı	aç+Verb^DB+Verb+Pass+Pos+Past+A3sg
duymuştu	duy+Verb+Pos+Narr+Past+A3sg
tıkanan	tıka+Verb^DB+Verb+Pass+Pos^DB+Adj+PresPart
süzdü	süz+Verb+Pos+Past+A3sg
tekrarladı	tekrarla+Verb+Pos+Past+A3sg
parladı	parla+Verb+Pos+Past+A3sg
yürüyerek	yürü+Verb+Pos^DB+Adverb+ByDoingSo
gerileyen	gerile+Verb+Pos^DB+Adj+PresPart
küçümseyen	küçümse+Verb+Pos^DB+Adj+PresPart
dinlediniz	dinle+Verb+Pos+Past+A2pl
yaptım	yap+Verb+Pos+Past+A1sg
bakışı	bak+Verb+Pos^DB+Noun+Inf3+A3sg+P3sg+Nom
eziliyordu	ez+Verb^DB+Verb+Pass+Pos+Prog1+Past+A3sg
suçlayabilirsiniz	suçla+Verb+Pos^DB+Verb+Able+Aor+A2pl
suçlamaya	suçla+Verb+Pos^DB+Noun+Inf2+A3sg+Pnon+Dat
konuşuyorsunuz	konuş+Verb+Pos+Prog1+A2pl
soruyorsunuz	sor+Verb+Pos+Prog1+A2pl
evlenecekmişsiniz	evlen+Verb+Pos+Fut+Narr+A2pl
çiğneyip	çiğne+Verb+Pos^DB+Adverb+AfterDoingSo
geçerek	geç+Verb+Pos^DB+Adverb+ByDoingSo
verdiniz	ver+Verb+Pos+Past+A2pl
ayırmıştınız	ayır+Verb+Pos+Narr+Past+A2pl
duymuş	duy+Verb+Pos+Narr+A3sg
buruştu	buruş+Verb+Pos+Past+A3sg
tuttu	tut+Verb+Pos+Past+A3sg
titremeyle	titre+Verb+Pos^DB+Noun+Inf2+A3sg+Pnon+Ins
acıdığımdan	acı+Verb+Pos^DB+Noun+PastPart+A3sg+P1sg+Abl
tanımam	tanı+Verb+Pos^DB+Noun+Inf2+A3sg+P1sg+Nom
yalvardınız	yalvar+Verb+Pos+Past+A2pl
anlayınca	anla+Verb+Pos^DB+Adverb+When
dediniz	de+Verb+Pos+Past+A2pl
açalı	aç+Verb+Pos^DB+Adverb+SinceDoingSo
tekrarlayıp	tekrarla+Verb+Pos^DB+Adverb+AfterDoingSo
duruyorsunuz	dur+Verb+Pos+Prog1+A2pl
oynadığımı	oyna+Verb+Pos^DB+Noun+PastPart+A3sg+P1sg+Acc
bulunuyorsunuz	bul+Verb^DB+Verb+Pass+Pos+Prog1+A2pl
kararlaştırdığımız	karar+Adj^DB+Verb+Become^DB+Verb+Caus+Pos^DB+Adj+PastPart+P1pl
görünce	gör+Verb+Pos^DB+Adverb+When
saklamaya	sakla+Verb+Pos^DB+Noun+Inf2+A3sg+Pnon+Dat
vurdum	vur+Verb+Pos+Past+A1sg
vardınız	var+Verb+Pos+Past+A2pl
gelişinize	gel+Verb+Pos^DB+Noun+Inf3+A3sg+P2pl+Dat
darılıp	darıl+Verb+Pos^DB+Adverb+AfterDoingSo
sordunuz	sor+Verb+Pos+Past+A2pl
saklamak	sakla+Verb+Pos^DB+Noun+Inf1+A3sg+Pnon+Nom
paylaşmak	paylaş+Verb+Pos^DB+Noun+Inf1+A3sg+Pnon+Nom
bilin	bil+Verb+Pos+Imp+A2pl
tuttuğumdan	tut+Verb+Pos^DB+Noun+PastPart+A3sg+P1sg+Abl
bahsetmeye	bahset+Verb+Pos^DB+Noun+Inf2+A3sg+Pnon+Dat
düşündüklerimi	düşün+Verb+Pos^DB+Noun+PastPart+A3pl+P1sg+Acc
olabilir	ol+Verb+Pos^DB+Verb+Able+Aor+A3sg
evlenebilirim	evlen+Verb+Pos^DB+Verb+Able+Aor+A1sg
diyordum	de+Verb+Pos+Prog1+Past+A1sg
versin	ver+Verb+Pos+Imp+A3sg
olmasını	ol+Verb+Pos^DB+Noun+Inf2+A3sg+P3sg+Acc
dilemekten	dile+Verb+Pos^DB+Noun+Inf1+A3sg+Pnon+Abl
diyeceğim	de+Verb+Pos+Fut+A1sg
söyledikten	söyle+Verb+Pos^DB+Noun+PastPart+A3sg+Pnon+Abl
kaybolduğunu	kaybol+Verb+Pos^DB+Noun+PastPart+A3sg+P3sg+Acc
köpürdü	köpür+Verb+Pos+Past+A3sg
bağırmaya	bağır+Verb+Pos^DB+Noun+Inf2+A3sg+Pnon+Dat
olduk	ol+Verb+Pos+Past+A1pl
gitmeden	git+Verb+Pos^DB+Noun+Inf2+A3sg+Pnon+Abl
içirip	iç+Verb^DB+Verb+Caus+Pos^DB+Adverb+AfterDoingSo
düşürdüğünüzü	düş+Verb^DB+Verb+Caus+Pos^DB+Noun+PastPart+A3sg+P2pl+Acc
yayacağım	yay+Verb+Pos+Fut+A1sg
anlatacağım	anla+Verb^DB+Verb+Caus+Pos+Fut+A1sg
sarsıldı	sars+Verb^DB+Verb+Pass+Pos+Past+A3sg
verecek	ver+Verb+Pos^DB+Adj+FutPart+Pnon
küçümseyerek	küçümse+Verb+Pos^DB+Adverb+ByDoingSo
vurup	vur+Verb+Pos^DB+Adverb+AfterDoingSo
bağırdıklarını	bağır+Verb+Pos^DB+Noun+PastPart+A3pl+P3pl+Acc
kavradı	kavra+Verb+Pos+Past+A3sg
gidebilirdi	git+Verb+Pos^DB+Verb+Able+Aor+Past+A3sg
olanı	ol+Verb+Pos^DB+Adj+PresPart^DB+Noun+Zero+A3sg+Pnon+Acc
biteni	bit+Verb+Pos^DB+Adj+PresPart^DB+Noun+Zero+A3sg+Pnon+Acc
yayabilirdi	yay+Verb+Pos^DB+Verb+Able+Aor+Past+A3sg
tutmaları	tut+Verb+Pos^DB+Noun+Inf2+A3pl+P3sg+Nom
yatıştırmak	yatış+Verb^DB+Verb+Caus+Pos^DB+Noun+Inf1+A3sg+Pnon+Nom
doğdu	doğ+Verb+Pos+Past+A3sg
sokularak	sok+Verb^DB+Verb+Pass+Pos^DB+Adverb+ByDoingSo
koyacağınızı	koy+Verb+Pos^DB+Noun+FutPart+A3sg+P2pl+Acc
sanıyorsunuz	san+Verb+Pos+Prog1+A2pl
gördüğüm	gör+Verb+Pos^DB+Adj+PastPart+P1sg
bulunduğunun	bulun+Verb+Pos^DB+Noun+PastPart+A3sg+P3sg+Gen
oturduğu	otur+Verb+Pos^DB+Adj+PastPart+P3sg
göstererek	göster+Verb+Pos^DB+Adverb+ByDoingSo
baksanıza	bak+Verb+Pos+Imp+A2pl
çekiyorsunuz	çek+Verb+Pos+Prog1+A2pl
vuruldunuz	vurul+Verb+Pos+Past+A2pl
konuşmanıza	konuş+Verb+Pos^DB+Noun+Inf2+A3sg+P2pl+Dat
hissettiğim	hisset+Verb+Pos^DB+Noun+PastPart+A3sg+P1sg+Nom
verdim	ver+Verb+Pos+Past+A1sg
konuşalım	konuş+Verb+Pos+Opt+A1pl
şaşırarak	şaşır+Verb+Pos^DB+Adverb+ByDoingSo
ilişti	iliş+Verb+Pos+Past+A3sg
körükleyerek	körükle+Verb+Pos^DB+Adverb+ByDoingSo
artırmaya	art+Verb^DB+Verb+Caus+Pos^DB+Noun+Inf2+A3sg+Pnon+Dat
kurduğunuzu	kur+Verb+Pos^DB+Noun+PastPart+A3sg+P2pl+Acc
öğrendim	öğren+Verb+Pos+Past+A1sg
edebildi	et+Verb+Pos^DB+Verb+Able+Past+A3sg
fırladı	fırla+Verb+Pos+Past+A3sg
hatırlayın	hatırla+Verb+Pos+Imp+A2pl
kınayın	kına+Verb+Pos+Imp+A2pl
dinlemeyi	dinle+Verb+Pos^DB+Noun+Inf2+A3sg+Pnon+Acc
koyan	koy+Verb+Pos^DB+Adj+PresPart
anlattı	anlat+Verb+Pos+Past+A3sg
edersiniz	et+Verb+Pos+Aor+A2pl
öğrenirim	öğren+Verb+Pos+Aor+A1sg
inceleyecek	incele+Verb+Pos+Fut+A3sg
olursanız	ol+Verb+Pos+Aor+Cond+A2pl
istediğimden	iste+Verb+Pos^DB+Noun+PastPart+A3sg+P1sg+Abl
çatırdatacak	çatırda+Verb^DB+Verb+Caus+Pos+Fut+A3sg
döndü	dön+Verb+Pos+Past+A3sg
dinlerseniz	dinle+Verb+Pos+Aor+Cond+A2pl
vereceksiniz	ver+Verb+Pos+Fut+A2pl
istiyordum	iste+Verb+Pos+Prog1+Past+A1sg
dinlemekle	dinle+Verb+Pos^DB+Noun+Inf1+A3sg+Pnon+Ins
küçültmeden	küçül+Verb^DB+Verb+Caus+Pos^DB+Noun+Inf2+A3sg+Pnon+Abl
öğrenmiş	öğren+Verb+Pos+Narr+A3sg
olurdunuz	ol+Verb+Pos+Aor+Past+A2pl
olmasındandı	ol+Verb+Pos^DB+Noun+Inf2+A3sg+P3sg+Abl^DB+Verb+Zero+Past+A3sg
konuşuyorum	konuş+Verb+Pos+Prog1+A1sg
seviyor	sev+Verb+Pos+Prog1+A3sg
vazgeçirip	vazgeç+Verb^DB+Verb+Caus+Pos^DB+Adverb+AfterDoingSo
ettirene	et+Verb^DB+Verb+Caus+Pos^DB+Adj+PresPart^DB+Noun+Zero+A3sg+Pnon+Dat
çektiğimi	çek+Verb+Pos^DB+Noun+PastPart+A3sg+P1sg+Acc
bilirim	bil+Verb+Pos+Aor+A1sg
işitmek	işit+Verb+Pos^DB+Noun+Inf1+A3sg+Pnon+Nom
oldum	ol+Verb+Pos+Past+A1sg
konuştunuz	konuş+Verb+Pos+Past+A2pl
konuşur	konuş+Verb+Pos+Aor+A3sg
görmüş	gör+Verb+Pos+Narr+A3sg
konuşması	konuş+Verb+Pos^DB+Noun+Inf2+A3sg+P3sg+Nom
kızdırdınız	kız+Verb^DB+Verb+Caus+Pos+Past+A2pl
güler	gül+Verb+Pos+Aor+A3sg
gösterirken	göster+Verb+Pos+Aor^DB+Adverb+While
gittiğim	git+Verb+Pos^DB+Adj+PastPart+P1sg
batırdınız	bat+Verb^DB+Verb+Caus+Pos+Past+A2pl
anladınız	anla+Verb+Pos+Past+A2pl
öğrendiniz	öğren+Verb+Pos+Past+A2pl
küçümser	küçümse+Verb+Pos+Aor+A3sg
gülümsemeyle	gülümse+Verb+Pos^DB+Noun+Inf2+A3sg+Pnon+Ins
büktü	bük+Verb+Pos+Past+A3sg
kötülüyordum	kötüle+Verb+Pos+Prog1+Past+A1sg
uğraştım	uğraş+Verb+Pos+Past+A1sg
kötülemek	kötüle+Verb+Pos^DB+Noun+Inf1+A3sg+Pnon+Nom
etmek	et+Verb+Pos^DB+Noun+Inf1+A3sg+Pnon+Nom
kalışım	kal+Verb+Pos^DB+Noun+Inf3+A3sg+P1sg+Nom
vazgeçirdiğimin	vazgeç+Verb^DB+Verb+Caus+Pos^DB+Noun+PastPart+A3sg+P1sg+Gen
kötüleyeyim	kötüle+Verb+Pos+Opt+A1sg
göstereyim	göster+Verb+Pos+Opt+A1sg
başvurayım	başvur+Verb+Pos+Opt+A1sg
söküp	sök+Verb+Pos^DB+Adverb+AfterDoingSo
atmak	at+Verb+Pos^DB+Noun+Inf1+A3sg+Pnon+Nom
kullanmak	kullan+Verb+Pos^DB+Noun+Inf1+A3sg+Pnon+Nom
kaldım	kal+Verb+Pos+Past+A1sg
edene	et+Verb+Pos^DB+Adj+PresPart^DB+Noun+Zero+A3sg+Pnon+Dat
konuştuklarımızı	konuş+Verb+Pos^DB+Noun+PastPart+A3pl+P1pl+Acc
dinlemişsiniz	dinle+Verb+Pos+Narr+A2pl
etmişsinizdir	et+Verb+Pos+Narr+A2pl+Cop
acıdığım	acı+Verb+Pos^DB+Noun+PastPart+A3sg+P1sg+Nom
götürdüm	götür+Verb+Pos+Past+A1sg
ağlamıştı	ağla+Verb+Pos+Narr+Past+A3sg
olmanız	ol+Verb+Pos^DB+Noun+Inf2+A3sg+P2pl+Nom
daldığı	dal+Verb+Pos^DB+Adj+PastPart+P3sg
ağlarken	ağla+Verb+Pos+Aor^DB+Adverb+While
bulduğunu	bul+Verb+Pos^DB+Noun+PastPart+A3sg+P3sg+Acc
kazıyorsunuz	kaz+Verb+Pos+Prog1+A2pl
kötülediniz	kötüle+Verb+Pos+Past+A2pl
açıklıyorsunuz	açıkla+Verb+Pos+Prog1+A2pl
sormuş	sor+Verb+Pos+Narr+A3sg
olsaydınız	ol+Verb+Pos+Desr+Past+A2pl
alırdınız	al+Verb+Pos+Aor+Past+A2pl
yaptığımı	yap+Verb+Pos^DB+Noun+PastPart+A3sg+P1sg+Acc
evlenirse	evlen+Verb+Pos+Aor+Cond+A3sg
konacak	kon+Verb+Pos+Fut+A3sg
ölünce	öl+Verb+Pos^DB+Adverb+When
olacağı	ol+Verb+Pos^DB+Adj+FutPart+P3sg
istese	iste+Verb+Pos+Desr+A3sg
evlenebilir	evlen+Verb+Pos^DB+Verb+Able+Aor+A3sg
yapabilir	yap+Verb+Pos^DB+Verb+Able+Aor+A3sg
evlenmekle	evlen+Verb+Pos^DB+Noun+Inf1+A3sg+Pnon+Ins
parçaladığı	parçala+Verb+Pos^DB+Adj+PastPart+P3sg
seçecek	seç+Verb+Pos^DB+Adj+FutPart+Pnon
duyarak	duy+Verb+Pos^DB+Adverb+ByDoingSo
işlediği	işle+Verb+Pos^DB+Noun+PastPart+A3sg+P3sg+Nom
affettireceğini	affet+Verb^DB+Verb+Caus+Pos^DB+Noun+FutPart+A3sg+P3sg+Acc
seyreden	seyret+Verb+Pos^DB+Adj+PresPart
homurdandı	homurda+Verb^DB+Verb+Pass+Pos+Past+A3sg
bahsedeceğim	bahset+Verb+Pos+Fut+A1sg
söyleyeceğim	söyle+Verb+Pos+Fut+A1sg
okuyor	oku+Verb+Pos+Prog1+A3sg
buluyorsunuz	bula+Verb+Pos+Prog1+A2pl
düşünerek	düşün+Verb+Pos^DB+Adverb+ByDoingSo
evlenmeyle	evlen+Verb+Pos^DB+Noun+Inf2+A3sg+Pnon+Ins
severdim	sev+Verb+Pos+Aor+Past+A1sg
düştüğü	düş+Verb+Pos^DB+Noun+PastPart+A3sg+P3sg+Nom
sokacak	sok+Verb+Pos^DB+Adj+FutPart+Pnon
evlenmeye	evlen+Verb+Pos^DB+Noun+Inf2+A3sg+Pnon+Dat
yapacağı	yap+Verb+Pos^DB+Noun+FutPart+A3sg+P3sg+Nom
sürerek	sür+Verb+Pos^DB+Adverb+ByDoingSo
edebildim	et+Verb+Pos^DB+Verb+Able+Past+A1sg
kapıldı	kap+Verb^DB+Verb+Pass+Pos+Past+A3sg
geçmeli	geç+Verb+Pos+Neces+A3sg
kattığımızı	kat+Verb+Pos^DB+Noun+PastPart+A3sg+P1pl+Acc
diyeyim	de+Verb+Pos+Opt+A1sg
hesaplar	hesapla+Verb+Pos+Aor+A3sg
yapmaktan	yap+Verb+Pos^DB+Noun+Inf1+A3sg+Pnon+Abl
hesaplardı	hesapla+Verb+Pos+Aor+Past+A3sg
şaşıyorsunuz	şaş+Verb+Pos+Prog1+A2pl
sevmeyi	sev+Verb+Pos^DB+Noun+Inf2+A3sg+Pnon+Acc
koyarak	koy+Verb+Pos^DB+Adverb+ByDoingSo
ederiz	et+Verb+Pos+Aor+A1pl
varmadan	var+Verb+Pos^DB+Noun+Inf2+A3sg+Pnon+Abl
yaparız	yap+Verb+Pos+Aor+A1pl
aldatarak	aldat+Verb+Pos^DB+Adverb+ByDoingSo
tekrarlamak	tekrarla+Verb+Pos^DB+Noun+Inf1+A3sg+Pnon+Nom
ettiğimi	et+Verb+Pos^DB+Noun+PastPart+A3sg+P1sg+Acc
gözettiğimi	göze+Verb^DB+Verb+Caus+Pos^DB+Noun+PastPart+A3sg+P1sg+Acc
sorarsanız	sor+Verb+Pos+Aor+Cond+A2pl
kapadım	kapa+Verb+Pos+Past+A1sg
girişiyorum	giriş+Verb+Pos+Prog1+A1sg
suçlayabilir	suçla+Verb+Pos^DB+Verb+Able+Aor+A3sg
açıklamayı	açıkla+Verb+Pos^DB+Noun+Inf2+A3sg+Pnon+Acc
dinliyor	dinle+Verb+Pos+Prog1+A3sg
bakıyordu	bak+Verb+Pos+Prog1+Past+A3sg
şakıyorsunuz	şakı+Verb+Pos+Prog1+A2pl
yapacağım	yap+Verb+Pos+Fut+A1sg
konuldum	kon+Verb^DB+Verb+Pass+Pos+Past+A1sg
çıkarım	çık+Verb+Pos+Aor+A1sg
şaşırmıştı	şaşır+Verb+Pos+Narr+Past+A3sg
demekmiş	de+Verb+Pos^DB+Noun+Inf1+A3sg+Pnon+Nom^DB+Verb+Zero+Narr+A3sg
kaldırarak	kaldır+Verb+Pos^DB+Adverb+ByDoingSo
dalıp	dal+Verb+Pos^DB+Adverb+AfterDoingSo
kurmanın	kur+Verb+Pos^DB+Noun+Inf2+A3sg+Pnon+Gen
yaşarken	yaşa+Verb+Pos+Aor^DB+Adverb+While
yaşıyorum	yaşa+Verb+Pos+Prog1+A1sg
sanmanın	san+Verb+Pos^DB+Noun+Inf2+A3sg+Pnon+Gen
görüyorsunuz	gör+Verb+Pos+Prog1+A2pl
açıklamak	açıkla+Verb+Pos^DB+Noun+Inf1+A3sg+Pnon+Nom
anladığıma	anla+Verb+Pos^DB+Noun+PastPart+A3sg+P1sg+Dat
görülür	gör+Verb^DB+Verb+Pass+Pos+Aor+A3sg
tutarak	tut+Verb+Pos^DB+Adverb+ByDoingSo
davrandığının	davran+Verb+Pos^DB+Noun+PastPart+A3sg+P3sg+Gen
vardım	var+Verb+Pos+Past+A1sg
ettim	et+Verb+Pos+Past+A1sg
darıltıp	darıl+Verb^DB+Verb+Caus+Pos^DB+Adverb+AfterDoingSo
karşıladınız	karşıla+Verb+Pos+Past+A2pl
ayırıyor	ayır+Verb+Pos+Prog1+A3sg
eğiyorum	eğ+Verb+Pos+Prog1+A1sg
gerekiyorsa	gerek+Verb+Pos+Prog1+Cond+A3sg
bağışlıyorum	bağışla+Verb+Pos+Prog1+A1sg
olursun	ol+Verb+Pos+Aor+A2sg
söylerken	söyle+Verb+Pos+Aor^DB+Adverb+While
dayanmış	dayan+Verb+Pos^DB+Adj+NarrPart
bakışını	bak+Verb+Pos^DB+Noun+Inf3+A3sg+P3sg+Acc
dikecektiniz	dik+Verb+Pos+Fut+Past+A2pl
söyledikleriniz	söyle+Verb+Pos^DB+Noun+PastPart+A3pl+P2pl+Nom
söylesem	söyle+Verb+Pos+Desr+A1sg
kalacaktı	kal+Verb+Pos+Fut+Past+A3sg
göstermek	göster+Verb+Pos^DB+Noun+Inf1+A3sg+Pnon+Nom
karşılaşıyorsunuz	karşılaş+Verb+Pos+Prog1+A2pl
kamaştıran	kamaş+Verb^DB+Verb+Caus+Pos^DB+Adj+PresPart
yaslanmış	yasla+Verb^DB+Verb+Pass+Pos+Narr+A3sg
görülebilir	gör+Verb^DB+Verb+Pass+Pos^DB+Verb+Able+Aor+A3sg
seyrediyorsunuz	seyret+Verb+Pos+Prog1+A2pl
duyuluyor	duy+Verb^DB+Verb+Pass+Pos+Prog1+A3sg
bakacak	bak+Verb+Pos^DB+Adj+FutPart+Pnon
düşünecek	düşün+Verb+Pos^DB+Adj+FutPart+Pnon
alevlenecek	alev+Noun+A3sg+Pnon+Nom^DB+Verb+Acquire+Pos+Fut+A3sg
çatırdatırcasına	çatırda+Verb^DB+Verb+Caus+Pos+Aor+A3sg^DB+Adverb+AsIf
kıpırdattı	kıpırda+Verb^DB+Verb+Caus+Pos+Past+A3sg
uçuştuğu	uçuş+Verb+Pos^DB+Adj+PastPart+P3sg
gidiyorsunuz	git+Verb+Pos+Prog1+A2pl
başlıyor	başla+Verb+Pos+Prog1+A3sg
bakmaktan	bak+Verb+Pos^DB+Noun+Inf1+A3sg+Pnon+Abl
duyuyorsunuz	duy+Verb+Pos+Prog1+A2pl
istediğimi	iste+Verb+Pos^DB+Noun+PastPart+A3sg+P1sg+Acc
anlıyorsunuz	anla+Verb+Pos+Prog1+A2pl
edeceklerdir	et+Verb+Pos+Fut+A3pl+Cop
verebilirler	ver+Verb+Pos^DB+Verb+Able+Aor+A3pl
çıkar	çık+Verb+Pos+Aor+A3sg
çıkarılır	çık+Verb^DB+Verb+Caus^DB+Verb+Pass+Pos+Aor+A3sg
ölüyor	öl+Verb+Pos+Prog1+A3sg
evlenmeyi	evlen+Verb+Pos^DB+Noun+Inf2+A3sg+Pnon+Acc
saydıkları	say+Verb+Pos^DB+Adj+PastPart+P3pl
alıyorsunuz	al+Verb+Pos+Prog1+A2pl
giriyorsunuz	gir+Verb+Pos+Prog1+A2pl
ulaşıyor	ulaş+Verb+Pos+Prog1+A3sg
olacaksınız	ol+Verb+Pos+Fut+A2pl
koyacak	koy+Verb+Pos+Fut+A3sg
alıyorum	al+Verb+Pos+Prog1+A1sg
inanmış	inan+Verb+Pos+Narr+A3sg
bakıp	bak+Verb+Pos^DB+Adverb+AfterDoingSo
gülen	gül+Verb+Pos^DB+Adj+PresPart
diyeni	de+Verb+Pos^DB+Adj+PresPart^DB+Noun+Zero+A3sg+P3sg+Nom
inanın	inan+Verb+Pos+Imp+A2pl
heyecanlanarak	heyecan+Noun+A3sg+Pnon+Nom^DB+Verb+Acquire+Pos^DB+Adverb+ByDoingSo
doğrularak	doğrul+Verb+Pos^DB+Adverb+ByDoingSo
daldırdı	dal+Verb^DB+Verb+Caus+Pos+Past+A3sg
ekledi	ekle+Verb+Pos+Past+A3sg
inledi	inle+Verb+Pos+Past+A3sg
sevdiğim	sev+Verb+Pos^DB+Adj+PastPart+P1sg
mahvettim	mahvet+Verb+Pos+Past+A1sg
düşünüyor	düşün+Verb+Pos+Prog1+A3sg
kurtarın	kurtar+Verb+Pos+Imp+A2pl
ağlamaya	ağla+Verb+Pos^DB+Noun+Inf2+A3sg+Pnon+Dat
duygulanarak	duygu+Noun+A3sg+Pnon+Nom^DB+Verb+Acquire+Pos^DB+Adverb+ByDoingSo
kaynayan	kayna+Verb+Pos^DB+Adj+PresPart
yaptığınızı	yap+Verb+Pos^DB+Noun+PastPart+A3sg+P2pl+Acc
anlaması	anla+Verb+Pos^DB+Noun+Inf2+A3sg+P3sg+Nom
gerekir	gerek+Verb+Pos+Aor+A3sg
çalışacağım	çalış+Verb+Pos+Fut+A1sg
öğrettiğim	öğret+Verb+Pos^DB+Noun+PastPart+A3sg+P1sg+Nom
söyleyeceksiniz	söyle+Verb+Pos+Fut+A2pl
yapsak	yap+Verb+Pos+Desr+A1pl
sayar	say+Verb+Pos+Aor+A3sg
koyacağız	koy+Verb+Pos+Fut+A1pl
gidiverin	git+Verb+Pos^DB+Verb+Hastily+Imp+A2pl
kavuşturdunuz	kavuş+Verb^DB+Verb+Caus+Pos+Past+A2pl
soracağım	sor+Verb+Pos+Fut+A1sg
etmeliyiz	et+Verb+Pos+Neces+A1pl
dilemeliyiz	dile+Verb+Pos+Neces+A1pl
dökerek	dök+Verb+Pos^DB+Adverb+ByDoingSo
görünüyor	görün+Verb+Pos+Prog1+A3sg
tanıtmak	tanı+Verb^DB+Verb+Caus+Pos^DB+Noun+Inf1+A3sg+Pnon+Nom
korkuyorum	kork+Verb+Pos+Prog1+A1sg
yapalım	yap+Verb+Pos+Opt+A1pl
etmiş	et+Verb+Pos+Narr+A3sg
kazanmış	kazan+Verb+Pos^DB+Adj+NarrPart
savdık	sav+Verb+Pos+Past+A1pl
parlıyordu	parla+Verb+Pos+Prog1+Past+A3sg
bitirin	bit+Verb^DB+Verb+Caus+Pos+Imp+A2pl
kaçacağım	kaç+Verb+Pos+Fut+A1sg
bulanıyor	bulan+Verb+Pos+Prog1+A3sg
duydunuz	duy+Verb+Pos+Past+A2pl
dikerek	dik+Verb+Pos^DB+Adverb+ByDoingSo
dinliyordum	dinle+Verb+Pos+Prog1+Past+A1sg
ayıplamaya	ayıpla+Verb+Pos^DB+Noun+Inf2+A3sg+Pnon+Dat
kalkacaksınız	kalk+Verb+Pos+Fut+A2pl
hırpalayıp	hırpala+Verb+Pos^DB+Adverb+AfterDoingSo
vermeye	ver+Verb+Pos^DB+Noun+Inf2+A3sg+Pnon+Dat
ederseniz	et+Verb+Pos+Aor+Cond+A2pl
bırakıp	bırak+Verb+Pos^DB+Adverb+AfterDoingSo
çekileceğim	çek+Verb^DB+Verb+Pass+Pos+Fut+A1sg
çarparak	çarp+Verb+Pos^DB+Adverb+ByDoingSo
daldı	dal+Verb+Pos+Past+A3sg
silkinerek	silkin+Verb+Pos^DB+Adverb+ByDoingSo
söylendi	söyle+Verb^DB+Verb+Pass+Pos+Past+A3sg
gecikmede	gecik+Verb+Pos^DB+Noun+Inf2+A3sg+Pnon+Loc
yayarlarsa	yay+Verb+Pos+Aor+A3pl+Cond
yapmışlardır	yap+Verb+Pos+Narr+A3pl+Cop
mahvolur	mahvol+Verb+Pos+Aor+A3sg
vazgeçer	vazgeç+Verb+Pos+Aor+A3sg
yapıp	yap+Verb+Pos^DB+Adverb+AfterDoingSo
götürmeli	götür+Verb+Pos+Neces+A3sg
yapışır	yapış+Verb+Pos+Aor+A3sg
getiririm	getir+Verb+Pos+Aor+A1sg
yarasın	yara+Verb+Pos+Imp+A3sg
kaldırıp	kaldır+Verb+Pos^DB+Adverb+AfterDoingSo
gideriz	git+Verb+Pos+Aor+A1pl
bastı	bas+Verb+Pos+Past+A3sg
götürürken	götür+Verb+Pos+Aor^DB+Adverb+While
ısmarlamıştı	ısmarla+Verb+Pos+Narr+Past+A3sg
giyindi	giy+Verb^DB+Verb+Reflex+Pos+Past+A3sg
çıkmadan	çık+Verb+Pos^DB+Noun+Inf2+A3sg+Pnon+Abl
yapacakları	yap+Verb+Pos^DB+Noun+FutPart+A3sg+P3pl+Nom
konuşmak	konuş+Verb+Pos^DB+Noun+Inf1+A3sg+Pnon+Nom
uğradı	uğra+Verb+Pos+Past+A3sg
dinleyecek	dinle+Verb+Pos+Fut+A3sg
yığılmış	yığ+Verb^DB+Verb+Pass+Pos+Narr+A3sg
gömülerek	göm+Verb^DB+Verb+Pass+Pos^DB+Adverb+ByDoingSo
hıçkıra	hıçkır+Verb+Pos+Opt+A3sg
ağlıyordu	ağla+Verb+Pos+Prog1+Past+A3sg
daldırmış	dal+Verb^DB+Verb+Caus+Pos+Narr+A3sg
yolmaya	yol+Verb+Pos^DB+Noun+Inf2+A3sg+Pnon+Dat
çalışıyor	çalış+Verb+Pos+Prog1+A3sg
üşüme	üşü+Verb+Pos^DB+Noun+Inf2+A3sg+Pnon+Nom
tutulmuş	tut+Verb^DB+Verb+Pass+Pos+Narr+A3sg
ürperiyordu	ürper+Verb+Pos+Prog1+Past+A3sg
durduktan	dur+Verb+Pos^DB+Noun+PastPart+A3sg+Pnon+Abl
bozulmuş	boz+Verb^DB+Verb+Pass+Pos+Narr+A3sg
gidermek	gider+Verb+Pos^DB+Noun+Inf1+A3sg+Pnon+Nom
koyuldu	koy+Verb^DB+Verb+Pass+Pos+Past+A3sg
koşturuyordu	koş+Verb^DB+Verb+Caus+Pos+Prog1+Past+A3sg
bozdu	boz+Verb+Pos+Past+A3sg
kandırmak	kan+Verb^DB+Verb+Caus+Pos^DB+Noun+Inf1+A3sg+Pnon+Nom
söylediklerimin	söyle+Verb+Pos^DB+Noun+PastPart+A3pl+P1sg+Gen
tekrarladım	tekrarla+Verb+Pos+Past+A1sg
alındı	al+Verb^DB+Verb+Pass+Pos+Past+A3sg
almadan	al+Verb+Pos^DB+Noun+Inf2+A3sg+Pnon+Abl
halletmek	hallet+Verb+Pos^DB+Noun+Inf1+A3sg+Pnon+Nom
gelmesi	gel+Verb+Pos^DB+Noun+Inf2+A3sg+P3sg+Nom
hiddetlendirdi	hiddet+Noun+A3sg+Pnon+Nom^DB+Verb+Acquire^DB+Verb+Caus+Pos+Past+A3sg
koşuyordu	koş+Verb+Pos+Prog1+Past+A3sg
kanatlanmış	kanat+Noun+A3sg+Pnon+Nom^DB+Verb+Acquire+Pos+Narr+A3sg
söylediğimiz	söyle+Verb+Pos^DB+Adj+PastPart+P1pl
kovalarken	kovala+Verb+Pos+Aor^DB+Adverb+While
doğmuştu	doğ+Verb+Pos+Narr+Past+A3sg
etmiştik	et+Verb+Pos+Narr+Past+A1pl
okuyucular	oku+Verb+Pos^DB+Noun+Agt+A3pl+Pnon+Nom
öğrendiler	öğren+Verb+Pos+Past+A3pl
götürmekti	götür+Verb+Pos^DB+Noun+Inf1+A3sg+Pnon+Nom^DB+Verb+Zero+Past+A3sg
kaplamaya	kapla+Verb+Pos^DB+Noun+Inf2+A3sg+Pnon+Dat
ulaştıkları	ulaş+Verb+Pos^DB+Adj+PastPart+P3pl
bastık	bas+Verb+Pos+Past+A1pl
beklenebilirdi	bekle+Verb^DB+Verb+Pass+Pos^DB+Verb+Able+Aor+Past+A3sg
korkuyormuş	kork+Verb+Pos+Prog1+Narr+A3sg
evlendirmenin	evlen+Verb^DB+Verb+Caus+Pos^DB+Noun+Inf2+A3sg+Pnon+Gen
hesaplamıştı	hesapla+Verb+Pos+Narr+Past+A3sg
kıyabilirdi	kıy+Verb+Pos^DB+Verb+Able+Aor+Past+A3sg
sıkışsa	sıkış+Verb+Pos+Desr+A3sg
yapılabilirdi	yap+Verb^DB+Verb+Pass+Pos^DB+Verb+Able+Aor+Past+A3sg
evlenmeler	evlen+Verb+Pos^DB+Noun+Inf2+A3pl+Pnon+Nom
göstermeli	göster+Verb+Pos^DB+Noun+Inf2+A3sg+Pnon+Nom^DB+Adj+With
koymalıydı	koy+Verb+Pos+Neces+Past+A3sg
vererek	ver+Verb+Pos^DB+Adverb+ByDoingSo
basmalıydı	bas+Verb+Pos+Neces+Past+A3sg
etmeli	et+Verb+Pos^DB+Noun+Inf2+A3sg+Pnon+Nom^DB+Adj+With
içirmeliydi	iç+Verb^DB+Verb+Caus+Pos+Neces+Past+A3sg
kopsa	kop+Verb+Pos+Desr+A3sg
gelirdi	gel+Verb+Pos+Aor+Past+A3sg
çıkabilirdi	çık+Verb+Pos^DB+Verb+Able+Aor+Past+A3sg
avutacak	avut+Verb+Pos^DB+Adj+FutPart+Pnon
bulmuştu	bul+Verb+Pos+Narr+Past+A3sg
sayardı	say+Verb+Pos+Aor+Past+A3sg
atar	at+Verb+Pos+Aor+A3sg
desteklemesi	destekle+Verb+Pos^DB+Noun+Inf2+A3sg+P3sg+Nom
edecekti	et+Verb+Pos+Fut+Past+A3sg
etmesine	et+Verb+Pos^DB+Noun+Inf2+A3sg+P3sg+Dat
geleceklerdi	gel+Verb+Pos+Fut+A3pl+Past
duyması	duy+Verb+Pos^DB+Noun+Inf2+A3sg+P3sg+Nom
tanışmayı	tanış+Verb+Pos^DB+Noun+Inf2+A3sg+Pnon+Acc
edince	et+Verb+Pos^DB+Adverb+When
gelişini	gel+Verb+Pos^DB+Noun+Inf3+A3sg+P3sg+Acc
duyar	duy+Verb+Pos+Aor+A3sg
koşan	koş+Verb+Pos^DB+Adj+PresPart
gelişi	gel+Verb+Pos^DB+Noun+Inf3+A3sg+P3sg+Nom
uyandıracak	uyan+Verb^DB+Verb+Caus+Pos^DB+Adj+FutPart+Pnon
okşayacaktı	okşa+Verb+Pos+Fut+Past+A3sg
reddedilirdi	reddet+Verb^DB+Verb+Pass+Pos+Aor+Past+A3sg
uçarak	uç+Verb+Pos^DB+Adverb+ByDoingSo
aştıktan	aş+Verb+Pos^DB+Noun+PastPart+A3sg+Pnon+Abl
durdurdu	dur+Verb^DB+Verb+Caus+Pos+Past+A3sg
kararmış	kar+Verb+Pos+Aor+Narr+A3sg
kullanıyordu	kullan+Verb+Pos+Prog1+Past+A3sg
yanmıştı	yan+Verb+Pos+Narr+Past+A3sg
dalarak	dal+Verb+Pos^DB+Adverb+ByDoingSo
kurulandı	kurula+Verb^DB+Verb+Pass+Pos+Past+A3sg
içiyor	iç+Verb+Pos+Prog1+A3sg
diktin	dik+Verb+Pos+Past+A2sg
kesmeni	kes+Verb+Pos^DB+Noun+Inf2+A3sg+P2sg+Acc
girerken	gir+Verb+Pos+Aor^DB+Adverb+While
selamlaşmaya	selam+Noun+A3sg+Pnon+Nom^DB+Verb+Become+Pos^DB+Noun+Inf2+A3sg+Pnon+Dat
çıkmış	çık+Verb+Pos+Narr+A3sg
yudumladığını	yudumla+Verb+Pos^DB+Noun+PastPart+A3sg+P3sg+Acc
umursamadan	umursa+Verb+Pos^DB+Noun+Inf2+A3sg+Pnon+Abl
çatıyordu	çat+Verb+Pos+Prog1+Past+A3sg
fırlamış	fırla+Verb+Pos^DB+Adj+NarrPart
uğratmıştı	uğra+Verb^DB+Verb+Caus+Pos+Narr+Past+A3sg
uzandı	uza+Verb^DB+Verb+Pass+Pos+Past+A3sg
gelirse	gel+Verb+Pos+Aor+Cond+A3sg
işitiriz	işit+Verb+Pos+Aor+A1pl
dedim	de+Verb+Pos+Past+A1sg
kıvıracağım	kıvır+Verb+Pos+Fut+A1sg
dediler	de+Verb+Pos+Past+A3pl
kıvıracak	kıvır+Verb+Pos+Fut+A3sg
kıvırtması	kıvır+Verb^DB+Verb+Caus+Pos^DB+Noun+Inf2+A3sg+P3sg+Nom
ettin	et+Verb+Pos+Past+A2sg
yakışır	yakış+Verb+Pos+Aor+A3sg
soruyorum	sor+Verb+Pos+Prog1+A1sg
kokuyor	kok+Verb+Pos+Prog1+A3sg
köpürerek	köpür+Verb+Pos^DB+Adverb+ByDoingSo
esiyordu	es+Verb+Pos+Prog1+Past+A3sg
tırmalayan	tırmala+Verb+Pos^DB+Adj+PresPart
yükseliyordu	yüksel+Verb+Pos+Prog1+Past+A3sg
geziyordu	gez+Verb+Pos+Prog1+Past+A3sg
koşuşan	koşuş+Verb+Pos^DB+Adj+PresPart
ilerliyorlardı	ilerle+Verb+Pos+Prog1+A3pl+Past
yöneten	yönet+Verb+Pos^DB+Adj+PresPart
denetleyen	denetle+Verb+Pos^DB+Adj+PresPart
serilen	ser+Verb^DB+Verb+Pass+Pos^DB+Adj+PresPart
sersemlemişti	sersemle+Verb+Pos+Narr+Past+A3sg
korkmuştu	kork+Verb+Pos+Narr+Past+A3sg
hissettiyse	hisset+Verb+Pos+Past+Cond+A3sg
döndürmüştü	dön+Verb^DB+Verb+Caus+Pos+Narr+Past+A3sg
şaşırtıyordu	şaşır+Verb^DB+Verb+Caus+Pos+Prog1+Past+A3sg
korumasına	koru+Verb+Pos^DB+Noun+Inf2+A3sg+P3sg+Dat
duyuyor	duy+Verb+Pos+Prog1+A3sg
kaybetmeye	kaybet+Verb+Pos^DB+Noun+Inf2+A3sg+Pnon+Dat
korkuyordu	kork+Verb+Pos+Prog1+Past+A3sg
çöken	çök+Verb+Pos^DB+Adj+PresPart
bindirip	bin+Verb^DB+Verb+Caus+Pos^DB+Adverb+AfterDoingSo
bağladı	bağla+Verb+Pos+Past+A3sg
katıyor	kat+Verb+Pos+Prog1+A3sg
alıyor	al+Verb+Pos+Prog1+A3sg
yığıyor	yığ+Verb+Pos+Prog1+A3sg
fırlatıyordu	fırla+Verb^DB+Verb+Caus+Pos+Prog1+Past+A3sg
gittiğini	git+Verb+Pos^DB+Noun+PastPart+A3sg+P3sg+Acc
zannetti	zannet+Verb+Pos+Past+A3sg
dikilip	dik+Verb^DB+Verb+Pass+Pos^DB+Adverb+AfterDoingSo
beklemeye	bekle+Verb+Pos^DB+Noun+Inf2+A3sg+Pnon+Dat
görününce	görün+Verb+Pos^DB+Adverb+When
bakındı	bakın+Verb+Pos+Past+A3sg
çöreklenen	çörek+Noun+A3sg+Pnon+Nom^DB+Verb+Acquire+Pos^DB+Adj+PresPart
olduysa	ol+Verb+Pos+Past+Cond+A3sg
kayboluvermişti	kaybol+Verb+Pos^DB+Verb+Hastily+Narr+Past+A3sg
gülümseyen	gülümse+Verb+Pos^DB+Adj+PresPart
uzayıp	uza+Verb+Pos^DB+Adverb+AfterDoingSo
beklemekteydi	bekle+Verb+Pos^DB+Noun+Inf1+A3sg+Pnon+Loc^DB+Verb+Zero+Past+A3sg
geldiler	gel+Verb+Pos+Past+A3pl
uzatarak	uza+Verb^DB+Verb+Caus+Pos^DB+Adverb+ByDoingSo
doladı	dola+Verb+Pos+Past+A3sg
saldıracaktı	sal+Verb^DB+Verb+Caus+Pos+Fut+Past+A3sg
olacakları	ol+Verb+Pos^DB+Noun+FutPart+A3pl+Pnon+Acc
ayrılıp	ayır+Verb^DB+Verb+Pass+Pos^DB+Adverb+AfterDoingSo
kudurmuş	kudur+Verb+Pos^DB+Adj+NarrPart
hırlayan	hırla+Verb+Pos^DB+Adj+PresPart
yakaladı	yakala+Verb+Pos+Past+A3sg
tutup	tut+Verb+Pos^DB+Adverb+AfterDoingSo
yatıştırmaya	yatış+Verb^DB+Verb+Caus+Pos^DB+Noun+Inf2+A3sg+Pnon+Dat
çalışırken	çalış+Verb+Pos+Aor^DB+Adverb+While
korkacak	kork+Verb+Pos^DB+Adj+FutPart+Pnon
diyordu	de+Verb+Pos+Prog1+Past+A3sg
edeceğinizi	et+Verb+Pos^DB+Noun+FutPart+A3sg+P2pl+Acc
sandı	san+Verb+Pos+Past+A3sg
yumacak	yum+Verb+Pos^DB+Adj+FutPart+Pnon
öğrenip	öğren+Verb+Pos^DB+Adverb+AfterDoingSo
alışır	alış+Verb+Pos+Aor+A3sg
sarılabileceğim	sar+Verb^DB+Verb+Pass+Pos^DB+Verb+Able+Fut+A1sg
diyor	de+Verb+Pos+Prog1+A3sg
gülüyordu	gül+Verb+Pos+Prog1+Past+A3sg
hırlayıp	hırla+Verb+Pos^DB+Adverb+AfterDoingSo
kabararak	kabar+Verb+Pos^DB+Adverb+ByDoingSo
süzmekte	süz+Verb+Pos^DB+Noun+Inf1+A3sg+Pnon+Loc
öğrenecek	öğren+Verb+Pos+Fut+A3sg
kaybetmeden	kaybet+Verb+Pos^DB+Noun+Inf2+A3sg+Pnon+Abl
alışmalı	alış+Verb+Pos+Neces+A3sg
yatıştırana	yatış+Verb^DB+Verb+Caus+Pos^DB+Adj+PresPart^DB+Noun+Zero+A3sg+Pnon+Dat
sertleştirdi	sert+Adj^DB+Verb+Become^DB+Verb+Caus+Pos+Past+A3sg
yat	yat+Verb+Pos+Imp+A2sg
öğretmişti	öğret+Verb+Pos+Narr+Past+A3sg
istemeye	iste+Verb+Pos^DB+Noun+Inf2+A3sg+Pnon+Dat
eğdi	eğ+Verb+Pos+Past+A3sg
açtı	aç+Verb+Pos+Past+A3sg
sarılırken	sar+Verb^DB+Verb+Pass+Pos+Aor^DB+Adverb+While
diyorum	de+Verb+Pos+Prog1+A1sg
uyarıyordu	uyar+Verb+Pos+Prog1+Past+A3sg
kalkmak	kalk+Verb+Pos^DB+Noun+Inf1+A3sg+Pnon+Nom
saydığı	say+Verb+Pos^DB+Adj+PastPart+P3sg
tekrarlanmasına	tekrarla+Verb^DB+Verb+Pass+Pos^DB+Noun+Inf2+A3sg+P3sg+Dat
kucaklamasından	kucakla+Verb+Pos^DB+Noun+Inf2+A3sg+P3sg+Abl
yatışıp	yatış+Verb+Pos^DB+Adverb+AfterDoingSo
yüklenmişti	yükle+Verb^DB+Verb+Pass+Pos+Narr+Past+A3sg
takıldı	tak+Verb^DB+Verb+Pass+Pos+Past+A3sg
götürdüklerinden	götür+Verb+Pos^DB+Noun+PastPart+A3sg+P3pl+Abl
öğrenmek	öğren+Verb+Pos^DB+Noun+Inf1+A3sg+Pnon+Nom
koşarak	koş+Verb+Pos^DB+Adverb+ByDoingSo
yapılmış	yap+Verb^DB+Verb+Pass+Pos+Narr+A3sg
ilerlemeye	ilerle+Verb+Pos^DB+Noun+Inf2+A3sg+Pnon+Dat
uzanıyor	uza+Verb^DB+Verb+Pass+Pos+Prog1+A3sg
oluşturuyordu	oluş+Verb^DB+Verb+Caus+Pos+Prog1+Past+A3sg
uzanıyordu	uza+Verb^DB+Verb+Pass+Pos+Prog1+Past+A3sg
doya	doy+Verb+Pos+Opt+A3sg
seyretmesine	seyret+Verb+Pos^DB+Noun+Inf2+A3sg+P3sg+Dat
yanan	yan+Verb+Pos^DB+Adj+PresPart
saldırdı	sal+Verb^DB+Verb+Caus+Pos+Past+A3sg
girip	gir+Verb+Pos^DB+Adverb+AfterDoingSo
kesmişti	kes+Verb+Pos+Narr+Past+A3sg
uyarmaya	uyar+Verb+Pos^DB+Noun+Inf2+A3sg+Pnon+Dat
görmeden	gör+Verb+Pos^DB+Noun+Inf2+A3sg+Pnon+Abl
kabartıp	kabar+Verb^DB+Verb+Caus+Pos^DB+Adverb+AfterDoingSo
yapacaktı	yap+Verb+Pos+Fut+Past+A3sg
çakılıp	çak+Verb^DB+Verb+Pass+Pos^DB+Adverb+AfterDoingSo
koştuğundan	koş+Verb+Pos^DB+Noun+PastPart+A3sg+P3sg+Abl
durdurabildi	dur+Verb^DB+Verb+Caus+Pos^DB+Verb+Able+Past+A3sg
saldırdığı	sal+Verb^DB+Verb+Caus+Pos^DB+Noun+PastPart+A3sg+P3sg+Nom
harcamıştı	harca+Verb+Pos+Narr+Past+A3sg
kaybedip	kaybet+Verb+Pos^DB+Adverb+AfterDoingSo
oturakaldı	otur+Verb+Pos^DB+Verb+Stay+Past+A3sg
korumalı	koru+Verb+Pos^DB+Noun+Inf2+A3sg+Pnon+Nom^DB+Adj+With
edebilmeliydi	et+Verb+Pos^DB+Verb+Able+Neces+Past+A3sg
gelelim	gel+Verb+Pos+Opt+A1pl
koruyan	koru+Verb+Pos^DB+Adj+PresPart
olduğundan	ol+Verb+Pos^DB+Noun+PastPart+A3sg+P3sg+Abl
duyduğu	duy+Verb+Pos^DB+Noun+PastPart+A3sg+P3sg+Nom
edildiği	et+Verb^DB+Verb+Pass+Pos^DB+Noun+PastPart+A3sg+P3sg+Nom
vazgeçip	vazgeç+Verb+Pos^DB+Adverb+AfterDoingSo
dizginlemeye	dizginle+Verb+Pos^DB+Noun+Inf2+A3sg+Pnon+Dat
hissetmesine	hisset+Verb+Pos^DB+Noun+Inf2+A3sg+P3sg+Dat
hırlamak	hırla+Verb+Pos^DB+Noun+Inf1+A3sg+Pnon+Nom
davranışta	davran+Verb+Pos^DB+Noun+Inf3+A3sg+Pnon+Loc
hırpalamak	hırpala+Verb+Pos^DB+Noun+Inf1+A3sg+Pnon+Nom
gererek	ger+Verb+Pos^DB+Adverb+ByDoingSo
sıkıla	sık+Verb^DB+Verb+Pass+Pos+Opt+A3sg
dönerse	dön+Verb+Pos+Aor+Cond+A3sg
dönsün	dön+Verb+Pos+Imp+A3sg
kesiyordu	kes+Verb+Pos+Prog1+Past+A3sg
seslendi	seslen+Verb+Pos+Past+A3sg
koş	koş+Verb+Pos+Imp+A2sg
olmaksızın	ol+Verb+Pos^DB+Adverb+WithoutHavingDoneSo
getireceğe	getir+Verb+Pos^DB+Noun+FutPart+A3sg+Pnon+Dat
benziyor	benze+Verb+Pos+Prog1+A3sg
öğrenmesi	öğren+Verb+Pos^DB+Noun+Inf2+A3sg+P3sg+Nom
başlarsa	başla+Verb+Pos+Aor+Cond+A3sg
dolanmayı	dola+Verb^DB+Verb+Pass+Pos^DB+Noun+Inf2+A3sg+Pnon+Acc
denedi	dene+Verb+Pos+Past+A3sg
kestirmeye	kes+Verb^DB+Verb+Caus+Pos^DB+Noun+Inf2+A3sg+Pnon+Dat
saparak	sap+Verb+Pos^DB+Adverb+ByDoingSo
dikiliyordu	dik+Verb^DB+Verb+Pass+Pos+Prog1+Past+A3sg
bulup	bul+Verb+Pos^DB+Adverb+AfterDoingSo
koşup	koş+Verb+Pos^DB+Adverb+AfterDoingSo
atlatmayı	atla+Verb^DB+Verb+Caus+Pos^DB+Noun+Inf2+A3sg+Pnon+Acc
götüren	götür+Verb+Pos^DB+Adj+PresPart
atlatmaya	atla+Verb^DB+Verb+Caus+Pos^DB+Noun+Inf2+A3sg+Pnon+Dat
çalıştıysa	çalış+Verb+Pos+Past+Cond+A3sg
bırakmaya	bırak+Verb+Pos^DB+Noun+Inf2+A3sg+Pnon+Dat
kalmıştı	kal+Verb+Pos+Narr+Past+A3sg
çarpışarak	çarp+Verb^DB+Verb+Recip+Pos^DB+Adverb+ByDoingSo
abanıverdi	aban+Verb+Pos^DB+Verb+Hastily+Past+A3sg
düşmekle	düş+Verb+Pos^DB+Noun+Inf1+A3sg+Pnon+Ins
koşmakta	koş+Verb+Pos^DB+Noun+Inf1+A3sg+Pnon+Loc
attı	at+Verb+Pos+Past+A3sg
doğrulmak	doğrul+Verb+Pos^DB+Noun+Inf1+A3sg+Pnon+Nom
eşelerken	eşele+Verb+Pos+Aor^DB+Adverb+While
incinen	incin+Verb+Pos^DB+Adj+PresPart
düşünüp	düşün+Verb+Pos^DB+Adverb+AfterDoingSo
kuduruyordu	kudur+Verb+Pos+Prog1+Past+A3sg
açılmıştı	aç+Verb^DB+Verb+Pass+Pos+Narr+Past+A3sg
vermeksizin	ver+Verb+Pos^DB+Adverb+WithoutHavingDoneSo
takılmıştı	tak+Verb^DB+Verb+Pass+Pos+Narr+Past+A3sg
koşulurmuş	koş+Verb^DB+Verb+Pass+Pos+Aor+Narr+A3sg
öğretecekti	öğret+Verb+Pos+Fut+Past+A3sg
almış	al+Verb+Pos+Narr+A3sg
kovalıyordu	kovala+Verb+Pos+Prog1+Past+A3sg
zorlanmadan	zorla+Verb^DB+Verb+Pass+Pos^DB+Noun+Inf2+A3sg+Pnon+Abl
dolanıp	dola+Verb^DB+Verb+Pass+Pos^DB+Adverb+AfterDoingSo
durmuştu	dur+Verb+Pos+Narr+Past+A3sg
iniyordu	in+Verb+Pos+Prog1+Past+A3sg
yaklaştığını	yaklaş+Verb+Pos^DB+Noun+PastPart+A3sg+P3sg+Acc
atılmaya	at+Verb^DB+Verb+Pass+Pos^DB+Noun+Inf2+A3sg+Pnon+Dat
koyacaktı	koy+Verb+Pos+Fut+Past+A3sg
avlanan	avla+Verb^DB+Verb+Pass+Pos^DB+Adj+PresPart
atarak	at+Verb+Pos^DB+Adverb+ByDoingSo
yuvarlandı	yuvarla+Verb^DB+Verb+Pass+Pos+Past+A3sg
kırıcı	kır+Verb+Pos^DB+Adj+Agt
kurtulmak	kurtul+Verb+Pos^DB+Noun+Inf1+A3sg+Pnon+Nom
dikildiğinde	dik+Verb^DB+Verb+Pass+Pos^DB+Noun+PastPart+A3sg+P3sg+Loc
yatmıştı	yat+Verb+Pos+Narr+Past+A3sg
kırış	kır+Verb+Pos^DB+Noun+Inf3+A3sg+Pnon+Nom
gerilmişti	ger+Verb^DB+Verb+Pass+Pos+Narr+Past+A3sg
ıskalayınca	ıskala+Verb+Pos^DB+Adverb+When
takırdadı	takırda+Verb+Pos+Past+A3sg
gören	gör+Verb+Pos^DB+Adj+PresPart
telaşlanmış	telaş+Noun+A3sg+Pnon+Nom^DB+Verb+Acquire+Pos+Narr+A3sg
dürülmüş	dür+Verb^DB+Verb+Pass+Pos+Narr+A3sg
incinmişti	incin+Verb+Pos+Narr+Past+A3sg
yaptıkları	yap+Verb+Pos^DB+Noun+PastPart+A3pl+P3pl+Nom
kaybetmiş	kaybet+Verb+Pos+Narr+A3sg
yuvarlanıp	yuvarla+Verb^DB+Verb+Reflex+Pos^DB+Adverb+AfterDoingSo
alınmıştı	al+Verb^DB+Verb+Pass+Pos+Narr+Past+A3sg
inen	in+Verb+Pos^DB+Adj+PresPart
saldırmıştı	sal+Verb^DB+Verb+Caus+Pos+Narr+Past+A3sg
zıplamışken	zıpla+Verb+Pos+Narr^DB+Adverb+While
saldırınca	sal+Verb^DB+Verb+Caus+Pos^DB+Adverb+When
yuvarlanmıştı	yuvarla+Verb^DB+Verb+Pass+Pos+Narr+Past+A3sg
yetişti	yetiş+Verb+Pos+Past+A3sg
kovalayıp	kovala+Verb+Pos^DB+Adverb+AfterDoingSo
uzaklaştırdı	uzak+Adj^DB+Verb+Become^DB+Verb+Caus+Pos+Past+A3sg
okşamaları	okşa+Verb+Pos^DB+Noun+Inf2+A3pl+P3sg+Nom
sakinleşebildi	sakin+Adj^DB+Verb+Become+Pos^DB+Verb+Able+Past+A3sg
karşılanır	karşıla+Verb^DB+Verb+Pass+Pos+Aor+A3sg
kesilip	kes+Verb^DB+Verb+Pass+Pos^DB+Adverb+AfterDoingSo
yıkılan	yık+Verb^DB+Verb+Pass+Pos^DB+Adj+PresPart
gitmişti	git+Verb+Pos+Narr+Past+A3sg
çıkıyordu	çık+Verb+Pos+Prog1+Past+A3sg
bekliyorlardı	bekle+Verb+Pos+Prog1+A3pl+Past
dolayarak	dola+Verb+Pos^DB+Adverb+ByDoingSo
tutmayı	tut+Verb+Pos^DB+Noun+Inf2+A3sg+Pnon+Acc
öğrenmişti	öğren+Verb+Pos+Narr+Past+A3sg
çıkan	çık+Verb+Pos^DB+Adj+PresPart
dokunacak	doku+Verb^DB+Verb+Pass+Pos+Fut+A3sg
hırlayarak	hırla+Verb+Pos^DB+Adverb+ByDoingSo
sokuluyor	sok+Verb^DB+Verb+Pass+Pos+Prog1+A3sg
okşayarak	okşa+Verb+Pos^DB+Adverb+ByDoingSo
yatıştırıyordu	yatış+Verb^DB+Verb+Caus+Pos+Prog1+Past+A3sg
tırmanıp	tırman+Verb+Pos^DB+Adverb+AfterDoingSo
kıvrıldı	kıvır+Verb^DB+Verb+Pass+Pos+Past+A3sg
saran	sar+Verb+Pos^DB+Adj+PresPart
okşuyordu	okşa+Verb+Pos+Prog1+Past+A3sg
inliyordu	inle+Verb+Pos+Prog1+Past+A3sg
durmasına	dur+Verb+Pos^DB+Noun+Inf2+A3sg+P3sg+Dat
şaşırmış	şaşır+Verb+Pos^DB+Adj+NarrPart
öfkelenmişti	öfke+Noun+A3sg+Pnon+Nom^DB+Verb+Acquire+Pos+Narr+Past+A3sg
gezdirmekle	gez+Verb^DB+Verb+Caus+Pos^DB+Noun+Inf1+A3sg+Pnon+Ins
ettiklerini	et+Verb+Pos^DB+Noun+PastPart+A3pl+P3sg+Acc
girmek	gir+Verb+Pos^DB+Noun+Inf1+A3sg+Pnon+Nom
yöneldiler	yönel+Verb+Pos+Past+A3pl
uzanmakta	uza+Verb^DB+Verb+Pass+Pos^DB+Noun+Inf1+A3sg+Pnon+Loc
homurdanınca	homurda+Verb^DB+Verb+Pass+Pos^DB+Adverb+When
kabarttı	kabar+Verb^DB+Verb+Caus+Pos+Past+A3sg
alalım	al+Verb+Pos+Opt+A1pl
paylaşsınlar	paylaş+Verb+Pos+Imp+A3pl
dalaşmadan	dalaş+Verb+Pos^DB+Noun+Inf2+A3sg+Pnon+Abl
kanıtlamak	kanıtla+Verb+Pos^DB+Noun+Inf1+A3sg+Pnon+Nom
onayladı	onayla+Verb+Pos+Past+A3sg
zannettiniz	zannet+Verb+Pos+Past+A2pl
parçalayıverir	parçala+Verb+Pos^DB+Verb+Hastily+Aor+A3sg
girme	gir+Verb+Pos^DB+Noun+Inf2+A3sg+Pnon+Nom
gere	ger+Verb+Pos+Opt+A3sg
ayırmadan	ayır+Verb+Pos^DB+Noun+Inf2+A3sg+Pnon+Abl
gelebilecek	gel+Verb+Pos^DB+Verb+Able^DB+Adj+FutPart+Pnon
korunmak	koru+Verb^DB+Verb+Pass+Pos^DB+Noun+Inf1+A3sg+Pnon+Nom
kolluyordu	kolla+Verb+Pos+Prog1+Past+A3sg
yatmış	yat+Verb+Pos+Narr+A3sg
olabileceği	ol+Verb+Pos^DB+Verb+Able^DB+Noun+FutPart+A3sg+P3sg+Nom
aradı	ara+Verb+Pos+Past+A3sg
korkulacak	kork+Verb^DB+Verb+Pass+Pos^DB+Adj+FutPart+Pnon
yattı	yat+Verb+Pos+Past+A3sg
bitenleri	bit+Verb+Pos^DB+Adj+PresPart^DB+Noun+Zero+A3sg+P3pl+Nom
gözlemeye	gözle+Verb+Pos^DB+Noun+Inf2+A3sg+Pnon+Dat
hortladığı	hortla+Verb+Pos^DB+Adj+PastPart+P3sg
fırlayacaktı	fırla+Verb+Pos+Fut+Past+A3sg
korumaya	koru+Verb+Pos^DB+Noun+Inf2+A3sg+Pnon+Dat
alışabilme	alış+Verb+Pos^DB+Verb+Able^DB+Noun+Inf2+A3sg+Pnon+Nom
yaratılışından	yara+Verb^DB+Verb+Caus^DB+Verb+Pass+Pos^DB+Noun+Inf3+A3sg+P3sg+Abl
sağlıyor	sağla+Verb+Pos+Prog1+A3sg
alıştı	alış+Verb+Pos+Past+A3sg
sokulması	sok+Verb^DB+Verb+Pass+Pos^DB+Noun+Inf2+A3sg+P3sg+Nom
görülmüş	gör+Verb^DB+Verb+Pass+Pos+Narr+A3sg
eğmeleri	eğ+Verb+Pos^DB+Noun+Inf2+A3pl+P3pl+Nom
davranmakla	davran+Verb+Pos^DB+Noun+Inf1+A3sg+Pnon+Ins
yetindi	yetin+Verb+Pos+Past+A3sg
diklendiği	dikle+Verb^DB+Verb+Pass+Pos^DB+Adj+PastPart+P3sg
kalsa	kal+Verb+Pos+Desr+A3sg
olabilirlerdi	ol+Verb+Pos^DB+Verb+Able+Aor+A3pl+Past
bırakmalarıydı	bırak+Verb+Pos^DB+Noun+Inf2+A3pl+P3sg+Nom^DB+Verb+Zero+Past+A3sg
durmaya	dur+Verb+Pos^DB+Noun+Inf2+A3sg+Pnon+Dat
yaklaşacak	yaklaş+Verb+Pos+Fut+A3sg
gidinceye	git+Verb+Pos^DB+Adverb+When^DB+Noun+Zero+A3sg+Pnon+Dat
aldığı	al+Verb+Pos^DB+Noun+PastPart+A3sg+P3sg+Nom
kalmakta	kal+Verb+Pos^DB+Noun+Inf1+A3sg+Pnon+Loc
anladı	anla+Verb+Pos+Past+A3sg
bağlandığı	bağla+Verb^DB+Verb+Pass+Pos^DB+Adj+PastPart+P3sg
gösterdiği	göster+Verb+Pos^DB+Noun+PastPart+A3sg+P3sg+Nom
yumuyordu	yum+Verb+Pos+Prog1+Past+A3sg
bırakacağı	bırak+Verb+Pos^DB+Adj+FutPart+P3sg
yağmaladığı	yağmala+Verb+Pos^DB+Adj+PastPart+P3sg
dökülen	dök+Verb^DB+Verb+Pass+Pos^DB+Adj+PresPart
kanlar	kanla+Verb+Pos^DB+Adj+AorPart
unutulacak	unut+Verb^DB+Verb+Pass+Pos+Fut+A3sg
yerleşmişti	yerleş+Verb+Pos+Narr+Past+A3sg
dürtüyor	dürt+Verb+Pos+Prog1+A3sg
kışkırtıyordu	kışkırt+Verb+Pos+Prog1+Past+A3sg
sayıp	say+Verb+Pos^DB+Adverb+AfterDoingSo
saldırmasına	sal+Verb^DB+Verb+Caus+Pos^DB+Noun+Inf2+A3sg+P3sg+Dat
faydalanıyor	fayda+Noun+A3sg+Pnon+Nom^DB+Verb+Acquire+Pos+Prog1+A3sg
dayanan	dayan+Verb+Pos^DB+Adj+PresPart
çalışacaktı	çalış+Verb+Pos+Fut+Past+A3sg
üzmek	üz+Verb+Pos^DB+Noun+Inf1+A3sg+Pnon+Nom
bozucu	boz+Verb+Pos^DB+Noun+Agt+A3sg+Pnon+Nom
tutuyordu	tut+Verb+Pos+Prog1+Past+A3sg
geçince	geç+Verb+Pos^DB+Adverb+When
korunan	koru+Verb^DB+Verb+Pass+Pos^DB+Adj+PresPart
savuşuyordu	savuş+Verb+Pos+Prog1+Past+A3sg
azıttığı	azıt+Verb+Pos^DB+Adj+PastPart+P3sg
bakışlarındaki	bak+Verb+Pos^DB+Noun+Inf3+A3pl+P3sg+Loc^DB+Adj+Rel
çevirip	çevir+Verb+Pos^DB+Adverb+AfterDoingSo
dolanmasına	dola+Verb^DB+Verb+Pass+Pos^DB+Noun+Inf2+A3sg+P3sg+Dat
kaptırdığı	kap+Verb^DB+Verb+Caus+Pos^DB+Noun+PastPart+A3sg+P3sg+Nom
dayanmak	daya+Verb^DB+Verb+Pass+Pos^DB+Noun+Inf1+A3sg+Pnon+Nom
uzaklaşıyordu	uzak+Adj^DB+Verb+Become+Pos+Prog1+Past+A3sg
uzaklaşmalarda	uzak+Adj^DB+Verb+Become+Pos^DB+Noun+Inf2+A3pl+Pnon+Loc
alçaltmadan	alçal+Verb^DB+Verb+Caus+Pos^DB+Adverb+WithoutHavingDoneSo
koruyarak	koru+Verb+Pos^DB+Adverb+ByDoingSo
ayrılmaya	ayır+Verb^DB+Verb+Pass+Pos^DB+Noun+Inf2+A3sg+Pnon+Dat
getirmişti	getir+Verb+Pos+Narr+Past+A3sg
görecek	gör+Verb+Pos+Fut+A3sg
kalkıyor	kalk+Verb+Pos+Prog1+A3sg
kıyaslandığında	kıyasla+Verb^DB+Verb+Pass+Pos^DB+Noun+PastPart+A3sg+P3sg+Loc
kalıyordu	kal+Verb+Pos+Prog1+Past+A3sg
tanıması	tanı+Verb+Pos^DB+Noun+Inf2+A3sg+P3sg+Nom
paylaşıyorlarsa	paylaş+Verb+Pos+Prog1+A3pl+Cond
anlatılsa	anla+Verb^DB+Verb+Caus^DB+Verb+Pass+Pos+Desr+A3sg
anlayacaktı	anla+Verb+Pos+Fut+Past+A3sg
anlamıştı	anla+Verb+Pos+Narr+Past+A3sg
yetinmeliydi	yetin+Verb+Pos+Neces+Past+A3sg
davranışlarını	davran+Verb+Pos^DB+Noun+Inf3+A3pl+P3pl+Acc
konuşmalarını	konuş+Verb+Pos^DB+Noun+Inf2+A3pl+P3pl+Acc
izleye	izle+Verb+Pos+Opt+A3sg
edinebilmişti	edin+Verb+Pos^DB+Verb+Able+Narr+Past+A3sg
tartmaya	tart+Verb+Pos^DB+Noun+Inf2+A3sg+Pnon+Dat
seviyorsa	sev+Verb+Pos+Prog1+Cond+A3sg
veriyorsa	ver+Verb+Pos+Prog1+Cond+A3sg
sevdiklerini	sev+Verb+Pos^DB+Noun+PastPart+A3pl+P3pl+Acc
koruyordu	koru+Verb+Pos+Prog1+Past+A3sg
yaşadıkları	yaşa+Verb+Pos^DB+Adj+PastPart+P3pl
yaklaştıklarında	yaklaş+Verb+Pos^DB+Noun+PastPart+A3sg+P3pl+Loc
